,code_xrefs,jump_refs,func_refs,code_up_refs,code_down_refs,jump_refs_perc,func_refs_perc,code_up_refs_perc,code_down_refs_perc,data_xrefs,write_refs,read_refs,taken_refs,data_up_refs,data_down_refs,write_refs_perc,read_refs_perc,taken_refs_perc,data_up_refs_perc,data_down_refs_perc
0,72,40,32,64,8,0.5555555555555556,0.4444444444444444,0.8888888888888888,0.1111111111111111,112,4,29,79,97,15,0.03571428571428571,0.25892857142857145,0.7053571428571429,0.8660714285714286,0.13392857142857142
1,4181,3465,716,2859,1322,0.8287491030853863,0.17125089691461373,0.6838077015068166,0.3161922984931834,2763,339,219,2205,1741,1022,0.12269272529858849,0.07926167209554831,0.7980456026058632,0.6301121968874411,0.3698878031125588
2,732,571,161,658,74,0.7800546448087432,0.21994535519125682,0.8989071038251366,0.10109289617486339,934,29,73,832,591,343,0.031049250535331904,0.07815845824411134,0.8907922912205567,0.632762312633833,0.367237687366167
3,17970,15118,2852,13012,4958,0.841291040623261,0.158708959376739,0.72409571508069,0.27590428491930996,4575,235,752,3588,3438,1137,0.05136612021857923,0.16437158469945357,0.7842622950819672,0.7514754098360655,0.24852459016393444
4,1268,1087,181,1073,195,0.8572555205047319,0.14274447949526814,0.8462145110410094,0.15378548895899052,362,48,70,244,295,67,0.13259668508287292,0.19337016574585636,0.6740331491712708,0.8149171270718232,0.1850828729281768
5,2230,1547,683,1748,482,0.6937219730941704,0.3062780269058296,0.7838565022421524,0.21614349775784752,2107,1018,142,947,1657,450,0.4831514000949217,0.06739439962031324,0.44945420028476507,0.7864261983863313,0.21357380161366873
6,961,875,86,597,364,0.9105098855359001,0.08949011446409989,0.6212278876170656,0.37877211238293446,202,4,80,118,154,48,0.019801980198019802,0.39603960396039606,0.5841584158415841,0.7623762376237624,0.2376237623762376
7,3937,3073,864,3211,726,0.7805435610871222,0.21945643891287783,0.8155956311912624,0.18440436880873762,1503,83,221,1199,970,533,0.0552228875582169,0.14703925482368596,0.7977378576180971,0.6453759148369926,0.3546240851630073
8,3124,2522,602,2591,533,0.8072983354673495,0.19270166453265045,0.8293854033290653,0.1706145966709347,910,65,190,655,674,236,0.07142857142857142,0.2087912087912088,0.7197802197802198,0.7406593406593407,0.25934065934065936
9,7412,6423,989,6229,1183,0.8665677280086347,0.13343227199136534,0.8403939557474366,0.15960604425256342,3447,149,343,2955,1051,2396,0.04322599361763853,0.09950681752248332,0.8572671888598782,0.30490281404119524,0.6950971859588048
10,8736,6706,2030,6731,2005,0.7676282051282052,0.23237179487179488,0.7704899267399268,0.22951007326007325,4563,93,349,4121,2457,2106,0.020381328073635765,0.0764847687924611,0.9031339031339032,0.5384615384615384,0.46153846153846156
11,18748,15343,3405,16700,2048,0.8183806272669085,0.18161937273309153,0.8907616812459995,0.10923831875400043,8324,152,660,7512,5078,3246,0.01826045170591062,0.07928880345987506,0.9024507448342143,0.6100432484382509,0.38995675156174914
12,316,265,51,278,38,0.8386075949367089,0.16139240506329114,0.879746835443038,0.12025316455696203,251,28,93,130,233,18,0.11155378486055777,0.3705179282868526,0.5179282868525896,0.9282868525896414,0.07171314741035857
13,13424,10536,2888,10762,2662,0.7848629320619785,0.21513706793802145,0.8016984505363528,0.1983015494636472,7449,307,1394,5748,6020,1429,0.04121358571620352,0.1871392133172238,0.7716472009665727,0.8081621694187139,0.1918378305812861
14,49771,42618,7153,42034,7737,0.856281770508931,0.1437182294910691,0.844548029977296,0.15545197002270397,27344,13159,1741,12444,20226,7118,0.48123902867173785,0.06367027501462844,0.4550906963136337,0.7396869514335869,0.26031304856641313
15,5221,4151,1070,4194,1027,0.7950584179276001,0.20494158207239993,0.8032943880482666,0.1967056119517334,2473,84,284,2105,2056,417,0.033966841892438336,0.11484027496967246,0.8511928831378892,0.8313788920339669,0.16862110796603316
16,833,583,250,729,104,0.6998799519807923,0.30012004801920766,0.8751500600240096,0.12484993997599039,627,39,115,473,544,83,0.06220095693779904,0.18341307814992025,0.7543859649122807,0.8676236044657097,0.13237639553429026
17,1006,918,88,624,382,0.9125248508946322,0.0874751491053678,0.6202783300198808,0.3797216699801193,245,4,102,139,195,50,0.0163265306122449,0.4163265306122449,0.5673469387755102,0.7959183673469388,0.20408163265306123
18,31207,26344,4863,25251,5956,0.8441695773384177,0.15583042266158234,0.8091453840484507,0.19085461595154934,10735,1131,646,8958,5940,4795,0.10535631113181183,0.06017699115044248,0.8344666977177457,0.5533302282254309,0.4466697717745692
19,32645,28911,3734,27300,5345,0.8856180119466993,0.11438198805330066,0.8362689538979936,0.16373104610200642,8595,125,814,7656,4556,4039,0.014543339150668994,0.09470622454915649,0.8907504363001745,0.5300756253635834,0.4699243746364165
20,1011,922,89,629,382,0.9119683481701286,0.08803165182987141,0.6221562809099901,0.3778437190900099,238,4,97,137,192,46,0.01680672268907563,0.40756302521008403,0.5756302521008403,0.8067226890756303,0.19327731092436976
21,3426,2818,608,2826,600,0.822533566841798,0.17746643315820199,0.8248686514886164,0.17513134851138354,1378,74,185,1119,805,573,0.05370101596516691,0.13425253991291727,0.8120464441219158,0.5841799709724238,0.4158200290275762
22,619,389,230,530,89,0.6284329563812601,0.3715670436187399,0.8562197092084006,0.14378029079159935,410,12,99,299,341,69,0.02926829268292683,0.24146341463414633,0.7292682926829268,0.8317073170731707,0.16829268292682928
23,5273,4109,1164,3889,1384,0.7792527972691068,0.22074720273089324,0.7375308173715153,0.26246918262848473,2276,41,182,2053,1196,1080,0.018014059753954304,0.07996485061511424,0.9020210896309314,0.5254833040421792,0.47451669595782076
24,5085,4997,88,2787,2298,0.9826941986234021,0.017305801376597835,0.5480825958702065,0.45191740412979353,1068,199,515,354,850,218,0.18632958801498128,0.48220973782771537,0.33146067415730335,0.795880149812734,0.20411985018726592
25,4115,2967,1148,3320,795,0.7210206561360875,0.2789793438639125,0.8068043742405833,0.19319562575941676,4876,56,460,4360,2988,1888,0.011484823625922888,0.09433962264150944,0.8941755537325676,0.6127973748974569,0.38720262510254305
26,803,580,223,588,215,0.7222914072229141,0.2777085927770859,0.7322540473225405,0.26774595267745954,578,17,95,466,356,222,0.029411764705882353,0.1643598615916955,0.8062283737024222,0.615916955017301,0.38408304498269896
27,768,510,258,672,96,0.6640625,0.3359375,0.875,0.125,464,4,148,312,379,85,0.008620689655172414,0.31896551724137934,0.6724137931034483,0.8168103448275862,0.18318965517241378
28,1053,816,237,756,297,0.7749287749287749,0.22507122507122507,0.717948717948718,0.28205128205128205,400,61,132,207,315,85,0.1525,0.33,0.5175,0.7875,0.2125
29,1182,968,214,995,187,0.8189509306260575,0.18104906937394247,0.8417935702199661,0.15820642978003385,590,47,169,374,458,132,0.07966101694915254,0.2864406779661017,0.6338983050847458,0.7762711864406779,0.22372881355932203
30,551,390,161,337,214,0.7078039927404719,0.29219600725952816,0.6116152450090744,0.38838475499092556,310,34,75,201,163,147,0.10967741935483871,0.24193548387096775,0.6483870967741936,0.5258064516129032,0.47419354838709676
31,18040,14531,3509,15750,2290,0.8054878048780488,0.19451219512195123,0.873059866962306,0.12694013303769403,6415,181,504,5730,5064,1351,0.028215120810600156,0.07856586126266563,0.8932190179267342,0.7893998441153547,0.21060015588464537
32,428,348,80,255,173,0.8130841121495327,0.18691588785046728,0.5957943925233645,0.40420560747663553,8869,26,45,8798,446,8423,0.0029315593640771224,0.005073852745518097,0.9919945878904047,0.050287518322246025,0.949712481677754
33,2960,2093,867,2099,861,0.7070945945945946,0.2929054054054054,0.7091216216216216,0.2908783783783784,770,82,166,522,487,283,0.10649350649350649,0.21558441558441557,0.6779220779220779,0.6324675324675325,0.36753246753246754
34,11618,9982,1636,9692,1926,0.8591840247891204,0.14081597521087966,0.8342227577896367,0.16577724221036322,3401,185,468,2748,2688,713,0.054395765951190826,0.1376065862981476,0.8079976477506615,0.7903557777124375,0.2096442222875625
35,11468,10792,676,10602,866,0.9410533658876875,0.058946634112312525,0.9244855249389606,0.07551447506103941,12329,2466,389,9474,10569,1760,0.20001622191580826,0.031551626247059775,0.768432151837132,0.8572471408873388,0.1427528591126612
36,1035,835,200,904,131,0.8067632850241546,0.1932367149758454,0.8734299516908213,0.12657004830917876,393,47,105,241,366,27,0.11959287531806616,0.26717557251908397,0.6132315521628499,0.9312977099236641,0.06870229007633588
37,1563,1103,460,1165,398,0.7056941778630839,0.2943058221369162,0.745361484325016,0.254638515674984,648,45,129,474,512,136,0.06944444444444445,0.19907407407407407,0.7314814814814815,0.7901234567901234,0.20987654320987653
38,2991,2595,396,2480,511,0.8676028084252758,0.13239719157472418,0.8291541290538281,0.17084587094617185,1001,20,186,795,604,397,0.01998001998001998,0.18581418581418582,0.7942057942057942,0.6033966033966034,0.3966033966033966
39,1069,977,92,679,390,0.9139382600561272,0.08606173994387278,0.6351730589335828,0.3648269410664172,222,4,103,115,178,44,0.018018018018018018,0.46396396396396394,0.5180180180180181,0.8018018018018018,0.1981981981981982
40,6507,5351,1156,5529,978,0.822345166743507,0.177654833256493,0.8497003227293684,0.15029967727063162,2168,345,617,1206,1916,252,0.1591328413284133,0.2845940959409594,0.5562730627306273,0.8837638376383764,0.11623616236162361
41,19737,16793,2944,15695,4042,0.8508385266251204,0.14916147337487967,0.7952069716775599,0.2047930283224401,16968,377,867,15724,6551,10417,0.022218293257897218,0.0510961810466761,0.9266855256954267,0.38607967939651106,0.6139203206034889
42,1072,977,95,679,393,0.9113805970149254,0.08861940298507463,0.6333955223880597,0.3666044776119403,300,4,99,197,207,93,0.013333333333333334,0.33,0.6566666666666666,0.69,0.31
43,6139,4889,1250,4929,1210,0.7963837758592605,0.20361622414073954,0.8028994950317642,0.19710050496823586,3190,278,357,2555,1930,1260,0.0871473354231975,0.11191222570532916,0.8009404388714734,0.6050156739811913,0.3949843260188088
44,2083,1681,402,1694,389,0.8070091214594335,0.19299087854056649,0.813250120019203,0.18674987998079692,717,85,186,446,567,150,0.11854951185495119,0.2594142259414226,0.6220362622036262,0.7907949790794979,0.20920502092050208
45,8002,6936,1066,6974,1028,0.8667833041739565,0.13321669582604348,0.8715321169707573,0.1284678830292427,2658,130,598,1930,1675,983,0.04890895410082769,0.22498118886380739,0.7261098570353649,0.6301730624529721,0.36982693754702783
46,6886,5668,1218,5608,1278,0.8231193726401395,0.1768806273598606,0.8144060412431019,0.18559395875689805,2134,192,328,1614,1517,617,0.08997188378631678,0.15370196813495782,0.7563261480787254,0.7108716026241799,0.2891283973758201
47,34322,27181,7141,26866,7456,0.7919410290775596,0.2080589709224404,0.782763242235301,0.21723675776469903,8059,220,856,6983,3743,4316,0.027298672291847625,0.10621665219009803,0.8664846755180543,0.46444968358357114,0.5355503164164288
48,23748,19088,4660,20683,3065,0.8037729493009937,0.19622705069900623,0.8709364999157824,0.12906350008421763,11053,269,830,9954,6454,4599,0.024337283995295396,0.07509273500407129,0.9005699810006333,0.5839138695376821,0.4160861304623179
49,10703,7781,2922,6792,3911,0.7269924320284032,0.27300756797159675,0.6345884331495842,0.36541156685041576,2861,120,553,2188,2011,850,0.04194337644180356,0.19328905976931143,0.764767563788885,0.7029010835372247,0.29709891646277525
50,58,33,25,31,27,0.5689655172413793,0.43103448275862066,0.5344827586206896,0.46551724137931033,96,5,26,65,71,25,0.052083333333333336,0.2708333333333333,0.6770833333333334,0.7395833333333334,0.2604166666666667
51,7167,5831,1336,5557,1610,0.8135900655783452,0.1864099344216548,0.7753592856146225,0.22464071438537742,8457,84,295,8078,5659,2798,0.009932600212841433,0.03488234598557408,0.9551850538015845,0.669149816719877,0.330850183280123
52,896,633,263,629,267,0.7064732142857143,0.2935267857142857,0.7020089285714286,0.29799107142857145,515,7,71,437,265,250,0.013592233009708738,0.1378640776699029,0.8485436893203884,0.5145631067961165,0.4854368932038835
53,7721,6586,1135,6430,1291,0.8529983162802746,0.1470016837197254,0.8327936795751846,0.16720632042481545,2735,184,296,2255,1521,1214,0.06727605118829982,0.10822669104204753,0.8244972577696527,0.5561243144424132,0.44387568555758683
54,584,518,66,506,78,0.886986301369863,0.11301369863013698,0.8664383561643836,0.13356164383561644,410,29,151,230,393,17,0.07073170731707316,0.36829268292682926,0.5609756097560976,0.9585365853658536,0.041463414634146344
55,1385,1221,164,1310,75,0.8815884476534296,0.1184115523465704,0.9458483754512635,0.05415162454873646,481,14,58,409,315,166,0.029106029106029108,0.12058212058212059,0.8503118503118503,0.6548856548856549,0.34511434511434513
56,8734,8198,536,5588,3146,0.9386306388825281,0.061369361117471946,0.6397984886649875,0.3602015113350126,1307,6,668,633,1041,266,0.0045906656465187455,0.5110941086457537,0.4843152257077276,0.7964804896710023,0.2035195103289977
57,3293,2774,519,2700,593,0.8423929547525053,0.1576070452474947,0.8199210446401458,0.18007895535985424,1096,136,221,739,817,279,0.12408759124087591,0.20164233576642335,0.6742700729927007,0.7454379562043796,0.2545620437956204
58,4386,3126,1260,3707,679,0.7127222982216143,0.2872777017783858,0.8451892384860921,0.15481076151390788,5510,14,627,4869,3090,2420,0.002540834845735027,0.11379310344827587,0.8836660617059892,0.5607985480943739,0.43920145190562615
59,6139,4889,1250,4929,1210,0.7963837758592605,0.20361622414073954,0.8028994950317642,0.19710050496823586,3190,278,357,2555,1930,1260,0.0871473354231975,0.11191222570532916,0.8009404388714734,0.6050156739811913,0.3949843260188088
60,9643,7955,1688,8064,1579,0.8249507414704967,0.17504925852950326,0.8362542777144042,0.16374572228559578,5929,15,460,5454,3901,2028,0.0025299375948726597,0.07758475290942823,0.9198853094956991,0.6579524371732164,0.3420475628267836
61,27620,23682,3938,23962,3658,0.8574221578566257,0.14257784214337438,0.8675597393193338,0.1324402606806662,5841,18,571,5252,3284,2557,0.0030816640986132513,0.09775723335045369,0.8991611025509331,0.5622324944358843,0.43776750556411576
62,3265,2437,828,2596,669,0.7464012251148545,0.2535987748851455,0.7950995405819296,0.20490045941807045,3990,19,511,3460,1873,2117,0.004761904761904762,0.1280701754385965,0.8671679197994987,0.46942355889724313,0.5305764411027569
63,3252,2396,856,2861,391,0.7367773677736777,0.26322263222632225,0.8797662976629766,0.12023370233702337,1519,86,319,1114,1198,321,0.05661619486504279,0.21000658327847269,0.7333772218564846,0.7886767610269915,0.21132323897300856
64,1046,828,218,769,277,0.7915869980879541,0.2084130019120459,0.7351816443594646,0.26481835564053535,434,41,136,257,294,140,0.0944700460829493,0.31336405529953915,0.5921658986175116,0.6774193548387096,0.3225806451612903
65,970,879,91,609,361,0.9061855670103093,0.09381443298969072,0.6278350515463917,0.37216494845360826,190,4,83,103,151,39,0.021052631578947368,0.4368421052631579,0.5421052631578948,0.7947368421052632,0.20526315789473684
66,1168,961,207,981,187,0.8227739726027398,0.17722602739726026,0.8398972602739726,0.1601027397260274,509,46,149,314,399,110,0.09037328094302555,0.29273084479371314,0.6168958742632613,0.7838899803536346,0.21611001964636542
67,1492,1368,124,941,551,0.9168900804289544,0.08310991957104558,0.6306970509383378,0.3693029490616622,301,4,103,194,258,43,0.013289036544850499,0.34219269102990035,0.6445182724252492,0.8571428571428571,0.14285714285714285
68,668,402,266,590,78,0.6017964071856288,0.39820359281437123,0.8832335329341318,0.11676646706586827,317,1,68,248,291,26,0.0031545741324921135,0.21451104100946372,0.7823343848580442,0.917981072555205,0.08201892744479496
69,239,140,99,196,43,0.5857740585774058,0.41422594142259417,0.8200836820083682,0.1799163179916318,553,3,258,292,467,86,0.0054249547920434,0.4665461121157324,0.5280289330922242,0.8444846292947559,0.15551537070524413
70,5859,4722,1137,4291,1568,0.8059395801331285,0.19406041986687148,0.7323775388291517,0.26762246117084826,2820,93,523,2204,1604,1216,0.03297872340425532,0.1854609929078014,0.7815602836879433,0.5687943262411348,0.43120567375886526
71,608,373,235,553,55,0.6134868421052632,0.38651315789473684,0.9095394736842105,0.09046052631578948,383,14,113,256,279,104,0.03655352480417755,0.2950391644908616,0.6684073107049608,0.7284595300261096,0.27154046997389036
72,4095,3509,586,3732,363,0.8568986568986569,0.1431013431013431,0.9113553113553113,0.08864468864468865,1671,93,264,1314,1235,436,0.05565529622980251,0.15798922800718132,0.7863554757630161,0.7390783961699581,0.26092160383004187
73,656,589,67,607,49,0.8978658536585366,0.10213414634146341,0.9253048780487805,0.07469512195121951,326,10,46,270,226,100,0.03067484662576687,0.1411042944785276,0.8282208588957055,0.6932515337423313,0.3067484662576687
74,2286,1860,426,1932,354,0.8136482939632546,0.18635170603674542,0.8451443569553806,0.15485564304461943,952,52,141,759,579,373,0.0546218487394958,0.148109243697479,0.7972689075630253,0.6081932773109243,0.3918067226890756
75,1479,1179,300,1207,272,0.7971602434077079,0.2028397565922921,0.8160919540229885,0.1839080459770115,548,85,136,327,433,115,0.1551094890510949,0.24817518248175183,0.5967153284671532,0.7901459854014599,0.20985401459854014
76,2541,2108,433,2071,470,0.829594647776466,0.17040535222353403,0.8150334513970877,0.18496654860291223,783,89,171,523,551,232,0.1136653895274585,0.21839080459770116,0.6679438058748404,0.7037037037037037,0.2962962962962963
77,11577,10034,1543,9080,2497,0.8667184935648268,0.1332815064351732,0.7843137254901961,0.21568627450980393,3832,70,290,3472,1744,2088,0.01826722338204593,0.075678496868476,0.906054279749478,0.4551148225469729,0.5448851774530271
78,1461,1166,295,1196,265,0.7980835044490076,0.20191649555099248,0.8186173853524983,0.18138261464750172,516,76,133,307,429,87,0.14728682170542637,0.25775193798449614,0.5949612403100775,0.8313953488372093,0.1686046511627907
79,20733,17016,3717,16015,4718,0.8207205903631891,0.17927940963681088,0.7724400713837843,0.22755992861621568,5540,61,771,4708,2403,3137,0.011010830324909748,0.13916967509025271,0.8498194945848375,0.43375451263537906,0.566245487364621
80,17699,14825,2874,13528,4171,0.8376179445166394,0.16238205548336065,0.7643369681902933,0.23566303180970677,11418,335,508,10575,5676,5742,0.02933963916622876,0.04449115431774391,0.9261692065160273,0.49710982658959535,0.5028901734104047
81,3404,2726,678,2843,561,0.800822561692127,0.1991774383078731,0.8351938895417156,0.16480611045828436,2019,105,188,1726,1206,813,0.05200594353640416,0.09311540366518078,0.854878652798415,0.5973254086181278,0.4026745913818722
82,11082,9149,1933,9731,1351,0.8255730012633099,0.17442699873669013,0.8780905973650965,0.12190940263490345,12384,2363,1199,8822,6451,5933,0.19081072351421188,0.09681847545219638,0.7123708010335917,0.5209140826873385,0.4790859173126615
83,896,633,263,629,267,0.7064732142857143,0.2935267857142857,0.7020089285714286,0.29799107142857145,515,7,71,437,265,250,0.013592233009708738,0.1378640776699029,0.8485436893203884,0.5145631067961165,0.4854368932038835
84,13616,11218,2398,10898,2718,0.8238836662749707,0.17611633372502938,0.8003819036427732,0.1996180963572268,3631,108,421,3102,2875,756,0.02974387221151198,0.11594602038006059,0.8543101074084274,0.7917928945194161,0.20820710548058385
85,25576,20099,5477,18508,7068,0.785853925555208,0.214146074444792,0.7236471692211448,0.2763528307788552,20268,105,558,19605,15257,5011,0.005180580224985199,0.027531083481349913,0.9672883362936648,0.7527629761199921,0.2472370238800079
86,1539,1225,314,1269,270,0.7959714100064977,0.20402858999350226,0.8245614035087719,0.17543859649122806,749,87,139,523,506,243,0.11615487316421896,0.1855807743658211,0.69826435246996,0.6755674232309746,0.32443257676902537
87,985,896,89,623,362,0.9096446700507614,0.09035532994923857,0.63248730964467,0.36751269035532996,171,4,78,89,131,40,0.023391812865497075,0.45614035087719296,0.52046783625731,0.7660818713450293,0.23391812865497075
88,2670,2266,404,2218,452,0.8486891385767791,0.15131086142322098,0.8307116104868913,0.16928838951310862,846,55,235,556,645,201,0.06501182033096926,0.2777777777777778,0.6572104018912529,0.7624113475177305,0.2375886524822695
89,1015,719,296,883,132,0.7083743842364532,0.2916256157635468,0.8699507389162562,0.13004926108374384,681,12,127,542,631,50,0.01762114537444934,0.18649045521292218,0.7958883994126285,0.9265785609397944,0.07342143906020558
90,3946,3177,769,3382,564,0.8051191079574253,0.19488089204257475,0.8570704510897111,0.1429295489102889,3252,534,211,2507,2096,1156,0.16420664206642066,0.06488314883148831,0.7709102091020911,0.6445264452644527,0.35547355473554737
91,4635,3632,1003,3337,1298,0.7836030204962244,0.21639697950377562,0.7199568500539374,0.28004314994606255,2167,151,775,1241,1196,971,0.0696815874480849,0.35763728657129673,0.5726811259806184,0.551915089986156,0.44808491001384404
92,1466,1351,115,935,531,0.9215552523874488,0.07844474761255116,0.6377899045020464,0.36221009549795363,306,4,110,192,219,87,0.013071895424836602,0.35947712418300654,0.6274509803921569,0.7156862745098039,0.28431372549019607
93,8358,6617,1741,6725,1633,0.791696578128739,0.20830342187126108,0.8046183297439579,0.1953816702560421,3751,237,411,3103,2190,1561,0.06318315115969075,0.10957078112503332,0.827246067715276,0.5838443081844842,0.41615569181551587
94,981,888,93,611,370,0.9051987767584098,0.09480122324159021,0.6228338430173292,0.37716615698267075,187,4,87,96,148,39,0.0213903743315508,0.46524064171123,0.5133689839572193,0.7914438502673797,0.20855614973262032
95,4046,3160,886,3550,496,0.7810182896688087,0.2189817103311913,0.8774097874443895,0.12259021255561048,1889,67,307,1515,1236,653,0.035468501852832186,0.1625198517734251,0.8020116463737427,0.6543144520910534,0.3456855479089465
96,102,65,37,87,15,0.6372549019607843,0.3627450980392157,0.8529411764705882,0.14705882352941177,134,27,31,76,116,18,0.20149253731343283,0.23134328358208955,0.5671641791044776,0.8656716417910447,0.13432835820895522
97,132,68,64,119,13,0.5151515151515151,0.48484848484848486,0.9015151515151515,0.09848484848484848,347,5,143,199,286,61,0.01440922190201729,0.41210374639769454,0.5734870317002881,0.8242074927953891,0.17579250720461095
98,2347,1781,566,2065,282,0.7588410737111205,0.24115892628887942,0.8798466126970601,0.12015338730293992,591,21,279,291,470,121,0.03553299492385787,0.4720812182741117,0.49238578680203043,0.7952622673434856,0.20473773265651438
99,3475,2959,516,2691,784,0.8515107913669064,0.14848920863309353,0.7743884892086331,0.2256115107913669,1733,18,292,1423,823,910,0.0103866128101558,0.16849394114252741,0.8211194460473168,0.4748990190421235,0.5251009809578765
100,2824,2161,663,2015,809,0.7652266288951841,0.23477337110481586,0.7135269121813032,0.2864730878186969,1315,93,180,1042,801,514,0.07072243346007605,0.13688212927756654,0.7923954372623574,0.6091254752851711,0.3908745247148289
101,3464,2577,887,2789,675,0.7439376443418014,0.2560623556581986,0.8051385681293303,0.19486143187066973,5374,44,256,5074,2438,2936,0.008187569780424266,0.04763676963155936,0.9441756605880164,0.4536657982880536,0.5463342017119464
102,387,265,122,312,75,0.6847545219638242,0.3152454780361757,0.8062015503875969,0.1937984496124031,377,4,77,296,264,113,0.010610079575596816,0.20424403183023873,0.7851458885941645,0.7002652519893899,0.29973474801061006
103,1342,1053,289,920,422,0.7846497764530551,0.21535022354694486,0.6855439642324889,0.3144560357675112,900,69,219,612,702,198,0.07666666666666666,0.24333333333333335,0.68,0.78,0.22
104,15705,13868,1837,12766,2939,0.8830308818847501,0.11696911811524992,0.8128621458134352,0.18713785418656478,5547,413,708,4426,2974,2573,0.07445466017667207,0.1276365603028664,0.7979087795204615,0.5361456643230575,0.4638543356769425
105,6606,5411,1195,5902,704,0.8191038449894036,0.18089615501059642,0.8934302149561005,0.10656978504389948,2150,157,282,1711,1364,786,0.07302325581395348,0.13116279069767442,0.7958139534883721,0.6344186046511628,0.3655813953488372
106,299,205,94,263,36,0.68561872909699,0.31438127090301005,0.8795986622073578,0.12040133779264214,238,19,57,162,219,19,0.07983193277310924,0.23949579831932774,0.680672268907563,0.9201680672268907,0.07983193277310924
107,11930,8918,3012,8494,3436,0.7475272422464375,0.2524727577535624,0.711986588432523,0.28801341156747695,5769,84,391,5294,2422,3347,0.014560582423296931,0.06777604437510834,0.9176633732015947,0.41983012653839485,0.5801698734616051
108,4553,3712,841,3273,1280,0.8152866242038217,0.18471337579617833,0.718866681309027,0.28113331869097297,1203,113,229,861,929,274,0.09393183707398171,0.19035743973399832,0.71571072319202,0.772236076475478,0.22776392352452202
109,2892,2309,583,2336,556,0.7984094052558783,0.20159059474412172,0.8077455048409405,0.19225449515905949,1270,85,232,953,920,350,0.06692913385826772,0.1826771653543307,0.7503937007874015,0.7244094488188977,0.2755905511811024
110,36949,30807,6142,31381,5568,0.833770873365991,0.16622912663400904,0.8493057998863298,0.15069420011367018,27083,356,1082,25645,12354,14729,0.013144777166488203,0.03995126093859617,0.9469039618949157,0.45615330650223385,0.5438466934977662
111,2435,1933,502,1928,507,0.7938398357289528,0.20616016427104722,0.7917864476386037,0.2082135523613963,1063,83,185,795,790,273,0.07808090310442145,0.17403574788334902,0.7478833490122295,0.7431796801505174,0.2568203198494826
112,12290,9571,2719,9131,3159,0.7787632221318145,0.22123677786818552,0.7429617575264442,0.2570382424735557,6827,382,1360,5085,5549,1278,0.05595429910648894,0.19920902299692397,0.744836677896587,0.8128021092720082,0.18719789072799178
113,34322,27181,7141,26866,7456,0.7919410290775596,0.2080589709224404,0.782763242235301,0.21723675776469903,8059,220,856,6983,3743,4316,0.027298672291847625,0.10621665219009803,0.8664846755180543,0.46444968358357114,0.5355503164164288
114,6127,5013,1114,4993,1134,0.8181818181818182,0.18181818181818182,0.8149175779337359,0.18508242206626407,2304,131,280,1893,1395,909,0.05685763888888889,0.12152777777777778,0.8216145833333334,0.60546875,0.39453125
115,957,813,144,816,141,0.8495297805642633,0.15047021943573669,0.8526645768025078,0.14733542319749215,363,44,120,199,321,42,0.12121212121212122,0.3305785123966942,0.5482093663911846,0.8842975206611571,0.11570247933884298
116,1091,996,95,689,402,0.9129239230064161,0.08707607699358387,0.6315307057745188,0.3684692942254812,289,4,110,175,227,62,0.01384083044982699,0.3806228373702422,0.6055363321799307,0.7854671280276817,0.21453287197231835
117,426,385,41,350,76,0.903755868544601,0.09624413145539906,0.8215962441314554,0.1784037558685446,210,6,70,134,193,17,0.02857142857142857,0.3333333333333333,0.638095238095238,0.919047619047619,0.08095238095238096
118,15517,13789,1728,12686,2831,0.8886382677063865,0.11136173229361346,0.8175549397435071,0.18244506025649287,5892,183,347,5362,3059,2833,0.031059063136456212,0.05889341479972845,0.9100475220638153,0.5191785471826205,0.4808214528173795
119,2261,1906,355,1789,472,0.8429898275099513,0.15701017249004864,0.7912428129146395,0.20875718708536045,1251,117,196,938,760,491,0.09352517985611511,0.15667466027178256,0.7498001598721024,0.6075139888089528,0.39248601119104715
120,15711,13474,2237,13839,1872,0.8576156832792311,0.1423843167207689,0.8808478136337597,0.11915218636624021,7143,465,1375,5303,5850,1293,0.06509869802603947,0.19249615007699847,0.7424051518969621,0.8189836203275934,0.18101637967240655
121,6085,4961,1124,4798,1287,0.8152834839769926,0.1847165160230074,0.7884963023829088,0.2115036976170912,1456,132,279,1045,1092,364,0.09065934065934066,0.19162087912087913,0.7177197802197802,0.75,0.25
122,29666,26470,3196,25574,4092,0.8922672419604935,0.10773275803950651,0.8620643160520461,0.13793568394795389,14953,111,707,14135,7130,7823,0.007423259546579282,0.04728148197686083,0.9452952584765599,0.476827392496489,0.523172607503511
123,2240,1749,491,2005,235,0.7808035714285714,0.21919642857142857,0.8950892857142857,0.10491071428571429,946,121,300,525,874,72,0.12790697674418605,0.3171247357293869,0.554968287526427,0.9238900634249472,0.07610993657505286
124,1322,1281,41,1286,36,0.9689863842662633,0.031013615733736764,0.972768532526475,0.02723146747352496,32,0,22,10,32,0,0.0,0.6875,0.3125,1.0,0.0
125,3307,2831,476,2707,600,0.8560628968853946,0.1439371031146054,0.8185666767462957,0.18143332325370426,941,80,201,660,581,360,0.08501594048884166,0.21360255047821466,0.7013815090329437,0.6174282678002125,0.38257173219978746
126,2027,1582,445,1643,384,0.7804637395165269,0.2195362604834731,0.8105574740996546,0.18944252590034533,931,78,169,684,638,293,0.08378088077336197,0.18152524167561762,0.7346938775510204,0.6852846401718582,0.3147153598281418
127,983,891,92,616,367,0.9064089521871821,0.0935910478128179,0.6266531027466938,0.3733468972533062,183,4,83,96,144,39,0.02185792349726776,0.453551912568306,0.5245901639344263,0.7868852459016393,0.21311475409836064
128,5075,4132,943,4135,940,0.8141871921182267,0.1858128078817734,0.8147783251231527,0.1852216748768473,2428,76,282,2070,1350,1078,0.03130148270181219,0.11614497528830313,0.8525535420098846,0.556013179571664,0.4439868204283361
129,7022,5749,1273,5353,1669,0.8187126174878951,0.1812873825121048,0.762318427798348,0.23768157220165195,6038,59,192,5787,3454,2584,0.009771447499171911,0.03179860881086453,0.9584299436899636,0.5720437230871149,0.42795627691288507
130,13505,11048,2457,9289,4216,0.8180673824509441,0.1819326175490559,0.6878193261754906,0.3121806738245094,6453,389,514,5550,4260,2193,0.06028203936153727,0.07965287463195413,0.8600650860065086,0.6601580660158066,0.3398419339841934
131,2960,2093,867,2099,861,0.7070945945945946,0.2929054054054054,0.7091216216216216,0.2908783783783784,770,82,166,522,487,283,0.10649350649350649,0.21558441558441557,0.6779220779220779,0.6324675324675325,0.36753246753246754
132,5773,4581,1192,4630,1143,0.793521565910272,0.20647843408972805,0.8020093538887927,0.19799064611120734,2912,86,293,2533,2469,443,0.029532967032967032,0.10061813186813187,0.8698489010989011,0.8478708791208791,0.15212912087912087
133,1464,1168,296,1203,261,0.7978142076502732,0.20218579234972678,0.8217213114754098,0.17827868852459017,519,89,135,295,422,97,0.17148362235067438,0.26011560693641617,0.5684007707129094,0.8131021194605009,0.18689788053949905
134,6233,4689,1544,5334,899,0.7522862185143591,0.24771378148564094,0.8557676881116637,0.14423231188833627,3835,88,230,3517,2273,1562,0.022946544980443285,0.05997392438070404,0.9170795306388527,0.5926988265971317,0.4073011734028683
135,16556,14179,2377,13571,2985,0.8564266731094468,0.14357332689055327,0.8197028267697511,0.18029717323024885,2882,130,640,2112,1289,1593,0.04510756419153366,0.2220680083275503,0.732824427480916,0.4472588480222068,0.5527411519777932
136,10382,9297,1085,8590,1792,0.8954921980350606,0.10450780196493932,0.8273935657869389,0.17260643421306107,5771,751,1316,3704,4099,1672,0.13013342574943684,0.22803673540114364,0.6418298388494195,0.7102755155085774,0.28972448449142263
137,2973,2212,761,2472,501,0.7440295997309115,0.25597040026908846,0.8314833501513622,0.16851664984863773,2165,32,167,1966,1113,1052,0.014780600461893764,0.07713625866050808,0.9080831408775981,0.5140877598152425,0.4859122401847575
138,403,262,141,336,67,0.6501240694789082,0.34987593052109184,0.8337468982630273,0.1662531017369727,602,33,217,352,485,117,0.054817275747508304,0.36046511627906974,0.584717607973422,0.8056478405315615,0.19435215946843853
139,2597,2189,408,1966,631,0.842895648825568,0.15710435117443203,0.7570273392375818,0.24297266076241816,551,44,127,380,348,203,0.07985480943738657,0.23049001814882034,0.6896551724137931,0.631578947368421,0.3684210526315789
140,867,645,222,698,169,0.7439446366782007,0.2560553633217993,0.8050749711649365,0.19492502883506344,712,44,128,540,439,273,0.06179775280898876,0.1797752808988764,0.7584269662921348,0.6165730337078652,0.38342696629213485
141,6869,5652,1217,5310,1559,0.8228271946425971,0.17717280535740282,0.7730382879604019,0.2269617120395982,2458,25,206,2227,1120,1338,0.01017087062652563,0.0838079739625712,0.9060211554109032,0.45565500406834825,0.5443449959316518
142,6319,5580,739,5412,907,0.8830511156828612,0.11694888431713879,0.8564646304795063,0.14353536952049376,1582,78,285,1219,1480,102,0.0493046776232617,0.18015170670037928,0.770543615676359,0.9355246523388117,0.06447534766118837
143,1730,1362,368,1469,261,0.7872832369942196,0.21271676300578035,0.8491329479768787,0.1508670520231214,765,65,185,515,467,298,0.08496732026143791,0.24183006535947713,0.673202614379085,0.6104575163398693,0.3895424836601307
144,1043,954,89,664,379,0.9146692233940557,0.08533077660594439,0.6366251198465963,0.36337488015340363,207,4,88,115,164,43,0.01932367149758454,0.4251207729468599,0.5555555555555556,0.7922705314009661,0.20772946859903382
145,3639,2853,786,2738,901,0.7840065952184666,0.2159934047815334,0.7524045067326188,0.24759549326738114,2163,47,142,1974,1270,893,0.021729079981507166,0.06564956079519187,0.912621359223301,0.5871474803513639,0.4128525196486362
146,659,518,141,568,91,0.7860394537177542,0.21396054628224584,0.8619119878603946,0.13808801213960548,302,37,92,173,274,28,0.12251655629139073,0.304635761589404,0.5728476821192053,0.9072847682119205,0.09271523178807947
147,4133,2995,1138,3509,624,0.7246552141301718,0.2753447858698282,0.8490200822646987,0.15097991773530123,4256,2329,162,1765,3628,628,0.5472274436090225,0.03806390977443609,0.41470864661654133,0.8524436090225563,0.1475563909774436
148,5658,4711,947,4930,728,0.8326263697419582,0.16737363025804172,0.871332626369742,0.12866737363025804,2930,68,454,2408,2019,911,0.023208191126279865,0.15494880546075085,0.8218430034129692,0.6890784982935153,0.31092150170648464
149,2250,1846,404,1880,370,0.8204444444444444,0.17955555555555555,0.8355555555555556,0.16444444444444445,788,85,166,537,522,266,0.10786802030456853,0.21065989847715735,0.6814720812182741,0.6624365482233503,0.33756345177664976
150,6223,5018,1205,4318,1905,0.8063634902780009,0.19363650972199903,0.6938775510204082,0.30612244897959184,3068,75,229,2764,2255,813,0.024445893089960886,0.07464146023468057,0.9009126466753585,0.7350065189048239,0.264993481095176
151,1599,1197,402,1091,508,0.7485928705440901,0.25140712945590993,0.6823014383989994,0.31769856160100063,791,42,139,610,403,388,0.05309734513274336,0.17572692793931732,0.7711757269279393,0.5094816687737042,0.49051833122629585
152,33,24,9,30,3,0.7272727272727273,0.2727272727272727,0.9090909090909091,0.09090909090909091,53,4,12,37,49,4,0.07547169811320754,0.22641509433962265,0.6981132075471698,0.9245283018867925,0.07547169811320754
153,1220,1129,91,763,457,0.9254098360655738,0.07459016393442623,0.6254098360655738,0.37459016393442623,213,4,98,111,160,53,0.018779342723004695,0.460093896713615,0.5211267605633803,0.7511737089201878,0.24882629107981222
154,2082,1679,403,1616,466,0.8064361191162344,0.1935638808837656,0.7761767531219981,0.22382324687800192,1562,30,127,1405,990,572,0.019206145966709345,0.08130601792573623,0.8994878361075545,0.6338028169014085,0.36619718309859156
155,850,629,221,636,214,0.74,0.26,0.7482352941176471,0.25176470588235295,246,15,50,181,163,83,0.06097560975609756,0.2032520325203252,0.7357723577235772,0.6626016260162602,0.33739837398373984
156,4833,3607,1226,4154,679,0.7463273329195117,0.2536726670804883,0.8595075522449824,0.1404924477550176,2246,76,382,1788,1522,724,0.03383793410507569,0.170080142475512,0.7960819234194123,0.6776491540516474,0.3223508459483526
157,974,860,114,825,149,0.8829568788501027,0.11704312114989733,0.8470225872689938,0.15297741273100615,490,12,33,445,415,75,0.024489795918367346,0.0673469387755102,0.9081632653061225,0.8469387755102041,0.15306122448979592
158,1479,1179,300,1207,272,0.7971602434077079,0.2028397565922921,0.8160919540229885,0.1839080459770115,548,85,136,327,433,115,0.1551094890510949,0.24817518248175183,0.5967153284671532,0.7901459854014599,0.20985401459854014
159,1000,696,304,842,158,0.696,0.304,0.842,0.158,597,21,110,466,525,72,0.035175879396984924,0.18425460636515914,0.7805695142378559,0.8793969849246231,0.12060301507537688
160,8672,7344,1328,7399,1273,0.8468634686346863,0.15313653136531366,0.8532057195571956,0.14679428044280443,3105,122,291,2692,1696,1409,0.0392914653784219,0.09371980676328502,0.8669887278582931,0.5462157809983897,0.4537842190016103
161,25360,20664,4696,21039,4321,0.8148264984227129,0.18517350157728707,0.8296135646687697,0.1703864353312303,11251,918,1406,8927,7435,3816,0.0815927473113501,0.12496666962936628,0.7934405830592837,0.6608301484312505,0.33916985156874946
162,23098,18063,5035,19256,3842,0.782015758940168,0.21798424105983202,0.8336652524028054,0.16633474759719455,6864,533,994,5337,5380,1484,0.07765151515151515,0.1448135198135198,0.777534965034965,0.7837995337995338,0.2162004662004662
163,1484,903,581,1293,191,0.6084905660377359,0.3915094339622642,0.8712938005390836,0.12870619946091644,1782,37,572,1173,1355,427,0.020763187429854096,0.32098765432098764,0.6582491582491582,0.7603815937149271,0.23961840628507294
164,2398,2211,187,1567,831,0.9220183486238532,0.0779816513761468,0.6534612176814012,0.34653878231859886,863,4,200,659,727,136,0.004634994206257242,0.23174971031286212,0.7636152954808807,0.8424101969872537,0.15758980301274622
165,3426,2818,608,2826,600,0.822533566841798,0.17746643315820199,0.8248686514886164,0.17513134851138354,1378,74,185,1119,805,573,0.05370101596516691,0.13425253991291727,0.8120464441219158,0.5841799709724238,0.4158200290275762
166,16452,12855,3597,11381,5071,0.7813639679066375,0.21863603209336252,0.6917699975686846,0.3082300024313153,6555,115,494,5946,4151,2404,0.017543859649122806,0.07536231884057971,0.9070938215102975,0.633257055682685,0.366742944317315
167,1679,1280,399,1163,516,0.7623585467540203,0.23764145324597974,0.6926742108397855,0.3073257891602144,656,38,80,538,373,283,0.057926829268292686,0.12195121951219512,0.8201219512195121,0.5685975609756098,0.43140243902439024
168,2058,1530,528,1405,653,0.7434402332361516,0.2565597667638484,0.6827016520894071,0.3172983479105928,3577,106,221,3250,2052,1525,0.029633771316745876,0.061783617556611686,0.9085826111266424,0.5736650824713447,0.4263349175286553
169,2957,2091,866,2097,860,0.7071356104159622,0.2928643895840379,0.7091646939465674,0.29083530605343255,770,82,166,522,487,283,0.10649350649350649,0.21558441558441557,0.6779220779220779,0.6324675324675325,0.36753246753246754
170,428,285,143,362,66,0.6658878504672897,0.3341121495327103,0.8457943925233645,0.1542056074766355,221,12,42,167,177,44,0.05429864253393665,0.19004524886877827,0.755656108597285,0.8009049773755657,0.19909502262443438
171,1419,1322,97,883,536,0.9316420014094433,0.06835799859055673,0.6222692036645525,0.3777307963354475,201,4,90,107,158,43,0.01990049751243781,0.44776119402985076,0.5323383084577115,0.7860696517412935,0.21393034825870647
172,2452,2317,135,1709,743,0.9449429037520392,0.055057096247960846,0.6969820554649266,0.3030179445350734,258,4,111,143,204,54,0.015503875968992248,0.43023255813953487,0.5542635658914729,0.7906976744186046,0.20930232558139536
173,2307,1750,557,1682,625,0.7585609016038145,0.24143909839618552,0.729085392284352,0.270914607715648,1096,54,158,884,642,454,0.04927007299270073,0.14416058394160583,0.8065693430656934,0.5857664233576643,0.4142335766423358
174,968,876,92,604,364,0.9049586776859504,0.09504132231404959,0.6239669421487604,0.3760330578512397,189,4,87,98,150,39,0.021164021164021163,0.4603174603174603,0.5185185185185185,0.7936507936507936,0.20634920634920634
175,947,670,277,742,205,0.7074973600844773,0.2925026399155227,0.7835269271383316,0.21647307286166842,728,39,111,578,464,264,0.05357142857142857,0.15247252747252749,0.7939560439560439,0.6373626373626373,0.3626373626373626
176,139,73,66,76,63,0.5251798561151079,0.4748201438848921,0.5467625899280576,0.45323741007194246,152,8,37,107,87,65,0.05263157894736842,0.24342105263157895,0.7039473684210527,0.5723684210526315,0.4276315789473684
177,5612,5291,321,3330,2282,0.9428011404133999,0.05719885958660014,0.5933713471133286,0.40662865288667144,1012,4,727,281,929,83,0.003952569169960474,0.7183794466403162,0.2776679841897233,0.9179841897233202,0.08201581027667984
178,1471,1153,318,1259,212,0.7838205302515295,0.21617946974847044,0.8558803535010198,0.1441196464989803,517,46,129,342,425,92,0.08897485493230174,0.2495164410058027,0.6615087040618955,0.8220502901353965,0.17794970986460348
179,349,244,105,292,57,0.6991404011461319,0.3008595988538682,0.836676217765043,0.16332378223495703,308,30,67,211,242,66,0.09740259740259741,0.21753246753246752,0.685064935064935,0.7857142857142857,0.21428571428571427
180,13726,11783,1943,11472,2254,0.8584438292292,0.14155617077079993,0.8357860993734518,0.16421390062654817,3754,175,458,3121,2470,1284,0.04661694192860948,0.12200319659030368,0.8313798614810869,0.6579648375066596,0.34203516249334043
181,598,408,190,470,128,0.6822742474916388,0.3177257525083612,0.7859531772575251,0.2140468227424749,518,43,92,383,337,181,0.08301158301158301,0.1776061776061776,0.7393822393822393,0.6505791505791506,0.34942084942084944
182,3307,3103,204,2138,1169,0.9383126700937405,0.06168732990625945,0.6465074085273662,0.3534925914726338,947,4,459,484,711,236,0.004223864836325237,0.48468848996832103,0.5110876451953538,0.750791974656811,0.249208025343189
183,1131,792,339,730,401,0.7002652519893899,0.29973474801061006,0.6454465075154731,0.35455349248452694,510,27,103,380,317,193,0.052941176470588235,0.2019607843137255,0.7450980392156863,0.6215686274509804,0.3784313725490196
184,10,3,7,2,8,0.3,0.7,0.2,0.8,30,1,4,25,24,6,0.03333333333333333,0.13333333333333333,0.8333333333333334,0.8,0.2
185,3392,2506,886,2691,701,0.7387971698113207,0.26120283018867924,0.7933372641509434,0.20666273584905662,1566,100,221,1245,999,567,0.06385696040868455,0.14112388250319285,0.7950191570881227,0.6379310344827587,0.3620689655172414
186,3362,2707,655,2858,504,0.8051754907792981,0.19482450922070196,0.8500892325996431,0.14991076740035694,1374,74,280,1020,891,483,0.053857350800582245,0.20378457059679767,0.74235807860262,0.648471615720524,0.35152838427947597
187,5247,4061,1186,4309,938,0.7739660758528683,0.2260339241471317,0.8212311797217458,0.17876882027825425,5153,111,879,4163,2517,2636,0.021540849990296915,0.17058024451775664,0.8078789054919464,0.48845332815835435,0.5115466718416456
188,1820,1584,236,1535,285,0.8703296703296703,0.12967032967032968,0.8434065934065934,0.1565934065934066,480,57,159,264,405,75,0.11875,0.33125,0.55,0.84375,0.15625
189,2167,1564,603,1451,716,0.721735117674204,0.27826488232579605,0.6695892939547762,0.3304107060452238,2895,71,100,2724,1693,1202,0.02452504317789292,0.03454231433506045,0.9409326424870467,0.5848013816925735,0.4151986183074266
190,4033,3459,574,3679,354,0.8576741879494173,0.1423258120505827,0.9122241507562608,0.08777584924373916,1636,91,268,1277,1217,419,0.055623471882640586,0.16381418092909536,0.780562347188264,0.7438875305623472,0.2561124694376528
191,339,235,104,269,70,0.6932153392330384,0.30678466076696165,0.7935103244837758,0.20648967551622419,157,6,43,108,132,25,0.03821656050955414,0.27388535031847133,0.6878980891719745,0.8407643312101911,0.1592356687898089
192,14,10,4,5,9,0.7142857142857143,0.2857142857142857,0.35714285714285715,0.6428571428571429,56,5,11,40,41,15,0.08928571428571429,0.19642857142857142,0.7142857142857143,0.7321428571428571,0.26785714285714285
193,2040,1838,202,1865,175,0.9009803921568628,0.09901960784313725,0.9142156862745098,0.0857843137254902,1404,313,247,844,1351,53,0.22293447293447294,0.17592592592592593,0.6011396011396012,0.9622507122507122,0.03774928774928775
194,1126,759,367,913,213,0.6740674955595026,0.3259325044404973,0.8108348134991119,0.1891651865008881,794,33,193,568,691,103,0.041561712846347604,0.24307304785894207,0.7153652392947103,0.8702770780856424,0.1297229219143577
195,1399,1145,254,1047,352,0.8184417441029307,0.18155825589706934,0.7483917083631165,0.2516082916368835,544,63,184,297,369,175,0.11580882352941177,0.3382352941176471,0.5459558823529411,0.6783088235294118,0.32169117647058826
196,8934,7444,1490,7021,1913,0.8332214013879561,0.1667785986120439,0.785874188493396,0.21412581150660398,1536,48,201,1287,921,615,0.03125,0.130859375,0.837890625,0.599609375,0.400390625
197,1463,1101,362,1245,218,0.7525632262474368,0.24743677375256323,0.8509911141490089,0.14900888585099112,554,50,160,344,511,43,0.09025270758122744,0.2888086642599278,0.6209386281588448,0.9223826714801444,0.0776173285198556
198,1546,1119,427,1030,516,0.7238033635187581,0.27619663648124193,0.666235446313066,0.33376455368693403,842,19,108,715,458,384,0.022565320665083134,0.12826603325415678,0.8491686460807601,0.5439429928741093,0.45605700712589076
199,1556,1116,440,1158,398,0.7172236503856041,0.2827763496143959,0.7442159383033419,0.25578406169665807,1242,5,264,973,841,401,0.004025764895330112,0.21256038647342995,0.78341384863124,0.677133655394525,0.32286634460547503
200,218,176,42,186,32,0.8073394495412844,0.1926605504587156,0.8532110091743119,0.14678899082568808,409,25,70,314,306,103,0.061124694376528114,0.17114914425427874,0.7677261613691931,0.7481662591687042,0.25183374083129584
201,1081,983,98,684,397,0.9093432007400555,0.09065679925994449,0.6327474560592045,0.36725254394079554,278,4,109,165,224,54,0.014388489208633094,0.3920863309352518,0.5935251798561151,0.8057553956834532,0.19424460431654678
202,1365,859,506,823,542,0.6293040293040293,0.3706959706959707,0.6029304029304029,0.39706959706959705,549,19,140,390,329,220,0.03460837887067395,0.2550091074681239,0.7103825136612022,0.599271402550091,0.4007285974499089
203,24084,20785,3299,20291,3793,0.8630210928417207,0.13697890715827934,0.842509549908653,0.15749045009134696,13210,210,825,12175,5183,8027,0.015897047691143074,0.06245268735806207,0.9216502649507948,0.3923542770628312,0.6076457229371688
204,10081,8335,1746,8206,1875,0.8268028965380418,0.17319710346195813,0.8140065469695467,0.18599345303045334,5163,138,436,4589,2999,2164,0.02672864613596746,0.08444702692233198,0.8888243269417005,0.5808638388533798,0.41913616114662017
205,1013,718,295,663,350,0.7087857847976308,0.2912142152023692,0.6544916090819348,0.3455083909180652,490,11,122,357,290,200,0.022448979591836733,0.24897959183673468,0.7285714285714285,0.5918367346938775,0.40816326530612246
206,1015,719,296,883,132,0.7083743842364532,0.2916256157635468,0.8699507389162562,0.13004926108374384,679,12,125,542,629,50,0.017673048600883652,0.18409425625920472,0.7982326951399117,0.9263622974963182,0.07363770250368189
207,1660,1370,290,1420,240,0.8253012048192772,0.1746987951807229,0.8554216867469879,0.14457831325301204,1250,20,81,1149,552,698,0.016,0.0648,0.9192,0.4416,0.5584
208,1290,998,292,878,412,0.7736434108527132,0.22635658914728682,0.6806201550387597,0.31937984496124033,879,69,197,613,689,190,0.07849829351535836,0.2241183162684869,0.6973833902161547,0.7838452787258248,0.2161547212741752
209,994,749,245,891,103,0.7535211267605634,0.24647887323943662,0.8963782696177063,0.10362173038229376,385,9,86,290,312,73,0.023376623376623377,0.22337662337662337,0.7532467532467533,0.8103896103896104,0.18961038961038962
210,3895,3406,489,3364,531,0.8744544287548138,0.12554557124518614,0.8636713735558408,0.1363286264441592,1483,77,389,1017,891,592,0.051921780175320294,0.26230613621038434,0.6857720836142953,0.6008091706001348,0.39919082939986517
211,41061,35153,5908,35033,6028,0.8561165095833029,0.1438834904166971,0.8531940283967755,0.14680597160322448,9560,590,1084,7886,5518,4042,0.06171548117154812,0.11338912133891213,0.8248953974895398,0.5771966527196652,0.42280334728033475
212,3789,3634,155,2457,1332,0.9590921087358142,0.0409078912641858,0.6484560570071259,0.3515439429928741,431,4,130,297,361,70,0.009280742459396751,0.30162412993039445,0.6890951276102089,0.8375870069605569,0.16241299303944315
213,2194,1702,492,1819,375,0.7757520510483136,0.22424794895168643,0.8290793072014585,0.17092069279854147,910,54,192,664,671,239,0.05934065934065934,0.210989010989011,0.7296703296703296,0.7373626373626374,0.26263736263736265
214,5215,4309,906,4313,902,0.8262703739213806,0.17372962607861936,0.8270373921380633,0.17296260786193673,1422,114,300,1008,1132,290,0.08016877637130802,0.2109704641350211,0.7088607594936709,0.7960618846694796,0.2039381153305204
215,5721,5021,700,4658,1063,0.8776437685719279,0.12235623142807202,0.8141933228456564,0.18580667715434365,2561,22,497,2042,1387,1174,0.008590394377196407,0.19406481843030066,0.7973447871925029,0.5415853182350644,0.45841468176493555
216,326,240,86,267,59,0.7361963190184049,0.26380368098159507,0.8190184049079755,0.18098159509202455,240,4,31,205,193,47,0.016666666666666666,0.12916666666666668,0.8541666666666666,0.8041666666666667,0.19583333333333333
217,1012,918,94,631,381,0.9071146245059288,0.09288537549407115,0.6235177865612648,0.37648221343873517,192,4,90,98,153,39,0.020833333333333332,0.46875,0.5104166666666666,0.796875,0.203125
218,126,73,53,43,83,0.5793650793650794,0.42063492063492064,0.3412698412698413,0.6587301587301587,120,1,20,99,61,59,0.008333333333333333,0.16666666666666666,0.825,0.5083333333333333,0.49166666666666664
219,4725,3942,783,3844,881,0.8342857142857143,0.1657142857142857,0.8135449735449736,0.18645502645502646,1730,90,251,1389,1074,656,0.05202312138728324,0.14508670520231215,0.8028901734104046,0.6208092485549133,0.3791907514450867
220,98,61,37,82,16,0.6224489795918368,0.37755102040816324,0.8367346938775511,0.16326530612244897,132,29,32,71,122,10,0.2196969696969697,0.24242424242424243,0.5378787878787878,0.9242424242424242,0.07575757575757576
221,5726,4794,932,5366,360,0.8372336709745023,0.16276632902549773,0.9371288857841426,0.06287111421585749,3048,117,356,2575,1505,1543,0.038385826771653545,0.1167979002624672,0.8448162729658792,0.49376640419947504,0.506233595800525
222,1822,1297,525,1427,395,0.7118551042810098,0.2881448957189901,0.783205268935236,0.216794731064764,2042,27,110,1905,1047,995,0.013222331047992164,0.05386875612144956,0.9329089128305583,0.5127326150832517,0.48726738491674826
223,1666,1275,391,1217,449,0.7653061224489796,0.23469387755102042,0.7304921968787516,0.2695078031212485,863,69,153,641,394,469,0.07995365005793743,0.1772885283893395,0.7427578215527231,0.45654692931633833,0.5434530706836617
224,34322,27181,7141,26866,7456,0.7919410290775596,0.2080589709224404,0.782763242235301,0.21723675776469903,8059,220,856,6983,3743,4316,0.027298672291847625,0.10621665219009803,0.8664846755180543,0.46444968358357114,0.5355503164164288
225,12654,11150,1504,10160,2494,0.8811443021969337,0.11885569780306622,0.802908171329224,0.19709182867077604,4184,171,687,3326,2816,1368,0.04086998087954111,0.16419694072657745,0.7949330783938815,0.6730401529636711,0.32695984703632885
226,80,40,40,69,11,0.5,0.5,0.8625,0.1375,123,3,32,88,108,15,0.024390243902439025,0.2601626016260163,0.7154471544715447,0.8780487804878049,0.12195121951219512
227,1479,1179,300,1207,272,0.7971602434077079,0.2028397565922921,0.8160919540229885,0.1839080459770115,548,85,136,327,433,115,0.1551094890510949,0.24817518248175183,0.5967153284671532,0.7901459854014599,0.20985401459854014
228,1802,1432,370,1472,330,0.7946725860155383,0.20532741398446172,0.8168701442841287,0.18312985571587126,683,78,154,451,511,172,0.11420204978038068,0.22547584187408493,0.6603221083455344,0.7481698389458272,0.2518301610541728
229,1442,1026,416,916,526,0.7115117891816921,0.2884882108183079,0.6352288488210819,0.3647711511789182,665,19,125,521,373,292,0.02857142857142857,0.18796992481203006,0.7834586466165413,0.5609022556390978,0.43909774436090226
230,3844,2979,865,2842,1002,0.7749739854318418,0.22502601456815816,0.7393340270551508,0.2606659729448491,2031,56,177,1798,1269,762,0.027572624322993598,0.08714918759231906,0.8852781880846874,0.6248153618906942,0.37518463810930575
231,1196,1108,88,767,429,0.9264214046822743,0.07357859531772576,0.6413043478260869,0.358695652173913,180,4,78,98,139,41,0.022222222222222223,0.43333333333333335,0.5444444444444444,0.7722222222222223,0.22777777777777777
232,21266,18083,3183,16329,4937,0.8503244615818678,0.14967553841813222,0.7678453870027273,0.23215461299727264,10642,284,1453,8905,6104,4538,0.026686713023867693,0.13653448599887238,0.8367788009772599,0.5735763954143958,0.4264236045856042
233,2014,1612,402,1279,735,0.8003972194637538,0.19960278053624628,0.6350546176762661,0.36494538232373386,1343,6,134,1203,1158,185,0.004467609828741623,0.09977661950856292,0.8957557706626954,0.8622486969471332,0.1377513030528667
234,30994,26622,4372,25800,5194,0.8589404400851778,0.14105955991482222,0.8324191779054011,0.16758082209459896,12397,74,600,11723,5626,6771,0.005969186093409696,0.04839880616278132,0.945632007743809,0.45381947245301285,0.5461805275469872
235,5843,4225,1618,4028,1815,0.723087455074448,0.27691254492555195,0.689371897997604,0.31062810200239604,1213,68,215,930,688,525,0.05605935696619951,0.17724649629018963,0.7666941467436109,0.5671887881286067,0.43281121187139326
236,960,870,90,600,360,0.90625,0.09375,0.625,0.375,290,4,105,181,216,74,0.013793103448275862,0.3620689655172414,0.6241379310344828,0.7448275862068966,0.25517241379310346
237,34322,27181,7141,26866,7456,0.7919410290775596,0.2080589709224404,0.782763242235301,0.21723675776469903,8059,220,856,6983,3743,4316,0.027298672291847625,0.10621665219009803,0.8664846755180543,0.46444968358357114,0.5355503164164288
238,1059,969,90,670,389,0.9150141643059491,0.08498583569405099,0.6326723323890463,0.36732766761095376,198,4,82,112,153,45,0.020202020202020204,0.41414141414141414,0.5656565656565656,0.7727272727272727,0.22727272727272727
239,7128,6017,1111,5616,1512,0.8441358024691358,0.1558641975308642,0.7878787878787878,0.21212121212121213,2164,142,462,1560,1631,533,0.06561922365988909,0.2134935304990758,0.7208872458410351,0.7536968576709797,0.24630314232902034
240,166,109,57,103,63,0.6566265060240963,0.3433734939759036,0.6204819277108434,0.3795180722891566,182,30,52,100,127,55,0.16483516483516483,0.2857142857142857,0.5494505494505495,0.6978021978021978,0.3021978021978022
241,3201,2493,708,2412,789,0.7788191190253045,0.2211808809746954,0.753514526710403,0.246485473289597,849,55,211,583,570,279,0.06478209658421673,0.24852767962308597,0.6866902237926973,0.6713780918727915,0.3286219081272085
242,217,175,42,187,30,0.8064516129032258,0.1935483870967742,0.8617511520737328,0.1382488479262673,422,25,71,326,313,109,0.05924170616113744,0.16824644549763032,0.7725118483412322,0.7417061611374408,0.25829383886255924
243,21223,19172,2051,17403,3820,0.9033595627385383,0.09664043726146163,0.8200065966168779,0.17999340338312209,2014,0,130,1884,237,1777,0.0,0.06454816285998013,0.9354518371400199,0.11767626613704071,0.8823237338629593
244,7313,5841,1472,5807,1506,0.7987146178039108,0.20128538219608916,0.794065363052099,0.205934636947901,3735,92,629,3014,2199,1536,0.02463186077643909,0.16840696117804552,0.8069611780455154,0.5887550200803213,0.41124497991967873
245,80,36,44,66,14,0.45,0.55,0.825,0.175,226,2,129,95,199,27,0.008849557522123894,0.5707964601769911,0.42035398230088494,0.8805309734513275,0.11946902654867257
246,14720,12490,2230,11038,3682,0.8485054347826086,0.1514945652173913,0.7498641304347826,0.2501358695652174,8683,178,884,7621,5065,3618,0.020499827248646782,0.10180813083035817,0.877692041920995,0.5833237360359322,0.4166762639640677
247,1642,1259,383,1207,435,0.7667478684531059,0.23325213154689403,0.7350791717417783,0.26492082825822166,778,49,89,640,425,353,0.06298200514138817,0.11439588688946016,0.8226221079691517,0.5462724935732648,0.4537275064267352
248,943,724,219,810,133,0.767762460233298,0.23223753976670203,0.8589607635206787,0.14103923647932132,463,22,69,372,329,134,0.047516198704103674,0.1490280777537797,0.8034557235421166,0.7105831533477321,0.2894168466522678
249,0,0,0,0,0,0.0,0.0,0.0,0.0,0,0,0,0,0,0,0.0,0.0,0.0,0.0,0.0
250,5268,4310,958,4633,635,0.8181473044798785,0.18185269552012148,0.8794608959757023,0.12053910402429764,3292,111,412,2769,2619,673,0.03371810449574727,0.12515188335358446,0.8411300121506683,0.7955650060753341,0.20443499392466585
251,974,860,114,825,149,0.8829568788501027,0.11704312114989733,0.8470225872689938,0.15297741273100615,490,12,33,445,415,75,0.024489795918367346,0.0673469387755102,0.9081632653061225,0.8469387755102041,0.15306122448979592
252,5170,4678,492,4584,586,0.9048355899419729,0.09516441005802707,0.8866537717601547,0.11334622823984526,2677,40,411,2226,1290,1387,0.014942099364960777,0.15353007097497198,0.8315278296600672,0.48188270451998505,0.518117295480015
253,320,240,80,225,95,0.75,0.25,0.703125,0.296875,159,5,20,134,85,74,0.031446540880503145,0.12578616352201258,0.8427672955974843,0.5345911949685535,0.46540880503144655
254,5506,4313,1193,5060,446,0.7833272793316383,0.2166727206683618,0.9189974573192881,0.08100254268071196,11627,281,1190,10156,9625,2002,0.024167885095037412,0.10234798314268513,0.8734841317622775,0.8278145695364238,0.17218543046357615
255,259,149,110,223,36,0.5752895752895753,0.4247104247104247,0.861003861003861,0.138996138996139,343,3,146,194,309,34,0.008746355685131196,0.42565597667638483,0.565597667638484,0.9008746355685131,0.09912536443148688
256,834,610,224,730,104,0.7314148681055156,0.2685851318944844,0.8752997601918465,0.12470023980815348,422,11,64,347,317,105,0.026066350710900472,0.15165876777251186,0.8222748815165877,0.7511848341232228,0.24881516587677724
257,384,332,52,327,57,0.8645833333333334,0.13541666666666666,0.8515625,0.1484375,201,28,63,110,181,20,0.13930348258706468,0.31343283582089554,0.5472636815920398,0.900497512437811,0.09950248756218906
258,327,240,87,268,59,0.7339449541284404,0.26605504587155965,0.8195718654434251,0.18042813455657492,240,4,31,205,193,47,0.016666666666666666,0.12916666666666668,0.8541666666666666,0.8041666666666667,0.19583333333333333
259,961,876,85,600,361,0.9115504682622269,0.08844953173777315,0.6243496357960457,0.3756503642039542,209,4,106,99,168,41,0.019138755980861243,0.507177033492823,0.47368421052631576,0.8038277511961722,0.19617224880382775
260,7373,6149,1224,5993,1380,0.8339888783398888,0.16601112166011123,0.8128305981283059,0.187169401871694,4293,80,378,3835,2081,2212,0.01863498718844631,0.0880503144654088,0.8933146983461449,0.4847426042394596,0.5152573957605404
261,1062,958,104,668,394,0.9020715630885122,0.09792843691148775,0.6290018832391714,0.3709981167608286,296,4,125,167,254,42,0.013513513513513514,0.4222972972972973,0.5641891891891891,0.8581081081081081,0.14189189189189189
262,24033,21067,2966,19681,4352,0.8765863604210876,0.12341363957891233,0.8189156576374153,0.18108434236258478,3341,67,464,2810,1282,2059,0.02005387608500449,0.13888057467824005,0.8410655492367555,0.3837174498653098,0.6162825501346902
263,5791,4596,1195,4647,1144,0.7936453116905543,0.2063546883094457,0.8024520808150578,0.19754791918494216,2926,86,293,2547,2483,443,0.02939166097060834,0.10013670539986329,0.8704716336295284,0.8485987696514012,0.15140123034859876
264,12983,10116,2867,9620,3363,0.7791727643841947,0.22082723561580528,0.7409689594084572,0.2590310405915428,6447,234,1362,4851,5284,1163,0.03629595160539786,0.21126105165193113,0.752442996742671,0.8196060183030867,0.18039398169691329
265,7461,5942,1519,5733,1728,0.7964079882053344,0.2035920117946656,0.7683956574185766,0.2316043425814234,9021,80,300,8641,5677,3344,0.008868196430550937,0.03325573661456601,0.957876066954883,0.6293093892029709,0.37069061079702914
266,1423,1240,183,1242,181,0.8713984539704849,0.1286015460295151,0.8728039353478566,0.12719606465214336,701,15,51,635,391,310,0.021398002853067047,0.07275320970042796,0.905848787446505,0.557774607703281,0.442225392296719
267,58,33,25,31,27,0.5689655172413793,0.43103448275862066,0.5344827586206896,0.46551724137931033,96,5,26,65,71,25,0.052083333333333336,0.2708333333333333,0.6770833333333334,0.7395833333333334,0.2604166666666667
268,2320,1955,365,1912,408,0.8426724137931034,0.15732758620689655,0.8241379310344827,0.17586206896551723,830,98,170,562,572,258,0.1180722891566265,0.20481927710843373,0.6771084337349398,0.689156626506024,0.3108433734939759
269,43,26,17,20,23,0.6046511627906976,0.3953488372093023,0.46511627906976744,0.5348837209302325,61,3,22,36,38,23,0.04918032786885246,0.36065573770491804,0.5901639344262295,0.6229508196721312,0.3770491803278688
270,16543,14547,1996,13620,2923,0.8793447379556307,0.12065526204436922,0.8233089524270084,0.1766910475729916,3916,89,420,3407,2161,1755,0.022727272727272728,0.10725229826353422,0.8700204290091931,0.5518386108273748,0.4481613891726251
271,978,880,98,606,372,0.8997955010224948,0.10020449897750511,0.6196319018404908,0.3803680981595092,237,4,102,131,197,40,0.016877637130801686,0.43037974683544306,0.5527426160337553,0.8312236286919831,0.16877637130801687
272,179,121,58,155,24,0.6759776536312849,0.3240223463687151,0.8659217877094972,0.1340782122905028,392,3,176,213,312,80,0.007653061224489796,0.4489795918367347,0.5433673469387755,0.7959183673469388,0.20408163265306123
273,238,192,46,206,32,0.8067226890756303,0.19327731092436976,0.865546218487395,0.13445378151260504,137,30,44,63,129,8,0.21897810218978103,0.32116788321167883,0.45985401459854014,0.9416058394160584,0.058394160583941604
274,853,721,132,725,128,0.8452520515826495,0.15474794841735054,0.8499413833528722,0.15005861664712777,272,45,94,133,255,17,0.16544117647058823,0.34558823529411764,0.4889705882352941,0.9375,0.0625
275,3793,3089,704,3116,677,0.8143949380437648,0.18560506195623516,0.8215133139994727,0.17848668600052728,1589,87,275,1227,1068,521,0.05475141598489616,0.17306482064191314,0.7721837633731907,0.672120830711139,0.3278791692888609
276,3511,2741,770,2963,548,0.7806892623184278,0.2193107376815722,0.8439191113642837,0.15608088863571631,1613,81,187,1345,969,644,0.050216986980781156,0.11593304401735896,0.8338499690018599,0.6007439553626782,0.3992560446373218
277,5677,4953,724,4719,958,0.8724678527391228,0.12753214726087722,0.8312488990664083,0.1687511009335917,6643,1518,1923,3202,5614,1029,0.22851121481258468,0.2894776456420292,0.4820111395453861,0.845100105374078,0.15489989462592202
278,82,79,3,50,32,0.9634146341463414,0.036585365853658534,0.6097560975609756,0.3902439024390244,88,5,32,51,81,7,0.056818181818181816,0.36363636363636365,0.5795454545454546,0.9204545454545454,0.07954545454545454
279,14,5,9,11,3,0.35714285714285715,0.6428571428571429,0.7857142857142857,0.21428571428571427,271,0,6,265,250,21,0.0,0.02214022140221402,0.977859778597786,0.922509225092251,0.07749077490774908
280,659,527,132,569,90,0.7996965098634294,0.20030349013657056,0.8634294385432474,0.13657056145675264,266,41,84,141,249,17,0.15413533834586465,0.3157894736842105,0.5300751879699248,0.9360902255639098,0.06390977443609022
281,3511,2741,770,2963,548,0.7806892623184278,0.2193107376815722,0.8439191113642837,0.15608088863571631,1613,81,187,1345,969,644,0.050216986980781156,0.11593304401735896,0.8338499690018599,0.6007439553626782,0.3992560446373218
282,3522,2975,547,2915,607,0.8446905167518456,0.15530948324815447,0.8276547416240773,0.17234525837592277,1236,100,267,869,792,444,0.08090614886731391,0.21601941747572814,0.7030744336569579,0.6407766990291263,0.3592233009708738
283,1590,1253,337,1324,266,0.7880503144654089,0.2119496855345912,0.8327044025157233,0.16729559748427672,697,85,145,467,497,200,0.12195121951219512,0.20803443328550933,0.6700143472022956,0.7130559540889526,0.28694404591104733
284,1775,1518,257,1523,252,0.8552112676056338,0.1447887323943662,0.8580281690140845,0.14197183098591548,1063,158,204,701,974,89,0.14863593603010347,0.19190968955785512,0.6594543744120414,0.916274694261524,0.08372530573847602
285,13082,10818,2264,10216,2866,0.826937777098303,0.17306222290169698,0.7809203485705549,0.21907965142944505,7655,182,415,7058,3637,4018,0.023775310254735466,0.05421293272370999,0.9220117570215546,0.4751143043762247,0.5248856956237753
286,653,393,260,550,103,0.6018376722817764,0.3981623277182236,0.8422664624808576,0.15773353751914243,1004,29,194,781,724,280,0.02888446215139442,0.19322709163346613,0.7778884462151394,0.7211155378486056,0.2788844621513944
287,4758,3944,814,4334,424,0.8289197141656158,0.1710802858343842,0.9108869272803699,0.0891130727196301,2451,70,548,1833,1879,572,0.028559771521827825,0.22358221134230927,0.7478580171358629,0.766625866993064,0.23337413300693594
288,467,287,180,265,202,0.6145610278372591,0.3854389721627409,0.5674518201284796,0.43254817987152033,296,13,75,208,152,144,0.04391891891891892,0.2533783783783784,0.7027027027027027,0.5135135135135135,0.4864864864864865
289,964,771,193,828,136,0.799792531120332,0.20020746887966806,0.8589211618257261,0.14107883817427386,371,58,120,193,351,20,0.15633423180592992,0.32345013477088946,0.5202156334231806,0.9460916442048517,0.05390835579514825
290,6365,4938,1427,5204,1161,0.7758051846032993,0.22419481539670072,0.8175962293794187,0.1824037706205813,1728,172,319,1237,1456,272,0.09953703703703703,0.18460648148148148,0.7158564814814815,0.8425925925925926,0.1574074074074074
291,5828,4952,876,4667,1161,0.849691146190803,0.15030885380919698,0.8007892930679479,0.19921070693205217,1501,65,202,1234,933,568,0.04330446369087275,0.1345769487008661,0.8221185876082612,0.6215856095936043,0.37841439040639574
292,1607,1206,401,1221,386,0.7504667081518357,0.24953329184816428,0.7598008711885501,0.24019912881144992,729,34,85,610,518,211,0.04663923182441701,0.11659807956104253,0.8367626886145405,0.710562414266118,0.289437585733882
293,1020,928,92,649,371,0.9098039215686274,0.09019607843137255,0.6362745098039215,0.3637254901960784,181,4,85,92,142,39,0.022099447513812154,0.4696132596685083,0.5082872928176796,0.7845303867403315,0.2154696132596685
294,1184,970,214,996,188,0.8192567567567568,0.18074324324324326,0.8412162162162162,0.15878378378378377,539,45,151,343,416,123,0.08348794063079777,0.28014842300556586,0.6363636363636364,0.7717996289424861,0.22820037105751392
295,61,33,28,50,11,0.5409836065573771,0.45901639344262296,0.819672131147541,0.18032786885245902,104,3,34,67,98,6,0.028846153846153848,0.3269230769230769,0.6442307692307693,0.9423076923076923,0.057692307692307696
296,1252,1045,207,1089,163,0.8346645367412141,0.16533546325878595,0.8698083067092651,0.13019169329073482,1373,3,225,1145,868,505,0.0021849963583394027,0.1638747268754552,0.8339402767662054,0.6321922796795338,0.36780772032046616
297,41061,35153,5908,35033,6028,0.8561165095833029,0.1438834904166971,0.8531940283967755,0.14680597160322448,9560,590,1084,7886,5518,4042,0.06171548117154812,0.11338912133891213,0.8248953974895398,0.5771966527196652,0.42280334728033475
298,1006,914,92,634,372,0.9085487077534792,0.09145129224652088,0.6302186878727635,0.3697813121272366,224,4,86,134,176,48,0.017857142857142856,0.38392857142857145,0.5982142857142857,0.7857142857142857,0.21428571428571427
299,11838,9581,2257,10485,1353,0.8093427943909444,0.19065720560905558,0.8857070451089711,0.11429295489102889,5754,189,386,5179,3401,2353,0.032846715328467155,0.06708376781369482,0.900069516857838,0.5910670837678137,0.4089329162321863
300,14461,12359,2102,11967,2494,0.8546435239609985,0.14535647603900145,0.8275361316644768,0.17246386833552313,6277,78,461,5738,3843,2434,0.012426318304922733,0.07344272741755616,0.9141309542775211,0.6122351441771547,0.3877648558228453
301,972,880,92,614,358,0.9053497942386831,0.09465020576131687,0.6316872427983539,0.3683127572016461,174,4,81,89,134,40,0.022988505747126436,0.46551724137931033,0.5114942528735632,0.7701149425287356,0.22988505747126436
302,35,16,19,14,21,0.45714285714285713,0.5428571428571428,0.4,0.6,66,4,23,39,41,25,0.06060606060606061,0.3484848484848485,0.5909090909090909,0.6212121212121212,0.3787878787878788
303,1163,877,286,1008,155,0.7540842648323302,0.24591573516766982,0.8667239896818573,0.13327601031814273,610,9,109,492,411,199,0.014754098360655738,0.17868852459016393,0.8065573770491803,0.6737704918032786,0.3262295081967213
304,2292,1865,427,1852,440,0.8136998254799301,0.1863001745200698,0.8080279232111692,0.19197207678883071,1308,17,99,1192,788,520,0.012996941896024464,0.07568807339449542,0.9113149847094801,0.6024464831804281,0.39755351681957185
305,3157,2311,846,2472,685,0.7320240734874881,0.2679759265125119,0.7830218561925879,0.2169781438074121,2884,28,443,2413,1583,1301,0.009708737864077669,0.15360610263522884,0.8366851595006934,0.5488904299583911,0.4511095700416089
306,9667,8122,1545,7768,1899,0.8401779248991414,0.15982207510085858,0.8035584979828282,0.1964415020171718,4714,257,712,3745,2770,1944,0.054518455663979636,0.15103945693678406,0.7944420873992363,0.587611370386084,0.412388629613916
307,4844,4023,821,4167,677,0.8305119735755574,0.1694880264244426,0.8602394715111478,0.13976052848885218,1592,62,179,1351,947,645,0.038944723618090454,0.11243718592964824,0.8486180904522613,0.5948492462311558,0.40515075376884424
308,1475,1042,433,991,484,0.7064406779661017,0.2935593220338983,0.671864406779661,0.328135593220339,694,29,145,520,400,294,0.04178674351585014,0.20893371757925072,0.7492795389048992,0.5763688760806917,0.42363112391930835
309,299,205,94,263,36,0.68561872909699,0.31438127090301005,0.8795986622073578,0.12040133779264214,238,19,57,162,219,19,0.07983193277310924,0.23949579831932774,0.680672268907563,0.9201680672268907,0.07983193277310924
310,1673,1378,295,1386,287,0.8236700537955768,0.1763299462044232,0.8284518828451883,0.17154811715481172,667,100,185,382,532,135,0.14992503748125938,0.2773613193403298,0.5727136431784108,0.7976011994002998,0.20239880059970014
311,7856,6694,1162,6570,1286,0.8520875763747454,0.14791242362525459,0.8363034623217923,0.16369653767820774,2887,109,295,2483,864,2023,0.03775545549012816,0.10218219605126429,0.8600623484586075,0.2992726013162452,0.7007273986837548
312,253,156,97,135,118,0.616600790513834,0.383399209486166,0.5335968379446641,0.466403162055336,178,22,43,113,142,36,0.12359550561797752,0.24157303370786518,0.6348314606741573,0.797752808988764,0.20224719101123595
313,1218,1122,96,782,436,0.9211822660098522,0.07881773399014778,0.6420361247947455,0.3579638752052545,187,4,84,99,148,39,0.0213903743315508,0.44919786096256686,0.5294117647058824,0.7914438502673797,0.20855614973262032
314,12656,11151,1505,10162,2494,0.8810840707964602,0.11891592920353983,0.8029393173198482,0.1970606826801517,4184,173,687,3324,2816,1368,0.041347992351816444,0.16419694072657745,0.7944550669216062,0.6730401529636711,0.32695984703632885
315,2974,2468,506,2488,486,0.8298587760591796,0.17014122394082046,0.8365837256220578,0.16341627437794218,923,59,200,664,722,201,0.06392199349945829,0.21668472372697725,0.7193932827735645,0.7822318526543879,0.21776814734561215
316,73,35,38,60,13,0.4794520547945205,0.5205479452054794,0.821917808219178,0.1780821917808219,163,3,77,83,143,20,0.018404907975460124,0.4723926380368098,0.50920245398773,0.8773006134969326,0.12269938650306748
317,9302,7026,2276,7875,1427,0.7553214362502687,0.24467856374973124,0.8465921307245754,0.15340786927542463,5581,123,419,5039,3309,2272,0.02203906110016126,0.07507615122737861,0.9028847876724602,0.5929044974018993,0.4070955025981007
318,1103,866,237,737,366,0.785131459655485,0.21486854034451497,0.6681776971894833,0.3318223028105168,485,44,67,374,372,113,0.09072164948453608,0.13814432989690723,0.7711340206185567,0.7670103092783506,0.2329896907216495
319,770,509,261,578,192,0.6610389610389611,0.33896103896103896,0.7506493506493507,0.24935064935064935,505,25,95,385,373,132,0.04950495049504951,0.18811881188118812,0.7623762376237624,0.7386138613861386,0.2613861386138614
320,12248,9790,2458,9479,2769,0.7993141737426519,0.20068582625734813,0.7739222730241672,0.22607772697583278,1450,65,188,1197,766,684,0.04482758620689655,0.1296551724137931,0.8255172413793104,0.5282758620689655,0.47172413793103446
321,4015,3718,297,3261,754,0.9260273972602739,0.07397260273972603,0.8122042341220423,0.18779576587795765,1486,6,253,1227,1131,355,0.004037685060565276,0.1702557200538358,0.8257065948855989,0.7611036339165546,0.2388963660834455
322,5040,4172,868,4177,863,0.8277777777777777,0.17222222222222222,0.8287698412698413,0.17123015873015873,1156,49,185,922,847,309,0.04238754325259515,0.16003460207612458,0.7975778546712803,0.7326989619377162,0.2673010380622837
323,236,165,71,154,82,0.6991525423728814,0.3008474576271186,0.652542372881356,0.3474576271186441,223,31,37,155,128,95,0.13901345291479822,0.16591928251121077,0.695067264573991,0.5739910313901345,0.4260089686098655
324,2844,2600,244,2451,393,0.9142053445850914,0.08579465541490858,0.8618143459915611,0.13818565400843882,1038,28,149,861,547,491,0.02697495183044316,0.14354527938342967,0.8294797687861272,0.5269749518304432,0.4730250481695568
325,2694,2169,525,2369,325,0.8051224944320713,0.19487750556792874,0.8793615441722346,0.1206384558277654,759,71,255,433,712,47,0.09354413702239789,0.3359683794466403,0.5704874835309618,0.9380764163372859,0.061923583662714096
326,18815,14615,4200,14043,4772,0.7767738506510763,0.22322614934892374,0.74637257507308,0.25362742492692003,10781,430,1931,8420,8843,1938,0.0398849828401818,0.17911139968463036,0.7810036174751879,0.8202393098970411,0.17976069010295892
327,3173,2572,601,2645,528,0.8105893476205484,0.18941065237945162,0.8335959659628113,0.16640403403718879,1292,75,237,980,878,414,0.05804953560371517,0.18343653250773995,0.7585139318885449,0.6795665634674922,0.3204334365325077
328,169,140,29,150,19,0.8284023668639053,0.17159763313609466,0.8875739644970414,0.11242603550295859,125,4,21,100,113,12,0.032,0.168,0.8,0.904,0.096
329,1666,1275,391,1217,449,0.7653061224489796,0.23469387755102042,0.7304921968787516,0.2695078031212485,863,69,153,641,394,469,0.07995365005793743,0.1772885283893395,0.7427578215527231,0.45654692931633833,0.5434530706836617
330,4743,3678,1065,4125,618,0.7754585705249842,0.22454142947501582,0.8697027197975965,0.13029728020240355,1978,93,243,1642,1267,711,0.04701718907987867,0.12285136501516683,0.8301314459049545,0.6405460060667341,0.35945399393326594
331,12430,10778,1652,10198,2232,0.8670957361222847,0.1329042638777152,0.8204344328238133,0.17956556717618666,4192,169,677,3346,2834,1358,0.04031488549618321,0.16149809160305342,0.7981870229007634,0.6760496183206107,0.32395038167938933
332,3727,2765,962,2799,928,0.7418835524550577,0.25811644754494234,0.7510061711832573,0.2489938288167427,763,14,118,631,527,236,0.01834862385321101,0.15465268676277852,0.8269986893840104,0.690694626474443,0.30930537352555704
333,1640,1305,335,1327,313,0.7957317073170732,0.20426829268292682,0.8091463414634147,0.19085365853658537,588,68,138,382,406,182,0.11564625850340136,0.23469387755102042,0.6496598639455783,0.6904761904761905,0.30952380952380953
334,7537,5724,1813,6499,1038,0.7594533634071912,0.2405466365928088,0.8622794215204989,0.13772057847950112,4371,100,260,4011,2634,1737,0.022878059940517045,0.05948295584534431,0.9176389842141386,0.602608098833219,0.3973919011667811
335,2010,1836,174,1282,728,0.9134328358208955,0.08656716417910448,0.6378109452736318,0.36218905472636814,448,4,146,298,401,47,0.008928571428571428,0.32589285714285715,0.6651785714285714,0.8950892857142857,0.10491071428571429
336,0,0,0,0,0,0.0,0.0,0.0,0.0,0,0,0,0,0,0,0.0,0.0,0.0,0.0,0.0
337,1308,1208,100,809,499,0.9235474006116208,0.0764525993883792,0.6185015290519877,0.38149847094801226,347,4,110,233,257,90,0.011527377521613832,0.3170028818443804,0.6714697406340058,0.7406340057636888,0.25936599423631124
338,13261,10948,2313,10205,3056,0.8255787647990348,0.17442123520096522,0.7695498077068095,0.23045019229319055,6682,61,448,6173,3112,3570,0.009129003292427417,0.06704579467225381,0.9238252020353188,0.4657288237054774,0.5342711762945226
339,9819,8184,1635,8220,1599,0.8334860983806905,0.1665139016193095,0.8371524595172625,0.16284754048273756,3007,194,363,2450,2273,734,0.06451612903225806,0.12071832391087463,0.8147655470568673,0.7559028932490854,0.24409710675091453
340,581,505,76,418,163,0.8691910499139415,0.13080895008605853,0.7194492254733219,0.28055077452667815,4437,29,211,4197,2093,2344,0.006535947712418301,0.04755465404552626,0.9459093982420554,0.4717151228307415,0.5282848771692585
341,362,198,164,216,146,0.5469613259668509,0.4530386740331492,0.5966850828729282,0.40331491712707185,245,31,83,131,164,81,0.12653061224489795,0.33877551020408164,0.5346938775510204,0.6693877551020408,0.3306122448979592
342,22413,20155,2258,18382,4031,0.8992548967117298,0.1007451032882702,0.820149020657654,0.17985097934234595,3775,199,738,2838,2311,1464,0.05271523178807947,0.19549668874172185,0.7517880794701987,0.6121854304635762,0.38781456953642385
343,10869,8353,2516,9344,1525,0.7685159628300672,0.23148403716993285,0.859692704020609,0.14030729597939093,4481,181,620,3680,3484,997,0.0403927694711002,0.1383619727739344,0.8212452577549654,0.7775050212006248,0.22249497879937513
344,4334,3558,776,3653,681,0.8209506229810798,0.17904937701892015,0.8428703276419013,0.15712967235809874,1538,90,381,1067,1138,400,0.05851755526657997,0.24772431729518857,0.6937581274382315,0.7399219765929779,0.26007802340702213
345,659,518,141,568,91,0.7860394537177542,0.21396054628224584,0.8619119878603946,0.13808801213960548,302,37,92,173,274,28,0.12251655629139073,0.304635761589404,0.5728476821192053,0.9072847682119205,0.09271523178807947
346,19540,16743,2797,15985,3555,0.8568577277379734,0.1431422722620266,0.8180655066530195,0.18193449334698056,9201,1061,1234,6906,5300,3901,0.11531355287468753,0.13411585697206826,0.7505705901532442,0.5760243451798718,0.4239756548201282
347,2469,1999,470,2207,262,0.8096395301741596,0.19036046982584043,0.8938841636289996,0.1061158363710004,915,32,122,761,664,251,0.034972677595628415,0.13333333333333333,0.8316939890710382,0.7256830601092896,0.2743169398907104
348,3677,3040,637,3008,669,0.826760946423715,0.17323905357628502,0.8180581996192549,0.18194180038074517,1500,87,486,927,975,525,0.058,0.324,0.618,0.65,0.35
349,16628,12631,3997,14359,2269,0.7596223237911955,0.24037767620880443,0.8635434207361078,0.13645657926389224,11616,176,572,10868,7112,4504,0.015151515151515152,0.04924242424242424,0.9356060606060606,0.6122589531680441,0.3877410468319559
350,433,288,145,350,83,0.6651270207852193,0.3348729792147806,0.8083140877598153,0.19168591224018475,779,29,161,589,577,202,0.037227214377406934,0.20667522464698332,0.7560975609756098,0.7406931964056482,0.2593068035943517
351,31868,28991,2877,26792,5076,0.9097213505711058,0.09027864942889419,0.8407179615915652,0.1592820384084348,9773,174,650,8949,5990,3783,0.017804154302670624,0.06650977182032129,0.9156860738770081,0.6129131280057301,0.38708687199426994
352,193,126,67,165,28,0.6528497409326425,0.3471502590673575,0.8549222797927462,0.14507772020725387,210,28,48,134,176,34,0.13333333333333333,0.22857142857142856,0.638095238095238,0.8380952380952381,0.1619047619047619
353,8210,6963,1247,6948,1262,0.8481120584652863,0.15188794153471377,0.8462850182704019,0.15371498172959805,2674,145,389,2140,1703,971,0.054225878833208674,0.14547494390426327,0.8002991772625281,0.6368735976065819,0.3631264023934181
354,299,266,33,234,65,0.8896321070234113,0.11036789297658862,0.782608695652174,0.21739130434782608,84,3,32,49,82,2,0.03571428571428571,0.38095238095238093,0.5833333333333334,0.9761904761904762,0.023809523809523808
355,501,326,175,392,109,0.6506986027944112,0.34930139720558884,0.782435129740519,0.21756487025948104,414,2,89,323,282,132,0.004830917874396135,0.21497584541062803,0.7801932367149759,0.6811594202898551,0.3188405797101449
356,102,65,37,85,17,0.6372549019607843,0.3627450980392157,0.8333333333333334,0.16666666666666666,148,29,32,87,127,21,0.19594594594594594,0.21621621621621623,0.5878378378378378,0.8581081081081081,0.14189189189189189
357,14881,12592,2289,10355,4526,0.8461796922249849,0.15382030777501512,0.6958537732679255,0.3041462267320745,4391,148,498,3745,3247,1144,0.033705306308358,0.11341380095650194,0.85288089273514,0.7394670917786381,0.2605329082213619
358,13261,10948,2313,10205,3056,0.8255787647990348,0.17442123520096522,0.7695498077068095,0.23045019229319055,6678,58,448,6172,3109,3569,0.00868523510032944,0.06708595387840671,0.9242288110212639,0.46555855046421085,0.5344414495357892
359,1330,1024,306,1158,172,0.7699248120300752,0.23007518796992482,0.8706766917293233,0.1293233082706767,645,22,72,551,402,243,0.034108527131782945,0.11162790697674418,0.8542635658914729,0.6232558139534884,0.3767441860465116
360,1101,1009,92,705,396,0.9164396003633061,0.08356039963669391,0.6403269754768393,0.35967302452316074,323,4,97,222,256,67,0.01238390092879257,0.30030959752321984,0.6873065015479877,0.7925696594427245,0.20743034055727555
361,1057,962,95,657,400,0.9101229895931883,0.08987701040681173,0.6215704824976348,0.3784295175023652,209,4,94,111,162,47,0.019138755980861243,0.44976076555023925,0.5311004784688995,0.7751196172248804,0.22488038277511962
362,4001,2667,1334,2681,1320,0.6665833541614596,0.33341664583854036,0.670082479380155,0.32991752061984503,905,39,144,722,590,315,0.0430939226519337,0.1591160220994475,0.7977900552486188,0.6519337016574586,0.34806629834254144
363,1085,747,338,898,187,0.688479262672811,0.31152073732718893,0.8276497695852535,0.17235023041474654,895,50,130,715,628,267,0.055865921787709494,0.1452513966480447,0.7988826815642458,0.7016759776536313,0.29832402234636873
364,4659,3810,849,3701,958,0.8177720540888602,0.18222794591113972,0.7943764756385491,0.20562352436145095,2254,121,265,1868,1357,897,0.05368234250221828,0.11756876663708962,0.8287488908606921,0.6020408163265306,0.3979591836734694
365,1666,1275,391,1217,449,0.7653061224489796,0.23469387755102042,0.7304921968787516,0.2695078031212485,863,69,153,641,394,469,0.07995365005793743,0.1772885283893395,0.7427578215527231,0.45654692931633833,0.5434530706836617
366,361,198,163,216,145,0.5484764542936288,0.4515235457063712,0.5983379501385041,0.40166204986149584,246,31,84,131,164,82,0.12601626016260162,0.34146341463414637,0.532520325203252,0.6666666666666666,0.3333333333333333
367,21934,18941,2993,19069,2865,0.8635451809975381,0.13645481900246192,0.8693808698823744,0.1306191301176256,5318,881,1486,2951,5012,306,0.16566378337720947,0.2794283565250094,0.5549078600977811,0.9424595712673938,0.057540428732606244
368,10229,8613,1616,8525,1704,0.8420177925505915,0.15798220744940855,0.8334148010558217,0.1665851989441783,1316,153,386,777,1257,59,0.11626139817629179,0.2933130699088146,0.5904255319148937,0.9551671732522796,0.044832826747720364
369,11827,10135,1692,9738,2089,0.8569375158535554,0.14306248414644457,0.8233702545024097,0.17662974549759025,3117,140,447,2530,2037,1080,0.04491498235482836,0.14340712223291627,0.8116778954122553,0.6535129932627527,0.34648700673724736
370,5981,4963,1018,4778,1203,0.8297943487711085,0.1702056512288915,0.7988630663768601,0.20113693362313995,1148,73,258,817,833,315,0.06358885017421603,0.22473867595818817,0.7116724738675958,0.725609756097561,0.27439024390243905
371,1556,1339,217,1157,399,0.8605398457583547,0.13946015424164523,0.743573264781491,0.256426735218509,452,7,96,349,282,170,0.015486725663716814,0.21238938053097345,0.7721238938053098,0.6238938053097345,0.37610619469026546
372,827,704,123,694,133,0.8512696493349455,0.1487303506650544,0.8391777509068924,0.1608222490931076,348,14,172,162,323,25,0.040229885057471264,0.4942528735632184,0.46551724137931033,0.9281609195402298,0.07183908045977011
373,1479,1179,300,1207,272,0.7971602434077079,0.2028397565922921,0.8160919540229885,0.1839080459770115,548,85,136,327,433,115,0.1551094890510949,0.24817518248175183,0.5967153284671532,0.7901459854014599,0.20985401459854014
374,402,195,207,343,59,0.48507462686567165,0.5149253731343284,0.8532338308457711,0.14676616915422885,932,9,154,769,673,259,0.009656652360515022,0.16523605150214593,0.825107296137339,0.7221030042918455,0.2778969957081545
375,964,707,257,746,218,0.733402489626556,0.266597510373444,0.7738589211618258,0.22614107883817428,728,6,149,573,481,247,0.008241758241758242,0.20467032967032966,0.7870879120879121,0.6607142857142857,0.3392857142857143
376,4095,3504,591,3332,763,0.8556776556776556,0.1443223443223443,0.8136752136752137,0.18632478632478633,1539,100,386,1053,1083,456,0.0649772579597141,0.2508122157244964,0.6842105263157895,0.7037037037037037,0.2962962962962963
377,12655,11151,1504,10162,2493,0.8811536941920189,0.11884630580798103,0.8030027657052549,0.19699723429474517,4183,173,686,3324,2816,1367,0.041357877121683005,0.16399713124551757,0.7946449916327994,0.6732010518766436,0.32679894812335647
378,1095,724,371,997,98,0.6611872146118721,0.33881278538812787,0.9105022831050228,0.08949771689497717,703,32,79,592,564,139,0.04551920341394026,0.112375533428165,0.8421052631578947,0.802275960170697,0.19772403982930298
379,486,317,169,429,57,0.6522633744855967,0.3477366255144033,0.8827160493827161,0.11728395061728394,423,33,84,306,318,105,0.07801418439716312,0.19858156028368795,0.723404255319149,0.75177304964539,0.24822695035460993
380,1101,1002,99,703,398,0.9100817438692098,0.08991825613079019,0.6385104450499546,0.3614895549500454,313,4,109,200,220,93,0.012779552715654952,0.34824281150159747,0.6389776357827476,0.7028753993610224,0.2971246006389776
381,8016,6772,1244,6135,1881,0.8448103792415169,0.15518962075848303,0.7653443113772455,0.2346556886227545,4070,89,312,3669,2221,1849,0.021867321867321866,0.07665847665847667,0.9014742014742014,0.5457002457002457,0.4542997542997543
382,104,99,5,59,45,0.9519230769230769,0.04807692307692308,0.5673076923076923,0.4326923076923077,139,4,65,70,134,5,0.02877697841726619,0.4676258992805755,0.5035971223021583,0.9640287769784173,0.03597122302158273
383,1037,746,291,825,212,0.7193828351012537,0.2806171648987464,0.7955641272902604,0.20443587270973965,618,130,263,225,528,90,0.21035598705501618,0.4255663430420712,0.3640776699029126,0.8543689320388349,0.14563106796116504
384,7460,6483,977,3958,3502,0.8690348525469169,0.1309651474530831,0.5305630026809651,0.4694369973190349,2499,28,307,2164,1426,1073,0.011204481792717087,0.12284913965586235,0.8659463785514205,0.5706282513005202,0.4293717486994798
385,1081,774,307,957,124,0.7160037002775208,0.2839962997224792,0.8852913968547641,0.1147086031452359,516,36,91,389,437,79,0.06976744186046512,0.17635658914728683,0.7538759689922481,0.8468992248062015,0.15310077519379844
386,7173,6469,704,5809,1364,0.9018541753798969,0.09814582462010317,0.8098424647985502,0.19015753520144987,2163,134,269,1760,1258,905,0.061950993989828944,0.12436430883032824,0.8136846971798428,0.5815996301433195,0.41840036985668055
387,2655,1924,731,2144,511,0.7246704331450095,0.2753295668549906,0.8075329566854991,0.19246704331450093,1240,42,182,1016,998,242,0.03387096774193549,0.14677419354838708,0.8193548387096774,0.8048387096774193,0.19516129032258064
388,19525,17240,2285,15988,3537,0.8829705505761843,0.11702944942381562,0.8188476312419974,0.18115236875800256,13904,756,1819,11329,7251,6653,0.054372842347525895,0.13082566168009205,0.814801495972382,0.5215046029919448,0.4784953970080552
389,4935,4342,593,4395,540,0.87983789260385,0.12016210739614995,0.8905775075987842,0.1094224924012158,2078,183,410,1485,1802,276,0.08806544754571703,0.1973051010587103,0.7146294513955727,0.8671799807507219,0.13282001924927817
390,285,193,92,239,46,0.6771929824561403,0.32280701754385965,0.8385964912280702,0.16140350877192983,174,12,38,124,149,25,0.06896551724137931,0.21839080459770116,0.7126436781609196,0.8563218390804598,0.14367816091954022
391,21275,19209,2066,17447,3828,0.9028907168037603,0.09710928319623972,0.8200705052878966,0.1799294947121034,2038,0,130,1908,260,1778,0.0,0.06378802747791953,0.9362119725220804,0.12757605495583907,0.872423945044161
392,11204,8884,2320,9335,1869,0.7929310960371296,0.2070689039628704,0.8331845769368083,0.16681542306319172,4707,1894,355,2458,3744,963,0.402379434884215,0.07541958784788613,0.5222009772678988,0.7954110898661568,0.2045889101338432
393,1194,936,258,990,204,0.7839195979899497,0.21608040201005024,0.8291457286432161,0.1708542713567839,1338,12,73,1253,906,432,0.008968609865470852,0.05455904334828102,0.9364723467862481,0.6771300448430493,0.32286995515695066
394,1093,858,235,1000,93,0.7849954254345837,0.21500457456541627,0.9149130832570905,0.08508691674290943,915,6,151,758,670,245,0.006557377049180328,0.1650273224043716,0.8284153005464481,0.73224043715847,0.2677595628415301
395,5788,4594,1194,4645,1143,0.7937111264685557,0.20628887353144437,0.8025224602626123,0.1974775397373877,2926,86,293,2547,2483,443,0.02939166097060834,0.10013670539986329,0.8704716336295284,0.8485987696514012,0.15140123034859876
396,6876,5296,1580,5150,1726,0.7702152414194299,0.2297847585805701,0.7489819662594531,0.2510180337405468,2424,98,407,1919,1559,865,0.040429042904290426,0.1679042904290429,0.7916666666666666,0.6431518151815182,0.35684818481848185
397,7801,6030,1771,6304,1497,0.77297782335598,0.22702217664402,0.8081015254454557,0.19189847455454428,2488,126,295,2067,1560,928,0.05064308681672026,0.11856913183279742,0.8307877813504824,0.6270096463022508,0.3729903536977492
398,1155,1061,94,712,443,0.9186147186147187,0.08138528138528138,0.6164502164502165,0.38354978354978353,215,4,96,115,176,39,0.018604651162790697,0.44651162790697674,0.5348837209302325,0.8186046511627907,0.1813953488372093
399,12334,10919,1415,10570,1764,0.8852764715420788,0.11472352845792119,0.8569807037457434,0.14301929625425652,1906,160,373,1373,1319,587,0.08394543546694648,0.195697796432319,0.7203567681007346,0.6920251836306401,0.3079748163693599
400,373,284,89,312,61,0.7613941018766756,0.2386058981233244,0.8364611260053619,0.16353887399463807,131,8,25,98,105,26,0.061068702290076333,0.19083969465648856,0.7480916030534351,0.8015267175572519,0.1984732824427481
401,1805,1296,509,1522,283,0.718005540166205,0.281994459833795,0.843213296398892,0.15678670360110802,1381,41,152,1188,835,546,0.029688631426502535,0.11006517016654598,0.8602461984069515,0.6046343229543809,0.3953656770456191
402,446,339,107,344,102,0.7600896860986547,0.2399103139013453,0.7713004484304933,0.22869955156950672,242,32,55,155,199,43,0.1322314049586777,0.22727272727272727,0.640495867768595,0.8223140495867769,0.17768595041322313
403,3011,2505,506,2431,580,0.8319495184324145,0.1680504815675855,0.8073729657920956,0.19262703420790436,811,57,194,560,442,369,0.07028360049321825,0.23921085080147966,0.6905055487053021,0.5450061652281134,0.45499383477188654
404,152,102,50,116,36,0.6710526315789473,0.32894736842105265,0.7631578947368421,0.23684210526315788,458,3,240,215,378,80,0.006550218340611353,0.5240174672489083,0.46943231441048033,0.8253275109170306,0.17467248908296942
405,16569,14056,2513,13073,3496,0.8483312209547951,0.1516687790452049,0.7890035608666788,0.21099643913332125,5400,366,751,4283,3939,1461,0.06777777777777778,0.13907407407407407,0.7931481481481482,0.7294444444444445,0.27055555555555555
406,7174,5838,1336,5564,1610,0.813771954279342,0.18622804572065793,0.7755784778366323,0.22442152216336772,8414,84,295,8035,5630,2784,0.009983361064891847,0.03506061326360827,0.9549560256714998,0.6691228904207274,0.33087710957927263
407,866,551,315,550,316,0.6362586605080831,0.36374133949191684,0.6351039260969977,0.3648960739030023,1517,37,137,1343,281,1236,0.024390243902439025,0.0903098220171391,0.8852999340804218,0.1852340145023072,0.8147659854976929
408,758,636,122,593,165,0.8390501319261213,0.16094986807387862,0.7823218997361477,0.21767810026385223,317,29,44,244,237,80,0.0914826498422713,0.138801261829653,0.7697160883280757,0.7476340694006309,0.25236593059936907
409,41337,34315,7022,34541,6796,0.8301279725185668,0.1698720274814331,0.8355952294554515,0.16440477054454847,13303,423,1783,11097,8664,4639,0.031797338946102385,0.13402991806359468,0.834172742990303,0.6512816657896715,0.3487183342103285
410,11265,9441,1824,7595,3670,0.8380825565912117,0.16191744340878828,0.6742121615623613,0.3257878384376387,4185,42,183,3960,2742,1443,0.01003584229390681,0.04372759856630824,0.946236559139785,0.6551971326164875,0.34480286738351257
411,107,76,31,80,27,0.7102803738317757,0.2897196261682243,0.7476635514018691,0.2523364485981308,225,4,92,129,186,39,0.017777777777777778,0.4088888888888889,0.5733333333333334,0.8266666666666667,0.17333333333333334
412,5802,4949,853,5094,708,0.85298173043778,0.14701826956221992,0.8779731127197518,0.12202688728024819,3119,33,284,2802,1859,1260,0.01058031420327028,0.09105482526450785,0.8983648605322219,0.5960243667842258,0.4039756332157743
413,979,884,95,616,363,0.9029622063329928,0.09703779366700716,0.6292134831460674,0.3707865168539326,191,4,91,96,152,39,0.020942408376963352,0.47643979057591623,0.5026178010471204,0.7958115183246073,0.20418848167539266
414,21109,17957,3152,17102,4007,0.8506798048225875,0.1493201951774125,0.810175754417547,0.18982424558245298,8524,633,437,7454,3138,5386,0.07426091037071797,0.0512670107930549,0.8744720788362271,0.3681370248709526,0.6318629751290474
415,443,346,97,367,76,0.781038374717833,0.21896162528216703,0.8284424379232506,0.17155756207674944,167,31,65,71,133,34,0.18562874251497005,0.38922155688622756,0.4251497005988024,0.7964071856287425,0.20359281437125748
416,1922,1458,464,1489,433,0.7585848074921956,0.24141519250780438,0.7747138397502601,0.22528616024973985,1070,37,93,940,568,502,0.03457943925233645,0.08691588785046729,0.8785046728971962,0.5308411214953271,0.4691588785046729
417,1469,1173,296,1198,271,0.7985023825731791,0.20149761742682096,0.8155207624234173,0.18447923757658272,545,85,135,325,430,115,0.1559633027522936,0.24770642201834864,0.5963302752293578,0.7889908256880734,0.21100917431192662
418,9796,8370,1426,8508,1288,0.8544303797468354,0.14556962025316456,0.8685177623519804,0.1314822376480196,4314,318,1096,2900,3767,547,0.0737134909596662,0.25405656003708854,0.6722299490032453,0.8732035234121465,0.1267964765878535
419,1291,1182,109,807,484,0.9155693261037955,0.0844306738962045,0.6250968241673122,0.37490317583268784,418,4,111,303,278,140,0.009569377990430622,0.26555023923444976,0.7248803827751196,0.6650717703349283,0.3349282296650718
420,302,191,111,260,42,0.6324503311258278,0.3675496688741722,0.8609271523178808,0.1390728476821192,457,8,118,331,329,128,0.0175054704595186,0.25820568927789933,0.7242888402625821,0.7199124726477024,0.2800875273522976
421,1483,1179,304,1224,259,0.7950101146325017,0.20498988536749832,0.825354012137559,0.174645987862441,520,87,129,304,438,82,0.1673076923076923,0.24807692307692308,0.5846153846153846,0.8423076923076923,0.1576923076923077
422,26666,21235,5431,20225,6441,0.7963324083102078,0.20366759168979223,0.7584564614115353,0.24154353858846472,13686,536,2235,10915,11185,2501,0.039164109308782696,0.16330556773345023,0.797530322957767,0.8172585123483852,0.1827414876516148
423,19349,15210,4139,14571,4778,0.7860871362861129,0.213912863713887,0.7530621737557497,0.24693782624425034,10765,451,1864,8450,8854,1911,0.041895030190431955,0.17315373896888064,0.7849512308406874,0.822480260102183,0.177519739897817
424,7897,6679,1218,6667,1230,0.8457642142585792,0.1542357857414208,0.8442446498670381,0.15575535013296188,2195,70,313,1812,1190,1005,0.03189066059225513,0.14259681093394078,0.8255125284738041,0.5421412300683371,0.45785876993166286
425,7165,6247,918,5818,1347,0.8718771807397069,0.1281228192602931,0.8120027913468248,0.18799720865317515,855,41,363,451,700,155,0.047953216374269005,0.4245614035087719,0.5274853801169591,0.8187134502923976,0.18128654970760233
426,4442,3362,1080,3953,489,0.7568662764520486,0.24313372354795137,0.889914452949122,0.11008554705087799,1268,117,225,926,1030,238,0.09227129337539432,0.1774447949526814,0.7302839116719243,0.8123028391167192,0.18769716088328076
427,269,197,72,183,86,0.7323420074349443,0.26765799256505574,0.6802973977695167,0.31970260223048325,736,30,35,671,108,628,0.04076086956521739,0.04755434782608696,0.9116847826086957,0.14673913043478262,0.8532608695652174
428,1243,1149,94,779,464,0.9243765084473049,0.0756234915526951,0.6267095736122285,0.37329042638777155,220,4,104,112,167,53,0.01818181818181818,0.4727272727272727,0.509090909090909,0.759090909090909,0.2409090909090909
429,1092,1000,92,685,407,0.9157509157509157,0.08424908424908426,0.6272893772893773,0.3727106227106227,206,4,82,120,157,49,0.019417475728155338,0.39805825242718446,0.5825242718446602,0.7621359223300971,0.23786407766990292
430,5178,4354,824,4227,951,0.8408651989185013,0.15913480108149866,0.8163383545770567,0.18366164542294322,1364,130,231,1003,928,436,0.09530791788856305,0.1693548387096774,0.7353372434017595,0.6803519061583577,0.3196480938416422
431,168,126,42,126,42,0.75,0.25,0.75,0.25,652,1,50,601,161,491,0.0015337423312883436,0.07668711656441718,0.9217791411042945,0.2469325153374233,0.7530674846625767
432,18439,15166,3273,15697,2742,0.8224957969521124,0.17750420304788764,0.8512934540918705,0.1487065459081295,7468,2068,2430,2970,6355,1113,0.27691483663631494,0.32538832351365826,0.3976968398500268,0.8509641135511515,0.1490358864488484
433,1743,1398,345,1378,365,0.802065404475043,0.19793459552495696,0.7905909351692484,0.20940906483075158,278,21,56,201,197,81,0.07553956834532374,0.2014388489208633,0.7230215827338129,0.7086330935251799,0.29136690647482016
434,1042,950,92,669,373,0.9117082533589251,0.08829174664107485,0.6420345489443378,0.3579654510556622,178,4,81,93,138,40,0.02247191011235955,0.4550561797752809,0.5224719101123596,0.7752808988764045,0.2247191011235955
435,22279,21264,1015,18689,3590,0.9544414022173348,0.04555859778266529,0.8388617083352036,0.16113829166479646,27961,30,18431,9500,21874,6087,0.0010729229998927077,0.6591681270340832,0.3397589499660241,0.7823039233217696,0.2176960766782304
436,1021,795,226,766,255,0.7786483839373164,0.22135161606268364,0.7502448579823702,0.24975514201762977,827,30,188,609,576,251,0.036275695284159616,0.22732769044740025,0.7363966142684402,0.6964933494558646,0.30350665054413545
437,135,70,65,112,23,0.5185185185185185,0.48148148148148145,0.8296296296296296,0.17037037037037037,244,29,70,145,198,46,0.11885245901639344,0.28688524590163933,0.5942622950819673,0.8114754098360656,0.1885245901639344
438,1312,1218,94,813,499,0.9283536585365854,0.07164634146341463,0.6196646341463414,0.3803353658536585,210,4,92,114,169,41,0.01904761904761905,0.4380952380952381,0.5428571428571428,0.8047619047619048,0.19523809523809524
439,2067,1506,561,1828,239,0.7285921625544267,0.2714078374455733,0.8843734881470731,0.11562651185292695,1988,36,429,1523,1409,579,0.018108651911468814,0.21579476861167002,0.7660965794768612,0.7087525150905433,0.29124748490945673
440,983,756,227,706,277,0.7690742624618515,0.23092573753814852,0.7182095625635809,0.28179043743641913,493,63,108,322,353,140,0.12778904665314403,0.21906693711967545,0.6531440162271805,0.716024340770791,0.2839756592292089
441,13407,10149,3258,10127,3280,0.7569926157977176,0.24300738420228238,0.7553516819571865,0.24464831804281345,3713,263,550,2900,2147,1566,0.07083221115001347,0.14812819822246162,0.7810395906275249,0.5782386210611365,0.42176137893886345
442,1068,975,93,677,391,0.9129213483146067,0.08707865168539326,0.6338951310861424,0.3661048689138577,197,4,93,100,158,39,0.02030456852791878,0.4720812182741117,0.5076142131979695,0.8020304568527918,0.19796954314720813
443,576,389,187,529,47,0.6753472222222222,0.3246527777777778,0.9184027777777778,0.08159722222222222,318,20,116,182,308,10,0.06289308176100629,0.36477987421383645,0.5723270440251572,0.9685534591194969,0.031446540880503145
444,625,506,119,537,88,0.8096,0.1904,0.8592,0.1408,255,39,81,135,238,17,0.15294117647058825,0.3176470588235294,0.5294117647058824,0.9333333333333333,0.06666666666666667
445,1850,1474,376,1500,350,0.7967567567567567,0.20324324324324325,0.8108108108108109,0.1891891891891892,763,77,149,537,492,271,0.10091743119266056,0.19528178243774574,0.7038007863695938,0.6448230668414154,0.35517693315858456
446,2934,2775,159,1720,1214,0.9458077709611452,0.0541922290388548,0.5862304021813224,0.41376959781867756,401,4,117,280,249,152,0.00997506234413965,0.29177057356608477,0.6982543640897756,0.6209476309226932,0.3790523690773067
447,1543,1338,205,1322,221,0.8671419313026572,0.13285806869734285,0.8567725210628645,0.14322747893713544,349,44,145,160,267,82,0.12607449856733524,0.4154727793696275,0.4584527220630373,0.7650429799426934,0.2349570200573066
448,5786,4550,1236,5076,710,0.7863809194607674,0.21361908053923262,0.8772900103698583,0.12270998963014172,2403,123,276,2004,1540,863,0.05118601747815231,0.11485642946317104,0.8339575530586767,0.6408655846858095,0.3591344153141906
449,10275,9107,1168,7748,2527,0.8863260340632604,0.11367396593673966,0.7540632603406326,0.2459367396593674,2475,52,326,2097,1486,989,0.02101010101010101,0.1317171717171717,0.8472727272727273,0.6004040404040404,0.3995959595959596
450,3811,2820,991,3303,508,0.7399632642351089,0.2600367357648911,0.86670165310942,0.1332983468905799,1610,71,190,1349,968,642,0.044099378881987575,0.11801242236024845,0.837888198757764,0.6012422360248447,0.3987577639751553
451,3427,2427,1000,2596,831,0.7081995914794281,0.29180040852057193,0.7575138605194047,0.24248613948059528,2927,1175,250,1502,2180,747,0.40143491629654937,0.08541168431841475,0.5131533993850359,0.7447898872565767,0.2552101127434233
452,481,336,145,407,74,0.6985446985446986,0.30145530145530147,0.8461538461538461,0.15384615384615385,251,18,51,182,216,35,0.07171314741035857,0.20318725099601595,0.7250996015936255,0.8605577689243028,0.1394422310756972
453,867,645,222,698,169,0.7439446366782007,0.2560553633217993,0.8050749711649365,0.19492502883506344,712,44,128,540,439,273,0.06179775280898876,0.1797752808988764,0.7584269662921348,0.6165730337078652,0.38342696629213485
454,2622,2411,211,2190,432,0.9195270785659801,0.08047292143401984,0.8352402745995423,0.16475972540045766,1681,78,346,1257,1147,534,0.04640095181439619,0.20582986317668056,0.7477691850089233,0.6823319452706722,0.3176680547293278
455,2134,1352,782,1442,692,0.633552014995314,0.36644798500468606,0.6757263355201499,0.32427366447985007,3616,35,158,3423,2043,1573,0.009679203539823008,0.043694690265486724,0.9466261061946902,0.5649889380530974,0.43501106194690264
456,474,332,142,402,72,0.70042194092827,0.29957805907172996,0.8481012658227848,0.1518987341772152,251,18,51,182,216,35,0.07171314741035857,0.20318725099601595,0.7250996015936255,0.8605577689243028,0.1394422310756972
457,1017,928,89,643,374,0.9124877089478859,0.08751229105211406,0.632251720747296,0.36774827925270404,252,4,101,147,205,47,0.015873015873015872,0.4007936507936508,0.5833333333333334,0.8134920634920635,0.1865079365079365
458,2408,1897,511,2006,402,0.7877906976744186,0.21220930232558138,0.8330564784053156,0.1669435215946844,1035,24,122,889,577,458,0.02318840579710145,0.1178743961352657,0.8589371980676328,0.557487922705314,0.442512077294686
459,2010,1543,467,1442,568,0.7676616915422886,0.23233830845771145,0.7174129353233831,0.28258706467661693,1068,81,164,823,793,275,0.07584269662921349,0.15355805243445692,0.7705992509363296,0.7425093632958801,0.25749063670411987
460,10191,8788,1403,8589,1602,0.8623295064272397,0.1376704935727603,0.8428024727700912,0.15719752722990873,3675,256,571,2848,2864,811,0.06965986394557823,0.15537414965986396,0.7749659863945578,0.7793197278911564,0.22068027210884353
461,1774,1560,214,1437,337,0.8793686583990981,0.12063134160090191,0.8100338218714769,0.18996617812852312,979,61,218,700,756,223,0.06230847803881512,0.2226762002042901,0.7150153217568948,0.7722165474974464,0.22778345250255363
462,1762,1353,409,1361,401,0.7678774120317821,0.23212258796821794,0.7724177071509648,0.2275822928490352,1221,19,113,1089,637,584,0.015561015561015561,0.09254709254709255,0.8918918918918919,0.5217035217035217,0.4782964782964783
463,953,864,89,596,357,0.906610703043022,0.09338929695697797,0.6253934942287513,0.3746065057712487,184,4,79,101,142,42,0.021739130434782608,0.42934782608695654,0.5489130434782609,0.7717391304347826,0.22826086956521738
464,592,468,124,414,178,0.7905405405405406,0.20945945945945946,0.6993243243243243,0.30067567567567566,284,58,106,120,255,29,0.20422535211267606,0.3732394366197183,0.4225352112676056,0.897887323943662,0.10211267605633803
465,4582,3474,1108,3769,813,0.7581841990397207,0.24181580096027935,0.8225665648188564,0.1774334351811436,1380,53,217,1110,831,549,0.03840579710144928,0.1572463768115942,0.8043478260869565,0.6021739130434782,0.3978260869565217
466,21275,19209,2066,17447,3828,0.9028907168037603,0.09710928319623972,0.8200705052878966,0.1799294947121034,2038,0,130,1908,260,1778,0.0,0.06378802747791953,0.9362119725220804,0.12757605495583907,0.872423945044161
467,3597,2850,747,2964,633,0.79232693911593,0.20767306088407006,0.8240200166805671,0.17597998331943285,2744,51,252,2441,1473,1271,0.01858600583090379,0.09183673469387756,0.8895772594752187,0.5368075801749271,0.46319241982507287
468,1347,751,596,704,643,0.5575352635486266,0.4424647364513734,0.5226429101707498,0.4773570898292502,38,0,10,28,33,5,0.0,0.2631578947368421,0.7368421052631579,0.868421052631579,0.13157894736842105
469,3307,2819,488,2723,584,0.8524342304203205,0.14756576957967946,0.8234048986997279,0.17659510130027214,2614,21,577,2016,1437,1177,0.008033664881407804,0.220734506503443,0.7712318286151492,0.5497322111706198,0.45026778882938023
470,3177,2290,887,2486,691,0.7208057916273214,0.2791942083726786,0.782499213094114,0.21750078690588606,3353,17,252,3084,1600,1753,0.005070086489710707,0.07515657620041753,0.9197733373098718,0.4771846107963018,0.5228153892036982
471,9512,6979,2533,7793,1719,0.7337047939444912,0.2662952060555088,0.8192809083263246,0.18071909167367536,6649,42,416,6191,3358,3291,0.006316739359302151,0.06256579936832607,0.9311174612723718,0.5050383516318243,0.4949616483681757
472,1982,1621,361,1651,331,0.8178607467204844,0.18213925327951563,0.8329969727547931,0.16700302724520685,820,87,148,585,535,285,0.10609756097560975,0.18048780487804877,0.7134146341463414,0.6524390243902439,0.3475609756097561
473,245,169,76,199,46,0.689795918367347,0.31020408163265306,0.8122448979591836,0.18775510204081633,229,27,68,134,207,22,0.11790393013100436,0.29694323144104806,0.5851528384279476,0.9039301310043668,0.09606986899563319
474,8033,6901,1132,6849,1184,0.8590812896800697,0.14091871031993028,0.8526079920328644,0.14739200796713556,1674,142,270,1262,1153,521,0.08482676224611709,0.16129032258064516,0.7538829151732378,0.6887694145758662,0.3112305854241338
475,763,695,68,695,68,0.9108781127129751,0.0891218872870249,0.9108781127129751,0.0891218872870249,246,14,44,188,128,118,0.056910569105691054,0.17886178861788618,0.7642276422764228,0.5203252032520326,0.4796747967479675
476,8477,6958,1519,7058,1419,0.8208092485549133,0.1791907514450867,0.8326058747198302,0.16739412528016986,3967,83,442,3442,2140,1827,0.0209226115452483,0.11141920846987648,0.8676581799848753,0.5394504663473658,0.46054953365263424
477,22451,18905,3546,18246,4205,0.8420560331388357,0.15794396686116433,0.8127032203465324,0.18729677965346755,13173,310,962,11901,6359,6814,0.02353298413421392,0.073028163668109,0.9034388521976771,0.48272982615956883,0.5172701738404312
478,533,342,191,421,112,0.6416510318949343,0.35834896810506567,0.7898686679174484,0.2101313320825516,444,5,107,332,308,136,0.01126126126126126,0.240990990990991,0.7477477477477478,0.6936936936936937,0.3063063063063063
479,954,865,89,600,354,0.9067085953878407,0.09329140461215933,0.6289308176100629,0.3710691823899371,169,4,76,89,129,40,0.023668639053254437,0.44970414201183434,0.5266272189349113,0.7633136094674556,0.23668639053254437
480,4604,3781,823,3699,905,0.8212423979148566,0.17875760208514335,0.8034317984361424,0.19656820156385751,974,79,208,687,730,244,0.0811088295687885,0.2135523613963039,0.7053388090349076,0.7494866529774127,0.25051334702258726
481,12422,10773,1649,10190,2232,0.8672516502978587,0.13274834970214136,0.8203187892448881,0.1796812107551119,4191,169,676,3346,2833,1358,0.04032450489143403,0.1612980195657361,0.7983774755428299,0.675972321641613,0.32402767835838703
482,868,646,222,699,169,0.7442396313364056,0.2557603686635945,0.8052995391705069,0.19470046082949308,712,44,128,540,439,273,0.06179775280898876,0.1797752808988764,0.7584269662921348,0.6165730337078652,0.38342696629213485
483,2015,1377,638,1803,212,0.6833746898263028,0.31662531017369727,0.894789081885856,0.10521091811414392,3033,153,704,2176,2689,344,0.050445103857566766,0.23211341905703922,0.717441477085394,0.886580942960765,0.11341905703923508
484,2759,2074,685,2146,613,0.7517216382747373,0.24827836172526277,0.7778180500181225,0.22218194998187749,1555,32,182,1341,1029,526,0.020578778135048232,0.11704180064308682,0.862379421221865,0.6617363344051447,0.3382636655948553
485,3631,2997,634,2910,721,0.8253924538694575,0.17460754613054255,0.8014321123657394,0.19856788763426053,1283,89,191,1003,799,484,0.06936866718628215,0.14886983632112236,0.7817614964925955,0.622759158222915,0.37724084177708495
486,5058,4187,871,4195,863,0.8277975484381178,0.17220245156188216,0.8293792012653223,0.17062079873467773,1167,50,189,928,860,307,0.04284490145672665,0.16195372750642673,0.7952013710368466,0.7369323050556984,0.26306769494430166
487,4432,4106,326,4120,312,0.9264440433212996,0.07355595667870037,0.9296028880866426,0.0703971119133574,2372,16,361,1995,1182,1190,0.006745362563237774,0.15219224283305227,0.8410623946037099,0.49831365935919053,0.5016863406408094
488,3246,2426,820,2698,548,0.747381392483056,0.2526186075169439,0.8311768330252619,0.16882316697473815,1239,82,235,922,940,299,0.06618240516545601,0.18966908797417273,0.7441485068603713,0.7586763518966909,0.2413236481033091
489,23,11,12,8,15,0.4782608695652174,0.5217391304347826,0.34782608695652173,0.6521739130434783,27,0,5,22,20,7,0.0,0.18518518518518517,0.8148148148148148,0.7407407407407407,0.25925925925925924
490,967,873,94,602,365,0.9027921406411582,0.09720785935884178,0.6225439503619442,0.37745604963805585,189,4,87,98,150,39,0.021164021164021163,0.4603174603174603,0.5185185185185185,0.7936507936507936,0.20634920634920634
491,889,717,172,656,233,0.8065241844769404,0.19347581552305962,0.7379077615298087,0.26209223847019125,154,1,31,122,100,54,0.006493506493506494,0.2012987012987013,0.7922077922077922,0.6493506493506493,0.35064935064935066
492,564,443,121,470,94,0.7854609929078015,0.21453900709219859,0.8333333333333334,0.16666666666666666,204,5,60,139,195,9,0.024509803921568627,0.29411764705882354,0.6813725490196079,0.9558823529411765,0.04411764705882353
493,3223,2554,669,2441,782,0.7924294135898231,0.20757058641017687,0.7573689109525287,0.2426310890474713,1346,98,187,1061,791,555,0.07280832095096583,0.13893016344725112,0.788261515601783,0.587667161961367,0.41233283803863297
494,1000,908,92,628,372,0.908,0.092,0.628,0.372,219,4,91,124,169,50,0.0182648401826484,0.4155251141552511,0.5662100456621004,0.771689497716895,0.228310502283105
495,1481,1181,300,1211,270,0.7974341661039838,0.2025658338960162,0.8176907494935854,0.18230925050641458,552,83,137,332,427,125,0.1503623188405797,0.24818840579710144,0.6014492753623188,0.7735507246376812,0.22644927536231885
496,32329,30927,1402,29770,2559,0.9566333632342479,0.043366636765752115,0.9208450617093012,0.07915493829069875,21454,107,831,20516,2154,19300,0.00498741493427799,0.03873403561107486,0.9562785494546472,0.10040085764892327,0.8995991423510767
497,669,523,146,575,94,0.7817638266068759,0.21823617339312407,0.85949177877429,0.14050822122571002,333,38,100,195,303,30,0.11411411411411411,0.3003003003003003,0.5855855855855856,0.9099099099099099,0.09009009009009009
498,1075,980,95,676,399,0.9116279069767442,0.08837209302325581,0.6288372093023256,0.37116279069767444,225,4,95,126,182,43,0.017777777777777778,0.4222222222222222,0.56,0.8088888888888889,0.19111111111111112
499,1466,1172,294,1196,270,0.7994542974079127,0.20054570259208732,0.8158253751705321,0.18417462482946795,545,85,134,326,430,115,0.1559633027522936,0.24587155963302754,0.5981651376146789,0.7889908256880734,0.21100917431192662
500,9675,8205,1470,7189,2486,0.8480620155038759,0.15193798449612403,0.7430490956072351,0.25695090439276486,1730,76,248,1406,1056,674,0.04393063583815029,0.14335260115606938,0.8127167630057803,0.6104046242774567,0.3895953757225434
501,538,430,108,415,123,0.7992565055762082,0.20074349442379183,0.7713754646840149,0.22862453531598512,206,6,43,157,110,96,0.02912621359223301,0.2087378640776699,0.7621359223300971,0.5339805825242718,0.46601941747572817
502,6685,5038,1647,4585,2100,0.7536275243081526,0.24637247569184742,0.6858638743455497,0.31413612565445026,3929,60,240,3629,1874,2055,0.015271061338763044,0.06108424535505218,0.9236446933061848,0.47696614914736574,0.5230338508526342
503,2655,2176,479,2106,549,0.8195856873822975,0.18041431261770244,0.7932203389830509,0.20677966101694914,774,80,163,531,593,181,0.10335917312661498,0.21059431524547803,0.686046511627907,0.7661498708010336,0.23385012919896642
504,6395,6071,324,4221,2174,0.9493354182955434,0.050664581704456604,0.6600469116497264,0.33995308835027366,591,4,152,435,481,110,0.00676818950930626,0.2571912013536379,0.7360406091370558,0.8138747884940778,0.18612521150592218
505,208,98,110,89,119,0.47115384615384615,0.5288461538461539,0.42788461538461536,0.5721153846153846,199,1,54,144,101,98,0.005025125628140704,0.271356783919598,0.7236180904522613,0.507537688442211,0.49246231155778897
506,272,165,107,156,116,0.6066176470588235,0.39338235294117646,0.5735294117647058,0.4264705882352941,241,8,48,185,125,116,0.03319502074688797,0.1991701244813278,0.7676348547717843,0.5186721991701245,0.48132780082987553
507,5612,5566,46,3469,2143,0.9918032786885246,0.00819672131147541,0.6181397006414825,0.38186029935851745,1020,70,273,677,479,541,0.06862745098039216,0.2676470588235294,0.6637254901960784,0.4696078431372549,0.5303921568627451
508,4002,2668,1334,2682,1320,0.6666666666666666,0.3333333333333333,0.6701649175412294,0.32983508245877063,905,39,144,722,590,315,0.0430939226519337,0.1591160220994475,0.7977900552486188,0.6519337016574586,0.34806629834254144
509,1950,1345,605,1449,501,0.6897435897435897,0.31025641025641026,0.7430769230769231,0.2569230769230769,1649,716,139,794,1262,387,0.4342025469981807,0.08429351121892056,0.48150394178289874,0.7653123104912067,0.2346876895087932
510,1584,1478,106,1024,560,0.9330808080808081,0.06691919191919192,0.6464646464646465,0.35353535353535354,289,4,96,189,241,48,0.01384083044982699,0.33217993079584773,0.6539792387543253,0.8339100346020761,0.16608996539792387
511,3013,2419,594,2577,436,0.8028542980418187,0.1971457019581812,0.8552937271822104,0.14470627281778958,2008,39,147,1822,1128,880,0.01942231075697211,0.07320717131474104,0.9073705179282868,0.5617529880478087,0.43824701195219123
512,2188,1738,450,1767,421,0.7943327239488117,0.2056672760511883,0.8075868372943327,0.19241316270566727,1008,59,217,732,679,329,0.05853174603174603,0.2152777777777778,0.7261904761904762,0.6736111111111112,0.3263888888888889
513,0,0,0,0,0,0.0,0.0,0.0,0.0,0,0,0,0,0,0,0.0,0.0,0.0,0.0,0.0
514,112,34,78,94,18,0.30357142857142855,0.6964285714285714,0.8392857142857143,0.16071428571428573,88,0,28,60,85,3,0.0,0.3181818181818182,0.6818181818181818,0.9659090909090909,0.03409090909090909
515,1603,1237,366,1324,279,0.7716781035558328,0.2283218964441672,0.825951341235184,0.17404865876481598,1539,34,209,1296,1036,503,0.022092267706302793,0.13580246913580246,0.8421052631578947,0.673164392462638,0.3268356075373619
516,126,73,53,43,83,0.5793650793650794,0.42063492063492064,0.3412698412698413,0.6587301587301587,120,1,20,99,61,59,0.008333333333333333,0.16666666666666666,0.825,0.5083333333333333,0.49166666666666664
517,1013,718,295,663,350,0.7087857847976308,0.2912142152023692,0.6544916090819348,0.3455083909180652,490,11,122,357,290,200,0.022448979591836733,0.24897959183673468,0.7285714285714285,0.5918367346938775,0.40816326530612246
518,1554,1354,200,1252,302,0.8712998712998713,0.1287001287001287,0.8056628056628057,0.19433719433719435,470,17,63,390,346,124,0.036170212765957444,0.13404255319148936,0.8297872340425532,0.7361702127659574,0.26382978723404255
519,10,3,7,2,8,0.3,0.7,0.2,0.8,30,1,4,25,24,6,0.03333333333333333,0.13333333333333333,0.8333333333333334,0.8,0.2
520,5043,4555,488,4460,583,0.9032322030537379,0.09676779694626214,0.8843942097957564,0.11560579020424351,2671,39,406,2226,1285,1386,0.014601272931486334,0.15200299513290902,0.8333957319356047,0.48109322351179334,0.5189067764882067
521,964,879,85,607,357,0.9118257261410788,0.08817427385892117,0.6296680497925311,0.3703319502074689,173,4,77,92,134,39,0.023121387283236993,0.44508670520231214,0.5317919075144508,0.7745664739884393,0.2254335260115607
522,1046,939,107,638,408,0.8977055449330784,0.1022944550669216,0.609942638623327,0.390057361376673,233,4,87,142,194,39,0.017167381974248927,0.37339055793991416,0.6094420600858369,0.8326180257510729,0.16738197424892703
523,1666,1275,391,1217,449,0.7653061224489796,0.23469387755102042,0.7304921968787516,0.2695078031212485,863,69,153,641,394,469,0.07995365005793743,0.1772885283893395,0.7427578215527231,0.45654692931633833,0.5434530706836617
524,5859,4722,1137,4291,1568,0.8059395801331285,0.19406041986687148,0.7323775388291517,0.26762246117084826,2820,93,523,2204,1604,1216,0.03297872340425532,0.1854609929078014,0.7815602836879433,0.5687943262411348,0.43120567375886526
525,1871,1473,398,1615,256,0.7872795296632816,0.21272047033671834,0.863174772848744,0.136825227151256,594,50,157,387,510,84,0.08417508417508418,0.26430976430976433,0.6515151515151515,0.8585858585858586,0.1414141414141414
526,9378,7245,2133,7933,1445,0.772552783109405,0.22744721689059502,0.845915973555129,0.154084026444871,3778,115,405,3258,3249,529,0.030439385918475385,0.10719957649550027,0.8623610375860243,0.8599788247750132,0.14002117522498678
527,1006,919,87,630,376,0.9135188866799204,0.08648111332007952,0.6262425447316103,0.37375745526838966,255,4,93,158,202,53,0.01568627450980392,0.36470588235294116,0.6196078431372549,0.792156862745098,0.20784313725490197
528,10144,8721,1423,8463,1681,0.8597200315457413,0.14027996845425866,0.8342862776025236,0.16571372239747634,3615,262,617,2736,2833,782,0.07247579529737207,0.1706777316735823,0.7568464730290456,0.7836791147994467,0.21632088520055326
529,1183,1091,92,750,433,0.9222316145393068,0.07776838546069316,0.6339814032121724,0.36601859678782755,230,4,101,125,189,41,0.017391304347826087,0.4391304347826087,0.5434782608695652,0.8217391304347826,0.1782608695652174
530,41061,35153,5908,35033,6028,0.8561165095833029,0.1438834904166971,0.8531940283967755,0.14680597160322448,9560,590,1084,7886,5518,4042,0.06171548117154812,0.11338912133891213,0.8248953974895398,0.5771966527196652,0.42280334728033475
531,1793,1662,131,1092,701,0.9269380925822643,0.07306190741773563,0.6090351366424986,0.3909648633575014,305,4,130,171,261,44,0.013114754098360656,0.4262295081967213,0.5606557377049181,0.8557377049180328,0.14426229508196722
532,988,896,92,617,371,0.9068825910931174,0.0931174089068826,0.6244939271255061,0.37550607287449395,239,4,86,149,191,48,0.016736401673640166,0.3598326359832636,0.6234309623430963,0.799163179916318,0.200836820083682
533,682,535,147,520,162,0.7844574780058651,0.2155425219941349,0.7624633431085044,0.2375366568914956,418,3,50,365,262,156,0.007177033492822967,0.11961722488038277,0.8732057416267942,0.6267942583732058,0.37320574162679426
534,851,629,222,636,215,0.7391304347826086,0.2608695652173913,0.7473560517038778,0.2526439482961222,246,15,50,181,163,83,0.06097560975609756,0.2032520325203252,0.7357723577235772,0.6626016260162602,0.33739837398373984
535,5073,4133,940,3633,1440,0.8147053025822985,0.18529469741770155,0.7161442933175636,0.2838557066824364,1817,21,277,1519,842,975,0.011557512383048982,0.15244909190974132,0.8359933957072097,0.4634012107870116,0.5365987892129884
536,5308,4274,1034,4253,1055,0.805199698568199,0.19480030143180105,0.801243406179352,0.1987565938206481,1683,117,277,1289,1146,537,0.06951871657754011,0.16458704693998813,0.7658942364824718,0.6809269162210339,0.31907308377896615
537,10404,8373,2031,9158,1246,0.8047866205305652,0.19521337946943484,0.8802383698577471,0.11976163014225298,4671,139,331,4201,2772,1899,0.029758081781203167,0.0708627702847356,0.8993791479340613,0.5934489402697495,0.40655105973025046
538,738,605,133,660,78,0.8197831978319783,0.1802168021680217,0.8943089430894309,0.10569105691056911,604,81,140,383,558,46,0.13410596026490065,0.23178807947019867,0.6341059602649006,0.9238410596026491,0.076158940397351
539,13348,11850,1498,11038,2310,0.8877734492058735,0.11222655079412647,0.8269403655978423,0.17305963440215763,5470,78,441,4951,1694,3776,0.014259597806215722,0.08062157221206581,0.9051188299817184,0.3096892138939671,0.6903107861060329
540,1303,1069,234,1119,184,0.8204144282425173,0.17958557175748274,0.8587874136607828,0.14121258633921718,431,47,138,246,399,32,0.10904872389791183,0.32018561484918795,0.5707656612529002,0.925754060324826,0.07424593967517401
541,2514,2124,390,2084,430,0.8448687350835322,0.15513126491646778,0.8289578361177407,0.17104216388225935,894,99,187,608,602,292,0.11073825503355705,0.20917225950782997,0.680089485458613,0.6733780760626398,0.32662192393736017
542,3574,2866,708,2918,656,0.8019026301063235,0.19809736989367654,0.8164521544487968,0.18354784555120313,1240,115,335,790,940,300,0.09274193548387097,0.2701612903225806,0.6370967741935484,0.7580645161290323,0.24193548387096775
543,98,58,40,67,31,0.5918367346938775,0.40816326530612246,0.6836734693877551,0.3163265306122449,35,0,25,10,35,0,0.0,0.7142857142857143,0.2857142857142857,1.0,0.0
544,638,499,139,554,84,0.7821316614420063,0.21786833855799373,0.8683385579937304,0.13166144200626959,592,28,48,516,443,149,0.0472972972972973,0.08108108108108109,0.8716216216216216,0.7483108108108109,0.2516891891891892
545,2058,1530,528,1405,653,0.7434402332361516,0.2565597667638484,0.6827016520894071,0.3172983479105928,3577,106,221,3250,2052,1525,0.029633771316745876,0.061783617556611686,0.9085826111266424,0.5736650824713447,0.4263349175286553
546,1952,1595,357,1576,376,0.8171106557377049,0.18288934426229508,0.8073770491803278,0.19262295081967212,687,52,184,451,514,173,0.07569141193595343,0.2678311499272198,0.6564774381368268,0.7481804949053857,0.25181950509461426
547,12334,10919,1415,10570,1764,0.8852764715420788,0.11472352845792119,0.8569807037457434,0.14301929625425652,1907,160,373,1374,1319,588,0.08390141583639224,0.19559517566858942,0.7205034084950184,0.6916622968012586,0.3083377031987415
548,974,882,92,615,359,0.9055441478439425,0.0944558521560575,0.6314168377823408,0.36858316221765913,175,4,81,90,135,40,0.022857142857142857,0.46285714285714286,0.5142857142857142,0.7714285714285715,0.22857142857142856
549,236,165,71,154,82,0.6991525423728814,0.3008474576271186,0.652542372881356,0.3474576271186441,223,31,37,155,128,95,0.13901345291479822,0.16591928251121077,0.695067264573991,0.5739910313901345,0.4260089686098655
550,1481,1181,300,1211,270,0.7974341661039838,0.2025658338960162,0.8176907494935854,0.18230925050641458,552,83,137,332,427,125,0.1503623188405797,0.24818840579710144,0.6014492753623188,0.7735507246376812,0.22644927536231885
551,637,535,102,566,71,0.8398744113029827,0.16012558869701726,0.8885400313971743,0.11145996860282574,215,25,59,131,160,55,0.11627906976744186,0.2744186046511628,0.6093023255813953,0.7441860465116279,0.2558139534883721
552,7798,6353,1445,6409,1389,0.8146960759169017,0.18530392408309823,0.8218774044626828,0.17812259553731727,3373,206,347,2820,2111,1262,0.0610732285798992,0.10287577823895643,0.8360509931811444,0.625852356952268,0.374147643047732
553,1594,1136,458,1066,528,0.71267252195734,0.28732747804265996,0.6687578419071518,0.3312421580928482,461,35,109,317,280,181,0.07592190889370933,0.23644251626898047,0.6876355748373102,0.6073752711496746,0.3926247288503254
554,15538,13810,1728,12695,2843,0.8887887759042348,0.11121122409576523,0.817029218689664,0.18297078131033595,5892,183,347,5362,3059,2833,0.031059063136456212,0.05889341479972845,0.9100475220638153,0.5191785471826205,0.4808214528173795
555,1479,1179,300,1207,272,0.7971602434077079,0.2028397565922921,0.8160919540229885,0.1839080459770115,548,85,136,327,433,115,0.1551094890510949,0.24817518248175183,0.5967153284671532,0.7901459854014599,0.20985401459854014
556,1348,1192,156,1142,206,0.884272997032641,0.11572700296735905,0.8471810089020771,0.15281899109792285,369,44,125,200,318,51,0.11924119241192412,0.33875338753387535,0.5420054200542005,0.8617886178861789,0.13821138211382114
557,4298,3528,770,3390,908,0.8208469055374593,0.1791530944625407,0.7887389483480689,0.21126105165193113,2256,50,153,2053,1403,853,0.022163120567375887,0.0678191489361702,0.9100177304964538,0.6218971631205674,0.37810283687943264
558,8734,8198,536,5588,3146,0.9386306388825281,0.061369361117471946,0.6397984886649875,0.3602015113350126,1308,6,668,634,1042,266,0.0045871559633027525,0.5107033639143731,0.4847094801223242,0.7966360856269113,0.20336391437308868
559,13412,10151,3261,10132,3280,0.7568595287801968,0.24314047121980317,0.7554428869668953,0.24455711303310468,3744,263,548,2933,2170,1574,0.0702457264957265,0.14636752136752137,0.7833867521367521,0.5795940170940171,0.4204059829059829
560,1083,981,102,670,413,0.9058171745152355,0.09418282548476455,0.61865189289012,0.38134810710988,195,4,89,102,150,45,0.020512820512820513,0.4564102564102564,0.5230769230769231,0.7692307692307693,0.23076923076923078
561,1121,1029,92,689,432,0.9179304192685103,0.08206958073148975,0.6146297948260482,0.3853702051739518,182,4,85,93,143,39,0.02197802197802198,0.46703296703296704,0.510989010989011,0.7857142857142857,0.21428571428571427
562,7649,5831,1818,6589,1060,0.762321872140149,0.23767812785985096,0.8614197934370506,0.1385802065629494,4379,101,260,4018,2638,1741,0.02306462662708381,0.0593742863667504,0.9175610870061658,0.6024206439826444,0.39757935601735556
563,5354,4250,1104,4408,946,0.7937990287635412,0.20620097123645872,0.8233096750093388,0.1766903249906612,3430,108,582,2740,2446,984,0.0314868804664723,0.16967930029154518,0.7988338192419825,0.7131195335276967,0.2868804664723032
564,5903,5516,387,5006,897,0.9344401151956632,0.06555988480433678,0.8480433677790954,0.15195663222090464,1868,30,208,1630,755,1113,0.016059957173447537,0.11134903640256959,0.8725910064239829,0.40417558886509636,0.5958244111349036
565,949,859,90,588,361,0.9051633298208641,0.09483667017913593,0.6195995785036881,0.3804004214963119,196,4,87,105,155,41,0.02040816326530612,0.44387755102040816,0.5357142857142857,0.7908163265306123,0.20918367346938777
566,169,127,42,126,43,0.7514792899408284,0.2485207100591716,0.7455621301775148,0.25443786982248523,652,1,50,601,161,491,0.0015337423312883436,0.07668711656441718,0.9217791411042945,0.2469325153374233,0.7530674846625767
567,888,726,162,734,154,0.8175675675675675,0.18243243243243243,0.8265765765765766,0.17342342342342343,477,9,87,381,285,192,0.018867924528301886,0.18238993710691823,0.7987421383647799,0.5974842767295597,0.4025157232704403
568,84,57,27,77,7,0.6785714285714286,0.32142857142857145,0.9166666666666666,0.08333333333333333,141,4,30,107,117,24,0.028368794326241134,0.2127659574468085,0.7588652482269503,0.8297872340425532,0.1702127659574468
569,6884,5937,947,5507,1377,0.8624346310284718,0.13756536897152818,0.7999709471237653,0.20002905287623474,1350,51,182,1117,636,714,0.03777777777777778,0.1348148148148148,0.8274074074074074,0.4711111111111111,0.5288888888888889
570,1684,1379,305,1468,216,0.8188836104513064,0.18111638954869358,0.8717339667458432,0.12826603325415678,703,80,157,466,590,113,0.11379800853485064,0.2233285917496444,0.662873399715505,0.8392603129445235,0.16073968705547653
571,2343,1868,475,1749,594,0.7972684592402902,0.20273154075970978,0.7464788732394366,0.2535211267605634,1202,91,285,826,338,864,0.07570715474209651,0.23710482529118138,0.6871880199667221,0.281198003327787,0.718801996672213
572,253,156,97,135,118,0.616600790513834,0.383399209486166,0.5335968379446641,0.466403162055336,178,23,42,113,142,36,0.12921348314606743,0.23595505617977527,0.6348314606741573,0.797752808988764,0.20224719101123595
573,330,212,118,259,71,0.6424242424242425,0.3575757575757576,0.7848484848484848,0.21515151515151515,415,35,74,306,260,155,0.08433734939759036,0.1783132530120482,0.7373493975903614,0.6265060240963856,0.37349397590361444
574,127,85,42,77,50,0.6692913385826772,0.33070866141732286,0.6062992125984252,0.3937007874015748,148,29,42,77,106,42,0.19594594594594594,0.28378378378378377,0.5202702702702703,0.7162162162162162,0.28378378378378377
575,270,176,94,204,66,0.6518518518518519,0.34814814814814815,0.7555555555555555,0.24444444444444444,370,28,40,302,213,157,0.07567567567567568,0.10810810810810811,0.8162162162162162,0.5756756756756757,0.4243243243243243
576,5017,4413,604,4126,891,0.879609328283835,0.12039067171616503,0.82240382698824,0.17759617301176,1903,108,786,1009,1416,487,0.05675249605885444,0.41303205465055176,0.5302154492905938,0.744088281660536,0.255911718339464
577,1478,1179,299,1207,271,0.7976995940460081,0.20230040595399187,0.8166441136671178,0.18335588633288227,548,85,136,327,433,115,0.1551094890510949,0.24817518248175183,0.5967153284671532,0.7901459854014599,0.20985401459854014
578,2470,2270,200,1497,973,0.9190283400809717,0.08097165991902834,0.6060728744939271,0.3939271255060729,693,14,422,257,635,58,0.020202020202020204,0.6089466089466089,0.3708513708513709,0.9163059163059163,0.0836940836940837
579,9691,9040,651,8682,1009,0.9328242699411825,0.06717573005881745,0.8958827778351047,0.10411722216489526,1357,31,317,1009,504,853,0.022844509948415623,0.23360353721444363,0.7435519528371407,0.3714075165806927,0.6285924834193073
580,950,865,85,593,357,0.9105263157894737,0.08947368421052632,0.6242105263157894,0.3757894736842105,232,4,104,124,191,41,0.017241379310344827,0.4482758620689655,0.5344827586206896,0.8232758620689655,0.17672413793103448
581,1604,1140,464,1316,288,0.7107231920199502,0.2892768079800499,0.8204488778054863,0.17955112219451372,1257,24,134,1099,813,444,0.01909307875894988,0.10660302307080351,0.8743038981702467,0.6467780429594272,0.3532219570405728
582,831,704,127,676,155,0.8471720818291215,0.15282791817087846,0.8134777376654633,0.1865222623345367,299,29,96,174,237,62,0.09698996655518395,0.3210702341137124,0.5819397993311036,0.7926421404682275,0.20735785953177258
583,26587,21360,5227,21121,5466,0.8034001579719412,0.19659984202805883,0.794410802271787,0.20558919772821305,20292,175,613,19504,9826,10466,0.008624088310664302,0.030208949339641238,0.9611669623496945,0.4842302385176424,0.5157697614823575
584,1505,1191,314,1355,150,0.7913621262458472,0.20863787375415282,0.9003322259136213,0.09966777408637874,625,29,95,501,425,200,0.0464,0.152,0.8016,0.68,0.32
585,1807,1634,173,1104,703,0.9042612064194798,0.0957387935805202,0.6109573879358052,0.38904261206419477,396,4,116,276,337,59,0.010101010101010102,0.29292929292929293,0.696969696969697,0.851010101010101,0.14898989898989898
586,20734,17016,3718,16015,4719,0.8206810070415742,0.17931899295842577,0.7724028166296903,0.22759718337030962,5540,61,771,4708,2403,3137,0.011010830324909748,0.13916967509025271,0.8498194945848375,0.43375451263537906,0.566245487364621
587,99,63,36,83,16,0.6363636363636364,0.36363636363636365,0.8383838383838383,0.16161616161616163,133,27,32,74,114,19,0.20300751879699247,0.24060150375939848,0.556390977443609,0.8571428571428571,0.14285714285714285
588,976,891,85,613,363,0.9129098360655737,0.08709016393442623,0.6280737704918032,0.3719262295081967,185,4,80,101,146,39,0.021621621621621623,0.43243243243243246,0.5459459459459459,0.7891891891891892,0.21081081081081082
589,25283,19813,5470,18245,7038,0.783649092275442,0.216350907724558,0.7216311355456235,0.2783688644543765,20247,104,551,19592,15262,4985,0.0051365634414975055,0.027213908233318516,0.967649528325184,0.753790685039759,0.246209314960241
590,1479,1179,300,1207,272,0.7971602434077079,0.2028397565922921,0.8160919540229885,0.1839080459770115,548,85,136,327,433,115,0.1551094890510949,0.24817518248175183,0.5967153284671532,0.7901459854014599,0.20985401459854014
591,3637,2999,638,2884,753,0.8245806983777839,0.1754193016222161,0.7929612317844377,0.20703876821556227,761,45,195,521,561,200,0.05913272010512484,0.25624178712220763,0.6846254927726675,0.7371879106438897,0.2628120893561104
592,1296,1069,227,1115,181,0.8248456790123457,0.17515432098765432,0.8603395061728395,0.1396604938271605,796,40,87,669,610,186,0.05025125628140704,0.1092964824120603,0.8404522613065326,0.7663316582914573,0.23366834170854273
593,107,76,31,80,27,0.7102803738317757,0.2897196261682243,0.7476635514018691,0.2523364485981308,225,4,92,129,186,39,0.017777777777777778,0.4088888888888889,0.5733333333333334,0.8266666666666667,0.17333333333333334
594,3844,2979,865,2842,1002,0.7749739854318418,0.22502601456815816,0.7393340270551508,0.2606659729448491,2030,55,177,1798,1269,761,0.027093596059113302,0.08719211822660099,0.8857142857142857,0.6251231527093596,0.3748768472906404
595,4132,3510,622,3651,481,0.8494675701839303,0.1505324298160697,0.8835914811229428,0.11640851887705711,3688,22,326,3340,2264,1424,0.00596529284164859,0.08839479392624729,0.9056399132321041,0.613882863340564,0.38611713665943603
596,805,585,220,681,124,0.7267080745341615,0.2732919254658385,0.8459627329192546,0.15403726708074533,885,48,103,734,630,255,0.05423728813559322,0.11638418079096045,0.8293785310734463,0.711864406779661,0.288135593220339
597,1383,886,497,1139,244,0.6406362979031092,0.35936370209689084,0.8235719450469993,0.17642805495300073,3483,29,361,3093,2006,1477,0.008326155612977318,0.10364628194085558,0.8880275624461671,0.575940281366638,0.42405971863336206
598,2749,2121,628,2369,380,0.7715532921062205,0.22844670789377955,0.8617679156056748,0.13823208439432522,1153,51,178,924,817,336,0.04423243712055507,0.15437987857762359,0.8013876843018214,0.7085862966175195,0.29141370338248046
599,58,33,25,31,27,0.5689655172413793,0.43103448275862066,0.5344827586206896,0.46551724137931033,96,5,26,65,71,25,0.052083333333333336,0.2708333333333333,0.6770833333333334,0.7395833333333334,0.2604166666666667
600,3029,2440,589,2345,684,0.8055463849455266,0.19445361505447342,0.774182898646418,0.22581710135358204,1690,223,357,1110,895,795,0.1319526627218935,0.21124260355029587,0.6568047337278107,0.5295857988165681,0.47041420118343197
601,14826,12975,1851,10813,4013,0.8751517604208823,0.12484823957911777,0.7293268582220424,0.27067314177795765,4471,71,360,4040,2953,1518,0.015880116305077165,0.08051889957503915,0.9036009841198837,0.6604786401252516,0.33952135987474835
602,4720,4316,404,2899,1821,0.9144067796610169,0.08559322033898305,0.6141949152542373,0.3858050847457627,1605,18,197,1390,1039,566,0.011214953271028037,0.12274143302180686,0.8660436137071651,0.6473520249221184,0.3526479750778816
603,10257,8115,2142,8996,1261,0.791167007897046,0.20883299210295408,0.8770595690747782,0.1229404309252218,8626,48,403,8175,3695,4931,0.005564572223510317,0.04671922095988871,0.947716206816601,0.42835613262230465,0.5716438673776953
604,4551,4113,438,4043,508,0.9037574159525379,0.0962425840474621,0.8883761810591079,0.11162381894089211,2493,41,360,2092,1194,1299,0.016446048937023665,0.1444043321299639,0.8391496189330124,0.4789410348977136,0.5210589651022864
605,1332,968,364,936,396,0.7267267267267268,0.2732732732732733,0.7027027027027027,0.2972972972972973,524,21,117,386,268,256,0.04007633587786259,0.22328244274809161,0.7366412213740458,0.5114503816793893,0.48854961832061067
606,2849,2291,558,2508,341,0.8041418041418041,0.19585819585819586,0.8803088803088803,0.11969111969111969,1070,134,329,607,1000,70,0.1252336448598131,0.3074766355140187,0.5672897196261683,0.9345794392523364,0.06542056074766354
607,2452,1900,552,1959,493,0.7748776508972267,0.22512234910277323,0.7989396411092985,0.20106035889070148,1260,93,195,972,837,423,0.07380952380952381,0.15476190476190477,0.7714285714285715,0.6642857142857143,0.3357142857142857
608,2645,2033,612,2327,318,0.7686200378071834,0.23137996219281665,0.879773156899811,0.12022684310018904,1203,19,182,1002,828,375,0.015793848711554447,0.1512884455527847,0.8329177057356608,0.6882793017456359,0.3117206982543641
609,49769,42617,7152,42033,7736,0.8562960879262191,0.14370391207378086,0.8445618758665032,0.15543812413349675,27343,13159,1740,12444,20225,7118,0.4812566287532458,0.06363603115971181,0.4551073400870424,0.7396774311523974,0.2603225688476027
610,5835,5308,527,5121,714,0.9096829477292202,0.09031705227077978,0.8776349614395886,0.12236503856041131,2923,48,449,2426,1395,1528,0.016421484775915155,0.1536093055080397,0.8299692097160452,0.47724940130003424,0.5227505986999658
611,14735,13403,1332,12633,2102,0.9096029860875466,0.09039701391245335,0.8573464540210384,0.14265354597896165,2100,152,644,1304,1267,833,0.07238095238095238,0.30666666666666664,0.6209523809523809,0.6033333333333334,0.39666666666666667
612,12334,10919,1415,10570,1764,0.8852764715420788,0.11472352845792119,0.8569807037457434,0.14301929625425652,1906,160,373,1373,1319,587,0.08394543546694648,0.195697796432319,0.7203567681007346,0.6920251836306401,0.3079748163693599
613,17552,15696,1856,13164,4388,0.894257064721969,0.105742935278031,0.75,0.25,4009,31,357,3621,2240,1769,0.007732601646295834,0.08904963831379396,0.9032177600399102,0.55874282863557,0.44125717136443005
614,2103,1765,338,1755,348,0.8392772230147408,0.16072277698525916,0.8345221112696148,0.16547788873038516,804,55,271,478,580,224,0.06840796019900497,0.3370646766169154,0.5945273631840796,0.7213930348258707,0.27860696517412936
615,1012,717,295,663,349,0.708498023715415,0.29150197628458496,0.6551383399209486,0.3448616600790514,490,11,122,357,290,200,0.022448979591836733,0.24897959183673468,0.7285714285714285,0.5918367346938775,0.40816326530612246
616,659,518,141,568,91,0.7860394537177542,0.21396054628224584,0.8619119878603946,0.13808801213960548,302,37,92,173,274,28,0.12251655629139073,0.304635761589404,0.5728476821192053,0.9072847682119205,0.09271523178807947
617,2082,1680,402,1693,389,0.8069164265129684,0.1930835734870317,0.8131604226705091,0.18683957732949089,717,85,186,446,567,150,0.11854951185495119,0.2594142259414226,0.6220362622036262,0.7907949790794979,0.20920502092050208
618,4590,3479,1111,3775,815,0.7579520697167756,0.2420479302832244,0.8224400871459695,0.1775599128540305,1380,53,217,1110,831,549,0.03840579710144928,0.1572463768115942,0.8043478260869565,0.6021739130434782,0.3978260869565217
619,5785,4153,1632,4991,794,0.7178910976663786,0.28210890233362146,0.8627484874675886,0.1372515125324114,7067,4466,266,2335,6011,1056,0.6319513230507995,0.03763973397481251,0.330408942974388,0.8505730861751805,0.1494269138248196
620,1806,1171,635,1287,519,0.6483942414174972,0.35160575858250276,0.7126245847176079,0.287375415282392,2612,37,243,2332,1532,1080,0.014165390505359877,0.0930321592649311,0.892802450229709,0.5865237366003063,0.41347626339969373
621,163,89,74,84,79,0.5460122699386503,0.4539877300613497,0.5153374233128835,0.48466257668711654,145,5,36,104,72,73,0.034482758620689655,0.2482758620689655,0.7172413793103448,0.496551724137931,0.503448275862069
622,2231,2076,155,1498,733,0.9305244285073958,0.06947557149260421,0.6714477812640072,0.32855221873599283,374,4,120,250,258,116,0.0106951871657754,0.32085561497326204,0.6684491978609626,0.6898395721925134,0.31016042780748665
623,1003,795,208,843,160,0.7926221335992024,0.2073778664007976,0.8404785643070788,0.15952143569292124,398,50,141,207,380,18,0.12562814070351758,0.3542713567839196,0.5201005025125628,0.9547738693467337,0.04522613065326633
624,9547,7364,2183,7610,1937,0.7713417827589819,0.22865821724101812,0.7971090394888447,0.20289096051115535,5083,79,561,4443,2761,2322,0.015542002754278968,0.11036789297658862,0.8740901042691324,0.543183159551446,0.45681684044855403
625,1331,1232,99,841,490,0.9256198347107438,0.0743801652892562,0.6318557475582269,0.3681442524417731,189,4,89,96,147,42,0.021164021164021163,0.4708994708994709,0.5079365079365079,0.7777777777777778,0.2222222222222222
626,4174,3439,735,3489,685,0.8239099185433637,0.17609008145663632,0.8358888356492573,0.1641111643507427,2018,115,222,1681,1196,822,0.05698711595639247,0.11000991080277503,0.8330029732408325,0.5926660059464817,0.40733399405351833
627,17760,14962,2798,14412,3348,0.8424549549549549,0.15754504504504505,0.8114864864864865,0.1885135135135135,4912,134,697,4081,3022,1890,0.02728013029315961,0.14189739413680783,0.8308224755700325,0.615228013029316,0.38477198697068404
628,562,392,170,340,222,0.697508896797153,0.302491103202847,0.604982206405694,0.39501779359430605,369,54,93,222,209,160,0.14634146341463414,0.25203252032520324,0.6016260162601627,0.5663956639566395,0.43360433604336046
629,4638,3625,1013,3722,916,0.7815868909012506,0.21841310909874945,0.802501078050884,0.197498921949116,1465,102,285,1078,1155,310,0.0696245733788396,0.1945392491467577,0.7358361774744028,0.78839590443686,0.21160409556313994
630,170,95,75,79,91,0.5588235294117647,0.4411764705882353,0.4647058823529412,0.5352941176470588,161,1,30,130,90,71,0.006211180124223602,0.18633540372670807,0.8074534161490683,0.5590062111801242,0.4409937888198758
631,1870,1473,397,1613,257,0.7877005347593583,0.21229946524064172,0.8625668449197861,0.1374331550802139,594,50,157,387,510,84,0.08417508417508418,0.26430976430976433,0.6515151515151515,0.8585858585858586,0.1414141414141414
632,3367,2581,786,2491,876,0.7665577665577665,0.23344223344223344,0.7398277398277399,0.2601722601722602,2540,26,195,2319,1428,1112,0.010236220472440945,0.07677165354330709,0.912992125984252,0.5622047244094488,0.4377952755905512
633,5270,5144,126,3511,1759,0.9760910815939279,0.023908918406072108,0.6662239089184061,0.33377609108159395,1262,116,260,886,494,768,0.0919175911251981,0.20602218700475436,0.7020602218700476,0.39144215530903326,0.6085578446909667
634,609,435,174,393,216,0.7142857142857143,0.2857142857142857,0.645320197044335,0.35467980295566504,217,3,65,149,121,96,0.013824884792626729,0.2995391705069124,0.6866359447004609,0.5576036866359447,0.4423963133640553
635,12564,11071,1493,10195,2369,0.881168417701369,0.11883158229863101,0.8114453995542821,0.18855460044571792,4192,169,676,3347,2834,1358,0.04031488549618321,0.16125954198473283,0.798425572519084,0.6760496183206107,0.32395038167938933
636,1622,1176,446,1380,242,0.7250308261405672,0.2749691738594328,0.8508014796547472,0.14919852034525277,1277,30,111,1136,778,499,0.023492560689115115,0.08692247454972592,0.889584964761159,0.6092404072043853,0.39075959279561473
637,2062,1544,518,1469,593,0.7487875848690592,0.25121241513094084,0.7124151309408342,0.28758486905916586,978,134,280,564,558,420,0.13701431492842536,0.28629856850715746,0.5766871165644172,0.5705521472392638,0.4294478527607362
638,1006,921,85,633,373,0.915506958250497,0.08449304174950298,0.6292246520874751,0.37077534791252487,175,4,75,96,135,40,0.022857142857142857,0.42857142857142855,0.5485714285714286,0.7714285714285715,0.22857142857142856
639,867,645,222,698,169,0.7439446366782007,0.2560553633217993,0.8050749711649365,0.19492502883506344,712,44,128,540,439,273,0.06179775280898876,0.1797752808988764,0.7584269662921348,0.6165730337078652,0.38342696629213485
640,1383,1220,163,1309,74,0.8821402747650036,0.11785972523499638,0.9464931308749096,0.05350686912509038,480,14,57,409,314,166,0.029166666666666667,0.11875,0.8520833333333333,0.6541666666666667,0.3458333333333333
641,1195,790,405,1017,178,0.6610878661087866,0.3389121338912134,0.8510460251046025,0.1489539748953975,3542,28,510,3004,1777,1765,0.007905138339920948,0.14398644833427443,0.8481084133258047,0.5016939582156974,0.49830604178430266
642,1081,983,98,684,397,0.9093432007400555,0.09065679925994449,0.6327474560592045,0.36725254394079554,277,4,109,164,223,54,0.01444043321299639,0.3935018050541516,0.592057761732852,0.8050541516245487,0.19494584837545126
643,2458,2097,361,1945,513,0.8531326281529699,0.1468673718470301,0.791293734743694,0.20870626525630595,628,15,85,528,382,246,0.02388535031847134,0.13535031847133758,0.8407643312101911,0.60828025477707,0.39171974522292996
644,2586,1909,677,2165,421,0.7382057231245166,0.26179427687548334,0.837200309358082,0.16279969064191802,2053,37,162,1854,1041,1012,0.01802240623477837,0.07890891378470531,0.9030686799805163,0.5070628348757915,0.4929371651242085
645,1916,1524,392,1421,495,0.7954070981210856,0.2045929018789144,0.7416492693110647,0.25835073068893527,751,90,217,444,492,259,0.11984021304926765,0.28894806924101196,0.5912117177097204,0.6551264980026631,0.3448735019973369
646,19550,16332,3218,15977,3573,0.8353964194373401,0.16460358056265983,0.8172378516624041,0.1827621483375959,9962,338,750,8874,4266,5696,0.03392892993374824,0.07528608713109818,0.8907849829351536,0.4282272636016864,0.5717727363983136
647,3279,2470,809,2360,919,0.7532784385483379,0.2467215614516621,0.7197316254955779,0.2802683745044221,2126,32,181,1913,1256,870,0.015051740357478834,0.08513640639698965,0.8998118532455315,0.5907808090310442,0.40921919096895576
648,36434,28113,8321,25600,10834,0.7716144260855246,0.2283855739144755,0.7026403908437174,0.29735960915628257,11235,182,1390,9663,7683,3552,0.0161993769470405,0.12372051624388072,0.8600801068090788,0.683845126835781,0.316154873164219
649,1531,988,543,949,582,0.6453298497713913,0.35467015022860876,0.6198563030698889,0.380143696930111,712,35,184,493,563,149,0.04915730337078652,0.25842696629213485,0.6924157303370787,0.7907303370786517,0.20926966292134833
650,2093,1658,435,1824,269,0.7921643573817487,0.20783564261825133,0.8714763497372193,0.1285236502627807,625,60,171,394,527,98,0.096,0.2736,0.6304,0.8432,0.1568
651,17699,14825,2874,13528,4171,0.8376179445166394,0.16238205548336065,0.7643369681902933,0.23566303180970677,11418,335,508,10575,5676,5742,0.02933963916622876,0.04449115431774391,0.9261692065160273,0.49710982658959535,0.5028901734104047
652,2962,2094,868,2100,862,0.7069547602970966,0.29304523970290347,0.7089804186360568,0.2910195813639433,770,82,166,522,487,283,0.10649350649350649,0.21558441558441557,0.6779220779220779,0.6324675324675325,0.36753246753246754
653,6867,5887,980,4110,2757,0.8572884811416922,0.14271151885830785,0.598514635211883,0.4014853647881171,2877,107,433,2337,2369,508,0.037191518943343764,0.1505039972193257,0.8123044838373306,0.8234271810914147,0.17657281890858534
654,428,285,143,362,66,0.6658878504672897,0.3341121495327103,0.8457943925233645,0.1542056074766355,221,12,42,167,177,44,0.05429864253393665,0.19004524886877827,0.755656108597285,0.8009049773755657,0.19909502262443438
655,1281,995,286,1049,232,0.7767369242779079,0.2232630757220921,0.8188914910226386,0.18110850897736144,526,32,83,411,405,121,0.060836501901140684,0.15779467680608364,0.7813688212927756,0.7699619771863118,0.2300380228136882
656,7227,5806,1421,5915,1312,0.8033762280337623,0.19662377196623773,0.8184585581845856,0.18154144181541443,2243,212,360,1671,1538,705,0.09451627284886313,0.16049933125278645,0.7449843958983504,0.6856888096299599,0.3143111903700401
657,11968,10612,1356,10262,1706,0.8866978609625669,0.11330213903743315,0.8574532085561497,0.14254679144385027,1883,158,370,1355,1298,585,0.08390865639936272,0.19649495485926713,0.7195963887413701,0.6893255443441317,0.3106744556558683
658,1673,1378,295,1386,287,0.8236700537955768,0.1763299462044232,0.8284518828451883,0.17154811715481172,667,100,185,382,532,135,0.14992503748125938,0.2773613193403298,0.5727136431784108,0.7976011994002998,0.20239880059970014
659,1542,1394,148,942,600,0.9040207522697795,0.0959792477302205,0.6108949416342413,0.38910505836575876,436,4,192,240,373,63,0.009174311926605505,0.44036697247706424,0.5504587155963303,0.8555045871559633,0.1444954128440367
660,3202,2493,709,2412,790,0.7785758900687071,0.22142410993129294,0.7532792004996877,0.2467207995003123,849,55,211,583,570,279,0.06478209658421673,0.24852767962308597,0.6866902237926973,0.6713780918727915,0.3286219081272085
661,7789,6737,1052,6467,1322,0.8649377326999614,0.1350622673000385,0.8302734625754269,0.1697265374245731,4241,49,825,3367,2821,1420,0.0115538788021693,0.19452959207734025,0.7939165291204905,0.6651733081820326,0.3348266918179675
662,5216,3747,1469,4185,1031,0.7183665644171779,0.2816334355828221,0.8023389570552147,0.1976610429447853,3668,827,704,2137,2713,955,0.22546346782988005,0.19193020719738277,0.5826063249727372,0.7396401308615049,0.26035986913849507
663,8114,6618,1496,6717,1397,0.8156273108208035,0.18437268917919644,0.8278284446635444,0.1721715553364555,3770,81,426,3263,2101,1669,0.021485411140583555,0.1129973474801061,0.8655172413793103,0.5572944297082228,0.4427055702917772
664,151,88,63,122,29,0.5827814569536424,0.41721854304635764,0.8079470198675497,0.19205298013245034,136,4,27,105,121,15,0.029411764705882353,0.19852941176470587,0.7720588235294118,0.8897058823529411,0.11029411764705882
665,1866,1319,547,1303,563,0.7068595927116827,0.29314040728831725,0.6982851018220794,0.3017148981779207,811,63,147,601,417,394,0.07768187422934648,0.1812577065351418,0.7410604192355117,0.5141800246609125,0.48581997533908755
666,15491,12397,3094,13464,2027,0.8002711251694532,0.19972887483054677,0.8691498289329288,0.1308501710670712,5683,163,470,5050,4426,1257,0.028682034136899525,0.08270279781805384,0.8886151680450466,0.7788140066866092,0.2211859933133908
667,52,19,33,19,33,0.36538461538461536,0.6346153846153846,0.36538461538461536,0.6346153846153846,94,1,29,64,58,36,0.010638297872340425,0.30851063829787234,0.6808510638297872,0.6170212765957447,0.3829787234042553
668,1865,1710,155,1587,278,0.9168900804289544,0.08310991957104558,0.8509383378016085,0.14906166219839143,1016,76,289,651,744,272,0.07480314960629922,0.2844488188976378,0.640748031496063,0.7322834645669292,0.2677165354330709
669,5641,4265,1376,4609,1032,0.7560716185073568,0.24392838149264315,0.8170537138805176,0.18294628611948235,2104,94,282,1728,1641,463,0.04467680608365019,0.13403041825095058,0.8212927756653993,0.7799429657794676,0.22005703422053233
670,867,645,222,698,169,0.7439446366782007,0.2560553633217993,0.8050749711649365,0.19492502883506344,744,44,128,572,439,305,0.05913978494623656,0.17204301075268819,0.7688172043010753,0.5900537634408602,0.4099462365591398
671,1537,1292,245,1235,302,0.8405985686402082,0.1594014313597918,0.8035133376707873,0.19648666232921275,578,78,177,323,494,84,0.13494809688581316,0.3062283737024221,0.5588235294117647,0.8546712802768166,0.1453287197231834
672,1005,913,92,620,385,0.9084577114427861,0.09154228855721393,0.6169154228855721,0.38308457711442784,184,4,84,96,145,39,0.021739130434782608,0.45652173913043476,0.5217391304347826,0.7880434782608695,0.21195652173913043
673,258,164,94,224,34,0.6356589147286822,0.3643410852713178,0.8682170542635659,0.13178294573643412,384,7,106,271,292,92,0.018229166666666668,0.2760416666666667,0.7057291666666666,0.7604166666666666,0.23958333333333334
674,989,895,94,618,371,0.9049544994944388,0.09504550050556117,0.6248736097067745,0.3751263902932255,195,4,92,99,156,39,0.020512820512820513,0.4717948717948718,0.5076923076923077,0.8,0.2
675,26049,22647,3402,23132,2917,0.8693999769664862,0.13060002303351376,0.8880187339245269,0.11198126607547315,13428,1695,2647,9086,12448,980,0.12622877569258267,0.19712540959189753,0.6766458147155198,0.9270181709859994,0.07298182901400059
676,17708,14943,2765,14900,2808,0.8438558843460583,0.15614411565394173,0.8414276033431217,0.15857239665687825,11682,176,668,10838,3963,7719,0.015065913370998116,0.05718198938537922,0.9277520972436226,0.3392398561890087,0.6607601438109912
677,188,113,75,91,97,0.601063829787234,0.39893617021276595,0.48404255319148937,0.5159574468085106,134,1,34,99,106,28,0.007462686567164179,0.2537313432835821,0.7388059701492538,0.7910447761194029,0.208955223880597
678,1658,1316,342,1230,428,0.7937273823884198,0.20627261761158022,0.7418576598311218,0.25814234016887816,542,45,160,337,346,196,0.08302583025830258,0.2952029520295203,0.6217712177121771,0.6383763837638377,0.36162361623616235
679,9458,8301,1157,8103,1355,0.8776696976104885,0.12233030238951152,0.8567350391203215,0.14326496087967858,1280,76,305,899,659,621,0.059375,0.23828125,0.70234375,0.51484375,0.48515625
680,32596,29572,3024,27980,4616,0.9072278807215609,0.09277211927843908,0.8583875322125414,0.1416124677874586,15737,334,1299,14104,7319,8418,0.021223867319057,0.08254432229776959,0.8962318103831735,0.46508229014424607,0.5349177098557539
681,11397,8929,2468,9141,2256,0.7834517855576029,0.21654821444239714,0.8020531718873388,0.19794682811266123,4408,117,706,3585,2890,1518,0.026542649727767695,0.1601633393829401,0.8132940108892922,0.6556261343012704,0.3443738656987296
682,25268,19801,5467,18238,7030,0.7836393857843913,0.21636061421560868,0.7217824916890929,0.2782175083109071,20242,104,549,19589,15257,4985,0.005137832230016797,0.027121825906530974,0.9677403418634523,0.7537298685900603,0.24627013140993972
683,2865,2284,581,2255,610,0.7972076788830715,0.20279232111692844,0.787085514834206,0.21291448516579406,2000,11,133,1856,847,1153,0.0055,0.0665,0.928,0.4235,0.5765
684,169,127,42,126,43,0.7514792899408284,0.2485207100591716,0.7455621301775148,0.25443786982248523,652,1,50,601,161,491,0.0015337423312883436,0.07668711656441718,0.9217791411042945,0.2469325153374233,0.7530674846625767
685,99,62,37,83,16,0.6262626262626263,0.37373737373737376,0.8383838383838383,0.16161616161616163,133,28,31,74,114,19,0.21052631578947367,0.23308270676691728,0.556390977443609,0.8571428571428571,0.14285714285714285
686,13616,11218,2398,10898,2718,0.8238836662749707,0.17611633372502938,0.8003819036427732,0.1996180963572268,3632,108,421,3103,2875,757,0.02973568281938326,0.11591409691629956,0.8543502202643172,0.7915748898678414,0.2084251101321586
687,11753,9926,1827,9539,2214,0.8445503275759381,0.15544967242406194,0.8116225644516294,0.18837743554837064,5623,131,441,5051,3205,2418,0.023297172327938823,0.07842788547038947,0.8982749422016717,0.5699804374888849,0.43001956251111506
688,114,75,39,101,13,0.6578947368421053,0.34210526315789475,0.8859649122807017,0.11403508771929824,128,29,36,63,120,8,0.2265625,0.28125,0.4921875,0.9375,0.0625
689,479,335,144,405,74,0.6993736951983298,0.30062630480167013,0.8455114822546973,0.1544885177453027,251,18,51,182,216,35,0.07171314741035857,0.20318725099601595,0.7250996015936255,0.8605577689243028,0.1394422310756972
690,4815,3959,856,3896,919,0.8222222222222222,0.17777777777777778,0.8091381100726895,0.19086188992731049,1608,109,273,1226,1141,467,0.06778606965174129,0.16977611940298507,0.7624378109452736,0.7095771144278606,0.2904228855721393
691,6663,5323,1340,5299,1364,0.7988893891640402,0.20111061083595977,0.795287408074441,0.20471259192555905,4552,61,225,4266,2241,2311,0.013400702987697716,0.049428822495606324,0.937170474516696,0.49231107205623903,0.507688927943761
692,20566,18141,2425,16884,3682,0.8820869396090635,0.11791306039093649,0.8209666439754936,0.17903335602450646,14148,768,1861,11519,7372,6776,0.0542832909245123,0.1315380265761945,0.8141786824992931,0.5210630477806051,0.478936952219395
693,7148,6230,918,5804,1344,0.8715724678231673,0.12842753217683267,0.8119753777280359,0.18802462227196418,855,41,363,451,700,155,0.047953216374269005,0.4245614035087719,0.5274853801169591,0.8187134502923976,0.18128654970760233
694,422,232,190,239,183,0.5497630331753555,0.45023696682464454,0.566350710900474,0.43364928909952605,324,15,103,206,206,118,0.046296296296296294,0.31790123456790126,0.6358024691358025,0.6358024691358025,0.36419753086419754
695,3760,2644,1116,3045,715,0.7031914893617022,0.2968085106382979,0.8098404255319149,0.1901595744680851,4550,69,601,3880,3960,590,0.015164835164835164,0.1320879120879121,0.8527472527472527,0.8703296703296703,0.12967032967032968
696,372,260,112,273,99,0.6989247311827957,0.3010752688172043,0.7338709677419355,0.2661290322580645,372,31,59,282,279,93,0.08333333333333333,0.1586021505376344,0.7580645161290323,0.75,0.25
697,1197,989,208,1009,188,0.8262322472848789,0.17376775271512113,0.8429406850459482,0.1570593149540518,541,45,151,345,419,122,0.08317929759704251,0.27911275415896486,0.6377079482439926,0.7744916820702403,0.2255083179297597
698,1080,1034,46,1039,41,0.9574074074074074,0.04259259259259259,0.962037037037037,0.03796296296296296,37,0,26,11,37,0,0.0,0.7027027027027027,0.2972972972972973,1.0,0.0
699,4001,3096,905,2832,1169,0.7738065483629093,0.22619345163709073,0.7078230442389403,0.29217695576105973,3322,50,159,3113,1389,1933,0.015051173991571343,0.04786273329319687,0.9370860927152318,0.4181216134858519,0.5818783865141481
700,1479,1179,300,1207,272,0.7971602434077079,0.2028397565922921,0.8160919540229885,0.1839080459770115,548,85,136,327,433,115,0.1551094890510949,0.24817518248175183,0.5967153284671532,0.7901459854014599,0.20985401459854014
701,22279,21264,1015,18689,3590,0.9544414022173348,0.04555859778266529,0.8388617083352036,0.16113829166479646,27965,34,18431,9500,21880,6085,0.0012158054711246201,0.6590738423028786,0.33971035222599677,0.7824065796531379,0.21759342034686216
702,9642,8098,1544,7729,1913,0.8398672474590334,0.1601327525409666,0.8015971790085045,0.19840282099149553,4638,202,703,3733,2703,1935,0.043553255713669685,0.15157395429064252,0.8048727899956878,0.5827943078913325,0.41720569210866754
703,1120,1028,92,689,431,0.9178571428571428,0.08214285714285714,0.6151785714285715,0.3848214285714286,182,4,85,93,143,39,0.02197802197802198,0.46703296703296704,0.510989010989011,0.7857142857142857,0.21428571428571427
704,4636,3632,1004,3337,1299,0.7834339948231234,0.21656600517687663,0.7198015530629853,0.2801984469370147,2169,153,776,1240,1197,972,0.07053941908713693,0.3577685569386814,0.5716920239741816,0.5518672199170125,0.44813278008298757
705,1027,933,94,642,385,0.9084712755598832,0.09152872444011685,0.6251217137293087,0.3748782862706913,218,4,91,123,176,42,0.01834862385321101,0.41743119266055045,0.5642201834862385,0.8073394495412844,0.1926605504587156
706,21011,19031,1980,17111,3900,0.905763647613155,0.09423635238684498,0.8143829422683356,0.18561705773166437,4121,211,1275,2635,2850,1271,0.051201164765833536,0.30939092453288036,0.6394079107012861,0.6915797136617325,0.3084202863382674
707,843,648,195,636,207,0.7686832740213523,0.2313167259786477,0.7544483985765125,0.24555160142348753,285,7,42,236,128,157,0.02456140350877193,0.14736842105263157,0.8280701754385965,0.44912280701754387,0.5508771929824562
708,6984,5793,1191,5664,1320,0.8294673539518901,0.17053264604810997,0.8109965635738832,0.18900343642611683,1832,150,357,1325,1349,483,0.08187772925764192,0.19486899563318777,0.7232532751091703,0.736353711790393,0.263646288209607
709,29107,26993,2114,22923,6184,0.9273714226818291,0.07262857731817089,0.7875425155460886,0.21245748445391144,1888,0,752,1136,1029,859,0.0,0.3983050847457627,0.6016949152542372,0.545021186440678,0.454978813559322
710,2823,2020,803,2272,551,0.7155508324477506,0.28444916755224936,0.8048175699610344,0.19518243003896563,2310,1115,178,1017,1841,469,0.48268398268398266,0.07705627705627706,0.44025974025974024,0.796969696969697,0.20303030303030303
711,749,523,226,480,269,0.69826435246996,0.30173564753004006,0.6408544726301736,0.3591455273698264,264,4,91,169,209,55,0.015151515151515152,0.3446969696969697,0.6401515151515151,0.7916666666666666,0.20833333333333334
712,4450,3418,1032,3158,1292,0.7680898876404494,0.23191011235955056,0.7096629213483147,0.2903370786516854,2597,130,577,1890,2126,471,0.05005775895263766,0.22217943781286098,0.7277628032345014,0.8186368887177512,0.18136311128224875
713,5086,4491,595,4286,800,0.8830121903263861,0.11698780967361384,0.842705465985057,0.15729453401494298,1241,95,375,771,966,275,0.07655116841257051,0.3021756647864625,0.621273166800967,0.7784045124899275,0.22159548751007252
714,1831,1467,364,1518,313,0.801201529219006,0.198798470780994,0.8290551611141452,0.1709448388858547,720,50,243,427,583,137,0.06944444444444445,0.3375,0.5930555555555556,0.8097222222222222,0.19027777777777777
715,10307,7311,2996,8083,2224,0.7093237605510818,0.2906762394489182,0.7842243135732997,0.2157756864267003,10756,188,501,10067,5769,4987,0.017478616586091483,0.046578653774637414,0.935942729639271,0.5363518036444775,0.4636481963555225
716,1365,859,506,823,542,0.6293040293040293,0.3706959706959707,0.6029304029304029,0.39706959706959705,549,19,140,390,329,220,0.03460837887067395,0.2550091074681239,0.7103825136612022,0.599271402550091,0.4007285974499089
717,623,436,187,389,234,0.6998394863563403,0.3001605136436597,0.6243980738362761,0.3756019261637239,878,34,77,767,292,586,0.0387243735763098,0.08769931662870159,0.8735763097949886,0.3325740318906606,0.6674259681093394
718,1876,1468,408,1635,241,0.7825159914712153,0.21748400852878466,0.8715351812366737,0.12846481876332622,657,51,192,414,544,113,0.0776255707762557,0.2922374429223744,0.6301369863013698,0.8280060882800608,0.1719939117199391
719,125,71,54,108,17,0.568,0.432,0.864,0.136,173,30,44,99,155,18,0.17341040462427745,0.2543352601156069,0.5722543352601156,0.8959537572254336,0.10404624277456648
720,1866,1319,547,1304,562,0.7068595927116827,0.29314040728831725,0.6988210075026795,0.3011789924973205,811,63,147,601,417,394,0.07768187422934648,0.1812577065351418,0.7410604192355117,0.5141800246609125,0.48581997533908755
721,8624,7542,1082,6902,1722,0.8745361781076066,0.12546382189239333,0.8003246753246753,0.19967532467532467,3537,116,519,2902,2305,1232,0.032796154933559515,0.14673452078032231,0.8204693242861182,0.6516822165677127,0.34831778343228725
722,1441,956,485,1104,337,0.6634281748785565,0.33657182512144346,0.7661346287300486,0.2338653712699514,1063,49,135,879,825,238,0.04609595484477893,0.12699905926622765,0.8269049858889934,0.7761053621825024,0.22389463781749766
723,5487,5165,322,3251,2236,0.9413158374339348,0.05868416256606525,0.5924913431747767,0.40750865682522325,1012,4,721,287,929,83,0.003952569169960474,0.7124505928853755,0.283596837944664,0.9179841897233202,0.08201581027667984
724,1382,955,427,858,524,0.691027496382055,0.308972503617945,0.6208393632416788,0.3791606367583213,770,39,110,621,413,357,0.05064935064935065,0.14285714285714285,0.8064935064935065,0.5363636363636364,0.4636363636363636
725,1068,974,94,684,384,0.9119850187265918,0.08801498127340825,0.6404494382022472,0.3595505617977528,215,4,94,117,172,43,0.018604651162790697,0.4372093023255814,0.5441860465116279,0.8,0.2
726,9642,8098,1544,7729,1913,0.8398672474590334,0.1601327525409666,0.8015971790085045,0.19840282099149553,4638,202,703,3733,2703,1935,0.043553255713669685,0.15157395429064252,0.8048727899956878,0.5827943078913325,0.41720569210866754
727,8358,6617,1741,6725,1633,0.791696578128739,0.20830342187126108,0.8046183297439579,0.1953816702560421,3751,237,411,3103,2190,1561,0.06318315115969075,0.10957078112503332,0.827246067715276,0.5838443081844842,0.41615569181551587
728,1639,1172,467,1332,307,0.7150701647345943,0.2849298352654057,0.8126906650396584,0.18730933496034166,713,25,91,597,483,230,0.03506311360448808,0.1276297335203366,0.8373071528751753,0.6774193548387096,0.3225806451612903
729,5359,3860,1499,4278,1081,0.720283635006531,0.2797163649934689,0.7982832618025751,0.2017167381974249,6070,45,268,5757,3066,3004,0.007413509060955519,0.04415156507413509,0.9484349258649094,0.5051070840197693,0.49489291598023066
730,4920,3807,1113,3689,1231,0.7737804878048781,0.22621951219512196,0.7497967479674796,0.2502032520325203,2180,47,219,1914,1191,989,0.021559633027522937,0.10045871559633028,0.8779816513761468,0.5463302752293578,0.4536697247706422
731,218,122,96,188,30,0.5596330275229358,0.44036697247706424,0.8623853211009175,0.13761467889908258,272,5,52,215,200,72,0.01838235294117647,0.19117647058823528,0.7904411764705882,0.7352941176470589,0.2647058823529412
732,3129,2217,912,2534,595,0.7085330776605945,0.2914669223394056,0.8098434004474273,0.19015659955257272,5095,80,510,4505,2439,2656,0.015701668302257114,0.10009813542688911,0.8842001962708538,0.4787046123650638,0.5212953876349362
733,4240,3467,773,3737,503,0.817688679245283,0.18231132075471698,0.8813679245283019,0.11863207547169811,5088,168,416,4504,1205,3883,0.0330188679245283,0.08176100628930817,0.8852201257861635,0.2368317610062893,0.7631682389937107
734,5276,3952,1324,4535,741,0.7490523123578469,0.25094768764215314,0.8595526914329037,0.14044730856709628,2827,86,309,2432,1929,898,0.030420940926777502,0.10930314821365406,0.8602759108595684,0.6823487796250443,0.3176512203749558
735,12564,11071,1493,10195,2369,0.881168417701369,0.11883158229863101,0.8114453995542821,0.18855460044571792,4192,169,676,3347,2834,1358,0.04031488549618321,0.16125954198473283,0.798425572519084,0.6760496183206107,0.32395038167938933
736,2497,1877,620,2042,455,0.7517020424509411,0.24829795754905887,0.8177813376051262,0.18221866239487386,1541,115,249,1177,1081,460,0.07462686567164178,0.16158338741077222,0.7637897469175859,0.7014925373134329,0.29850746268656714
737,4270,3405,865,3489,781,0.797423887587822,0.202576112412178,0.817096018735363,0.182903981264637,1343,85,212,1046,853,490,0.06329113924050633,0.15785554728220402,0.7788533134772897,0.6351451973194341,0.3648548026805659
738,1752,1181,571,1216,536,0.6740867579908676,0.3259132420091324,0.6940639269406392,0.3059360730593607,1843,42,346,1455,1253,590,0.02278893109061313,0.18773738469886056,0.7894736842105263,0.679869777536625,0.3201302224633749
739,1550,1272,278,1317,233,0.8206451612903226,0.17935483870967742,0.8496774193548388,0.1503225806451613,581,48,163,370,449,132,0.08261617900172118,0.28055077452667815,0.6368330464716007,0.7728055077452668,0.22719449225473323
740,0,0,0,0,0,0.0,0.0,0.0,0.0,0,0,0,0,0,0,0.0,0.0,0.0,0.0,0.0
741,964,706,258,822,142,0.7323651452282157,0.2676348547717842,0.8526970954356846,0.14730290456431536,388,37,111,240,357,31,0.09536082474226804,0.2860824742268041,0.6185567010309279,0.9201030927835051,0.07989690721649484
742,982,890,92,616,366,0.9063136456211812,0.09368635437881874,0.6272912423625254,0.3727087576374745,182,4,86,92,143,39,0.02197802197802198,0.4725274725274725,0.5054945054945055,0.7857142857142857,0.21428571428571427
743,4203,3724,479,3799,404,0.8860337853913871,0.11396621460861289,0.9038781822507732,0.09612181774922675,1426,233,308,885,985,441,0.16339410939691446,0.21598877980364656,0.620617110799439,0.6907433380084151,0.30925666199158486
744,549,374,175,489,60,0.6812386156648452,0.31876138433515483,0.8907103825136612,0.1092896174863388,307,8,46,253,237,70,0.026058631921824105,0.1498371335504886,0.8241042345276873,0.7719869706840391,0.2280130293159609
745,12655,11150,1505,10162,2493,0.8810746740418807,0.11892532595811932,0.8030027657052549,0.19699723429474517,4184,172,687,3325,2816,1368,0.04110898661567878,0.16419694072657745,0.7946940726577438,0.6730401529636711,0.32695984703632885
746,1806,1436,370,1482,324,0.7951273532668881,0.20487264673311184,0.8205980066445183,0.17940199335548174,684,75,158,451,512,172,0.10964912280701754,0.2309941520467836,0.6593567251461988,0.7485380116959064,0.25146198830409355
747,889,717,172,656,233,0.8065241844769404,0.19347581552305962,0.7379077615298087,0.26209223847019125,154,1,31,122,100,54,0.006493506493506494,0.2012987012987013,0.7922077922077922,0.6493506493506493,0.35064935064935066
748,49771,42618,7153,42034,7737,0.856281770508931,0.1437182294910691,0.844548029977296,0.15545197002270397,27344,13159,1741,12444,20226,7118,0.48123902867173785,0.06367027501462844,0.4550906963136337,0.7396869514335869,0.26031304856641313
749,35,16,19,14,21,0.45714285714285713,0.5428571428571428,0.4,0.6,65,3,23,39,41,24,0.046153846153846156,0.35384615384615387,0.6,0.6307692307692307,0.36923076923076925
750,5455,4370,1085,4247,1208,0.8010999083409716,0.19890009165902842,0.7785517873510541,0.22144821264894593,3272,76,217,2979,2085,1187,0.023227383863080684,0.066320293398533,0.9104523227383863,0.6372249388753056,0.3627750611246944
751,4281,3393,888,3501,780,0.7925718290119131,0.20742817098808689,0.8177995795374913,0.18220042046250876,1666,111,297,1258,1181,485,0.0666266506602641,0.17827130852340936,0.7551020408163265,0.7088835534213686,0.29111644657863145
752,85,58,27,78,7,0.6823529411764706,0.3176470588235294,0.9176470588235294,0.08235294117647059,137,4,29,104,114,23,0.029197080291970802,0.2116788321167883,0.7591240875912408,0.8321167883211679,0.1678832116788321
753,330,235,95,292,38,0.7121212121212122,0.2878787878787879,0.8848484848484849,0.11515151515151516,379,4,95,280,320,59,0.010554089709762533,0.25065963060686014,0.7387862796833773,0.8443271767810027,0.15567282321899736
754,27,19,8,25,2,0.7037037037037037,0.2962962962962963,0.9259259259259259,0.07407407407407407,40,0,11,29,37,3,0.0,0.275,0.725,0.925,0.075
755,3218,2530,688,2322,896,0.786202610316967,0.21379738968303294,0.7215661901802362,0.27843380981976384,1539,94,194,1251,907,632,0.06107862248213125,0.12605588044184535,0.8128654970760234,0.5893437296946069,0.4106562703053931
756,3958,3328,630,3265,693,0.8408287013643254,0.15917129863567459,0.824911571500758,0.17508842849924205,1458,103,213,1142,1020,438,0.07064471879286695,0.14609053497942387,0.7832647462277091,0.6995884773662552,0.3004115226337449
757,1949,1683,266,1612,337,0.8635197537198563,0.13648024628014366,0.8270908158029758,0.1729091841970241,724,56,182,486,644,80,0.07734806629834254,0.2513812154696133,0.6712707182320442,0.8895027624309392,0.11049723756906077
758,949,729,220,682,267,0.768177028451001,0.23182297154899895,0.7186512118018967,0.2813487881981033,473,42,109,322,334,139,0.08879492600422834,0.23044397463002114,0.6807610993657506,0.7061310782241015,0.2938689217758985
759,16128,13796,2332,12788,3340,0.855406746031746,0.14459325396825398,0.792906746031746,0.20709325396825398,1891,108,234,1549,635,1256,0.05711263881544157,0.12374405076679006,0.8191433104177683,0.3358011634056055,0.6641988365943945
760,2258,1893,365,1852,406,0.8383525243578388,0.1616474756421612,0.8201948627103631,0.17980513728963685,684,106,176,402,545,139,0.15497076023391812,0.2573099415204678,0.5877192982456141,0.7967836257309941,0.20321637426900585
761,1477,1179,298,1208,269,0.7982396750169262,0.2017603249830738,0.8178740690589031,0.18212593094109683,565,84,138,343,440,125,0.1486725663716814,0.24424778761061947,0.6070796460176991,0.7787610619469026,0.22123893805309736
762,2713,2191,522,2166,547,0.8075930704017693,0.19240692959823075,0.7983781791374862,0.20162182086251382,1174,79,184,911,755,419,0.06729131175468483,0.1567291311754685,0.7759795570698467,0.6431005110732538,0.35689948892674617
763,139,63,76,67,72,0.45323741007194246,0.5467625899280576,0.48201438848920863,0.5179856115107914,158,4,51,103,97,61,0.02531645569620253,0.3227848101265823,0.6518987341772152,0.6139240506329114,0.3860759493670886
764,2707,2306,401,2236,471,0.851865533801256,0.14813446619874399,0.8260066494274104,0.17399335057258958,979,86,288,605,719,260,0.08784473953013279,0.2941777323799796,0.6179775280898876,0.7344228804902962,0.26557711950970375
765,11446,9536,1910,9702,1744,0.8331294775467413,0.16687052245325878,0.8476323606500087,0.15236763934999126,4914,496,430,3988,3215,1699,0.10093610093610093,0.08750508750508751,0.8115588115588116,0.6542531542531542,0.3457468457468457
766,6784,5719,1065,5921,863,0.8430129716981132,0.1569870283018868,0.8727889150943396,0.12721108490566038,2119,129,357,1633,1322,797,0.06087777253421425,0.16847569608305804,0.7706465313827277,0.6238791882963662,0.3761208117036338
767,3927,2875,1052,3414,513,0.7321110262286733,0.2678889737713267,0.8693659281894576,0.1306340718105424,2051,57,612,1382,1697,354,0.02779132130667967,0.2983910287664554,0.673817649926865,0.8274012676743052,0.17259873232569478
768,2994,2612,382,2489,505,0.8724114896459586,0.12758851035404142,0.8313293253173013,0.16867067468269872,1002,136,278,588,759,243,0.13572854291417166,0.2774451097804391,0.5868263473053892,0.7574850299401198,0.24251497005988024
769,787,562,225,600,187,0.7141041931385006,0.28589580686149935,0.7623888182973316,0.23761118170266837,907,37,118,752,637,270,0.040793825799338476,0.13009922822491732,0.8291069459757442,0.7023153252480706,0.29768467475192945
770,4925,3946,979,3795,1130,0.8012182741116751,0.19878172588832488,0.7705583756345178,0.22944162436548224,1551,86,240,1225,1201,350,0.05544809800128949,0.15473887814313347,0.7898130238555771,0.7743391360412637,0.2256608639587363
771,2393,1725,668,1608,785,0.7208524864187212,0.2791475135812787,0.6719598829920602,0.32804011700793984,1401,46,129,1226,598,803,0.03283369022127052,0.09207708779443255,0.875089221984297,0.42683797287651676,0.5731620271234832
772,1008,911,97,632,376,0.9037698412698413,0.09623015873015874,0.626984126984127,0.373015873015873,227,4,93,130,181,46,0.01762114537444934,0.40969162995594716,0.5726872246696035,0.7973568281938326,0.2026431718061674
773,1405,1229,176,887,518,0.8747330960854093,0.12526690391459075,0.6313167259786477,0.3686832740213523,439,42,74,323,317,122,0.09567198177676538,0.16856492027334852,0.7357630979498861,0.7220956719817767,0.27790432801822323
774,1035,854,181,877,158,0.8251207729468599,0.1748792270531401,0.8473429951690822,0.15265700483091788,437,44,113,280,353,84,0.10068649885583524,0.2585812356979405,0.6407322654462243,0.8077803203661327,0.19221967963386727
775,99,62,37,83,16,0.6262626262626263,0.37373737373737376,0.8383838383838383,0.16161616161616163,133,28,31,74,114,19,0.21052631578947367,0.23308270676691728,0.556390977443609,0.8571428571428571,0.14285714285714285
776,10335,8673,1662,8595,1740,0.8391872278664732,0.16081277213352685,0.8316400580551524,0.1683599419448476,1446,72,286,1088,821,625,0.04979253112033195,0.19778699861687413,0.7524204702627939,0.5677731673582296,0.4322268326417704
777,1576,1301,275,1298,278,0.825507614213198,0.17449238578680204,0.8236040609137056,0.17639593908629442,593,52,162,379,453,140,0.08768971332209106,0.27318718381112983,0.6391231028667791,0.7639123102866779,0.23608768971332209
778,7730,6775,955,6461,1269,0.8764553686934023,0.12354463130659767,0.8358344113842173,0.16416558861578268,2336,268,524,1544,1762,574,0.11472602739726027,0.2243150684931507,0.660958904109589,0.7542808219178082,0.2457191780821918
779,2824,2161,663,2015,809,0.7652266288951841,0.23477337110481586,0.7135269121813032,0.2864730878186969,1315,93,180,1042,801,514,0.07072243346007605,0.13688212927756654,0.7923954372623574,0.6091254752851711,0.3908745247148289
780,184,127,57,163,21,0.6902173913043478,0.30978260869565216,0.8858695652173914,0.11413043478260869,160,4,28,128,151,9,0.025,0.175,0.8,0.94375,0.05625
781,4005,3225,780,3529,476,0.8052434456928839,0.1947565543071161,0.8811485642946317,0.11885143570536828,3040,178,221,2641,1851,1189,0.05855263157894737,0.07269736842105264,0.86875,0.6088815789473684,0.39111842105263156
782,467,287,180,265,202,0.6145610278372591,0.3854389721627409,0.5674518201284796,0.43254817987152033,296,13,75,208,152,144,0.04391891891891892,0.2533783783783784,0.7027027027027027,0.5135135135135135,0.4864864864864865
783,4475,4366,109,3140,1335,0.9756424581005586,0.02435754189944134,0.7016759776536313,0.29832402234636873,254,4,94,156,204,50,0.015748031496062992,0.3700787401574803,0.6141732283464567,0.8031496062992126,0.1968503937007874
784,2121,1596,525,1802,319,0.7524752475247525,0.24752475247524752,0.8495992456388496,0.1504007543611504,1422,53,150,1219,912,510,0.03727144866385373,0.10548523206751055,0.8572433192686357,0.6413502109704642,0.35864978902953587
785,6445,4829,1616,4382,2063,0.7492629945694337,0.2507370054305663,0.6799069045771916,0.3200930954228084,4698,80,264,4354,2368,2330,0.017028522775649212,0.0561941251596424,0.9267773520647083,0.5040442741592167,0.4959557258407833
786,5261,4406,855,4319,942,0.8374833681809541,0.1625166318190458,0.8209465881011214,0.17905341189887855,1826,127,217,1482,1082,744,0.06955093099671412,0.11883899233296824,0.8116100766703176,0.592552026286966,0.40744797371303393
787,2307,1750,557,1682,625,0.7585609016038145,0.24143909839618552,0.729085392284352,0.270914607715648,1134,54,155,925,640,494,0.047619047619047616,0.13668430335097,0.8156966490299824,0.564373897707231,0.43562610229276894
788,9000,8301,699,5540,3460,0.9223333333333333,0.07766666666666666,0.6155555555555555,0.3844444444444444,2732,124,571,2037,2074,658,0.04538799414348463,0.20900439238653,0.7456076134699854,0.7591508052708639,0.24084919472913616
789,5828,4952,876,4667,1161,0.849691146190803,0.15030885380919698,0.8007892930679479,0.19921070693205217,1501,65,202,1234,933,568,0.04330446369087275,0.1345769487008661,0.8221185876082612,0.6215856095936043,0.37841439040639574
790,196,109,87,168,28,0.5561224489795918,0.44387755102040816,0.8571428571428571,0.14285714285714285,217,34,47,136,188,29,0.15668202764976957,0.21658986175115208,0.6267281105990783,0.8663594470046083,0.1336405529953917
791,7913,6415,1498,6474,1439,0.810691267534437,0.18930873246556298,0.8181473524579805,0.18185264754201946,5917,2556,218,3143,4518,1399,0.43197566334291027,0.03684299476085854,0.5311813418962312,0.7635626161906371,0.23643738380936286
792,2945,2370,575,2410,535,0.8047538200339559,0.19524617996604415,0.8183361629881154,0.18166383701188454,958,81,182,695,643,315,0.08455114822546973,0.18997912317327767,0.7254697286012526,0.6711899791231732,0.3288100208768267
793,1923,1792,131,1221,702,0.9318772750910036,0.06812272490899636,0.6349453978159126,0.36505460218408736,447,4,142,301,343,104,0.008948545861297539,0.31767337807606266,0.6733780760626398,0.767337807606264,0.232662192393736
794,4410,3767,643,3427,983,0.8541950113378685,0.1458049886621315,0.7770975056689342,0.22290249433106576,1515,18,113,1384,452,1063,0.011881188118811881,0.0745874587458746,0.9135313531353135,0.2983498349834984,0.7016501650165017
795,16454,12857,3597,11382,5072,0.7813905433329281,0.21860945666707185,0.6917466877355051,0.308253312264495,6555,115,494,5946,4151,2404,0.017543859649122806,0.07536231884057971,0.9070938215102975,0.633257055682685,0.366742944317315
796,1135,933,202,949,186,0.8220264317180617,0.17797356828193833,0.8361233480176211,0.16387665198237886,350,9,80,261,330,20,0.025714285714285714,0.22857142857142856,0.7457142857142857,0.9428571428571428,0.05714285714285714
797,8892,7196,1696,7060,1832,0.8092667566351777,0.1907332433648223,0.7939721097615835,0.20602789023841656,3641,203,349,3089,2110,1531,0.05575391375995606,0.095852787695688,0.848393298544356,0.5795111233177699,0.4204888766822302
798,1088,999,89,681,407,0.9181985294117647,0.0818014705882353,0.6259191176470589,0.3740808823529412,199,4,96,99,154,45,0.020100502512562814,0.4824120603015075,0.49748743718592964,0.7738693467336684,0.22613065326633167
799,34316,28725,5591,28232,6084,0.8370730854411936,0.1629269145588064,0.822706609161907,0.177293390838093,10730,360,795,9575,5832,4898,0.033550792171481825,0.07409133271202237,0.8923578751164958,0.5435228331780055,0.4564771668219944
800,9409,7064,2345,8046,1363,0.7507705388457859,0.24922946115421404,0.8551386969922414,0.14486130300775854,5038,110,408,4520,2948,2090,0.021834061135371178,0.08098451766574037,0.8971814211988884,0.5851528384279476,0.4148471615720524
801,9668,8122,1546,7769,1899,0.8400910219280099,0.15990897807199006,0.8035788167149359,0.19642118328506414,4714,257,712,3745,2770,1944,0.054518455663979636,0.15103945693678406,0.7944420873992363,0.587611370386084,0.412388629613916
802,3560,2755,805,3097,463,0.773876404494382,0.22612359550561797,0.869943820224719,0.1300561797752809,1146,31,190,925,848,298,0.027050610820244327,0.16579406631762653,0.8071553228621291,0.7399650959860384,0.2600349040139616
803,2188,1738,450,1767,421,0.7943327239488117,0.2056672760511883,0.8075868372943327,0.19241316270566727,1001,59,217,725,679,322,0.058941058941058944,0.21678321678321677,0.7242757242757243,0.6783216783216783,0.32167832167832167
804,3844,2979,865,2842,1002,0.7749739854318418,0.22502601456815816,0.7393340270551508,0.2606659729448491,2030,55,177,1798,1269,761,0.027093596059113302,0.08719211822660099,0.8857142857142857,0.6251231527093596,0.3748768472906404
805,9592,7242,2350,8507,1085,0.7550041701417848,0.2449958298582152,0.8868849040867389,0.11311509591326105,5007,154,403,4450,2435,2572,0.030756940283602957,0.0804873177551428,0.8887557419612543,0.48631915318554025,0.5136808468144598
806,1824,1298,526,1428,396,0.7116228070175439,0.2883771929824561,0.7828947368421053,0.21710526315789475,2042,27,110,1905,1047,995,0.013222331047992164,0.05386875612144956,0.9329089128305583,0.5127326150832517,0.48726738491674826
807,1179,1074,105,742,437,0.910941475826972,0.089058524173028,0.6293469041560644,0.3706530958439355,208,4,90,114,161,47,0.019230769230769232,0.4326923076923077,0.5480769230769231,0.7740384615384616,0.22596153846153846
808,8559,6857,1702,7234,1325,0.8011449935740157,0.19885500642598433,0.8451921953499241,0.15480780465007593,2025,238,564,1223,1432,593,0.11753086419753087,0.2785185185185185,0.6039506172839506,0.7071604938271605,0.2928395061728395
809,0,0,0,0,0,0.0,0.0,0.0,0.0,0,0,0,0,0,0,0.0,0.0,0.0,0.0,0.0
810,339,235,104,269,70,0.6932153392330384,0.30678466076696165,0.7935103244837758,0.20648967551622419,157,6,43,108,131,26,0.03821656050955414,0.27388535031847133,0.6878980891719745,0.8343949044585988,0.16560509554140126
811,1210,1103,107,744,466,0.9115702479338843,0.0884297520661157,0.6148760330578512,0.3851239669421488,278,4,106,168,215,63,0.014388489208633094,0.381294964028777,0.60431654676259,0.7733812949640287,0.22661870503597123
812,1660,1370,290,1420,240,0.8253012048192772,0.1746987951807229,0.8554216867469879,0.14457831325301204,1250,20,81,1149,552,698,0.016,0.0648,0.9192,0.4416,0.5584
813,1865,1318,547,1303,562,0.7067024128686327,0.2932975871313673,0.6986595174262734,0.30134048257372653,811,63,147,601,417,394,0.07768187422934648,0.1812577065351418,0.7410604192355117,0.5141800246609125,0.48581997533908755
814,575,398,177,396,179,0.6921739130434783,0.30782608695652175,0.688695652173913,0.31130434782608696,433,7,49,377,268,165,0.016166281755196306,0.11316397228637413,0.8706697459584296,0.6189376443418014,0.3810623556581986
815,4432,4107,325,4121,311,0.9266696750902527,0.0733303249097473,0.9298285198555957,0.07017148014440433,2369,14,359,1996,1170,1199,0.0059096665259603205,0.15154073448712538,0.8425495989869143,0.4938792739552554,0.5061207260447447
816,14917,13259,1658,12142,2775,0.8888516457732788,0.11114835422672119,0.813970637527653,0.186029362472347,7342,104,344,6894,2833,4509,0.014165077635521656,0.046853718332879324,0.938981204031599,0.3858621628983928,0.6141378371016072
817,4579,4057,522,3766,813,0.8860013103297664,0.11399868967023367,0.8224503166630268,0.17754968333697313,2021,115,795,1111,1582,439,0.05690252350321623,0.39336961900049483,0.5497278574962889,0.7827808015833746,0.21721919841662543
818,4561,3719,842,3277,1284,0.8153913615435212,0.18460863845647885,0.7184827888620916,0.28151721113790834,1203,113,229,861,929,274,0.09393183707398171,0.19035743973399832,0.71571072319202,0.772236076475478,0.22776392352452202
819,9185,7011,2174,7991,1194,0.7633097441480675,0.23669025585193249,0.8700054436581383,0.12999455634186174,2444,150,405,1889,2226,218,0.06137479541734861,0.16571194762684124,0.7729132569558101,0.9108019639934534,0.08919803600654665
820,4990,3781,1209,4057,933,0.7577154308617234,0.24228456913827656,0.8130260521042084,0.18697394789579158,3004,974,326,1704,2272,732,0.32423435419440744,0.1085219707057257,0.5672436750998668,0.7563249001331558,0.2436750998668442
821,5484,4227,1257,4274,1210,0.7707877461706784,0.22921225382932167,0.7793581327498177,0.22064186725018234,3184,54,263,2867,2137,1047,0.016959798994974875,0.08260050251256282,0.9004396984924623,0.6711683417085427,0.3288316582914573
822,0,0,0,0,0,0.0,0.0,0.0,0.0,0,0,0,0,0,0,0.0,0.0,0.0,0.0,0.0
823,99,62,37,83,16,0.6262626262626263,0.37373737373737376,0.8383838383838383,0.16161616161616163,133,28,31,74,114,19,0.21052631578947367,0.23308270676691728,0.556390977443609,0.8571428571428571,0.14285714285714285
824,25289,22890,2399,20990,4299,0.9051366206651114,0.09486337933488868,0.8300051405749536,0.16999485942504647,1274,250,455,569,1074,200,0.19623233908948196,0.35714285714285715,0.4466248037676609,0.8430141287284144,0.15698587127158556
825,35782,28992,6790,31666,4116,0.8102397853669443,0.18976021463305573,0.8849700966966632,0.11502990330333687,11555,703,840,10012,5649,5906,0.060839463435742105,0.07269580268282129,0.8664647338814366,0.48887927304197315,0.5111207269580268
826,2413,1800,613,1887,526,0.7459593866556155,0.2540406133443846,0.7820140903439702,0.21798590965602985,2633,36,222,2375,1666,967,0.013672616786935056,0.0843144701860995,0.9020129130269654,0.6327383213064945,0.3672616786935055
827,5788,4594,1194,4645,1143,0.7937111264685557,0.20628887353144437,0.8025224602626123,0.1974775397373877,2926,86,293,2547,2483,443,0.02939166097060834,0.10013670539986329,0.8704716336295284,0.8485987696514012,0.15140123034859876
828,1264,920,344,890,374,0.7278481012658228,0.2721518987341772,0.7041139240506329,0.2958860759493671,519,45,117,357,314,205,0.08670520231213873,0.2254335260115607,0.6878612716763006,0.605009633911368,0.394990366088632
829,2458,1960,498,1888,570,0.7973962571196095,0.20260374288039057,0.7681041497152156,0.23189585028478438,1536,37,139,1360,878,658,0.024088541666666668,0.09049479166666667,0.8854166666666666,0.5716145833333334,0.4283854166666667
830,3028,2440,588,2345,683,0.8058124174372523,0.19418758256274768,0.77443857331572,0.22556142668428006,1690,223,357,1110,895,795,0.1319526627218935,0.21124260355029587,0.6568047337278107,0.5295857988165681,0.47041420118343197
831,867,645,222,698,169,0.7439446366782007,0.2560553633217993,0.8050749711649365,0.19492502883506344,712,44,128,540,439,273,0.06179775280898876,0.1797752808988764,0.7584269662921348,0.6165730337078652,0.38342696629213485
832,3306,3026,280,2039,1267,0.9153055051421658,0.08469449485783424,0.6167574107683,0.38324258923169996,672,8,175,489,614,58,0.011904761904761904,0.2604166666666667,0.7276785714285714,0.9136904761904762,0.08630952380952381
833,7801,6030,1771,6304,1497,0.77297782335598,0.22702217664402,0.8081015254454557,0.19189847455454428,2488,126,295,2067,1560,928,0.05064308681672026,0.11856913183279742,0.8307877813504824,0.6270096463022508,0.3729903536977492
834,8716,7624,1092,7575,1141,0.8747131711794401,0.1252868288205599,0.8690913262964662,0.13090867370353373,1597,114,297,1186,1234,363,0.07138384470882905,0.1859737006887915,0.7426424546023794,0.7726988102692548,0.22730118973074515
835,1673,1378,295,1386,287,0.8236700537955768,0.1763299462044232,0.8284518828451883,0.17154811715481172,667,100,185,382,532,135,0.14992503748125938,0.2773613193403298,0.5727136431784108,0.7976011994002998,0.20239880059970014
836,2058,1530,528,1405,653,0.7434402332361516,0.2565597667638484,0.6827016520894071,0.3172983479105928,3577,106,221,3250,2052,1525,0.029633771316745876,0.061783617556611686,0.9085826111266424,0.5736650824713447,0.4263349175286553
837,1658,1316,342,1230,428,0.7937273823884198,0.20627261761158022,0.7418576598311218,0.25814234016887816,541,44,160,337,345,196,0.08133086876155268,0.2957486136783734,0.6229205175600739,0.6377079482439926,0.36229205175600737
838,1436,1315,121,906,530,0.9157381615598886,0.08426183844011143,0.6309192200557103,0.36908077994428967,375,4,127,244,335,40,0.010666666666666666,0.33866666666666667,0.6506666666666666,0.8933333333333333,0.10666666666666667
839,140,63,77,67,73,0.45,0.55,0.4785714285714286,0.5214285714285715,159,4,52,103,97,62,0.025157232704402517,0.3270440251572327,0.6477987421383647,0.610062893081761,0.389937106918239
840,1718,1433,285,1378,340,0.8341094295692666,0.1658905704307334,0.8020954598370198,0.1979045401629802,538,59,95,384,369,169,0.10966542750929369,0.17657992565055763,0.7137546468401487,0.6858736059479554,0.3141263940520446
841,13623,11218,2405,10904,2719,0.8234603244512956,0.1765396755487044,0.8004110695147911,0.19958893048520884,3637,111,424,3102,2881,756,0.03051965905966456,0.1165795985702502,0.8529007423700853,0.7921363761341765,0.2078636238658235
842,1732,1431,301,1412,320,0.8262124711316398,0.17378752886836027,0.815242494226328,0.18475750577367206,801,65,187,549,711,90,0.08114856429463171,0.23345817727840198,0.6853932584269663,0.8876404494382022,0.11235955056179775
843,16055,14121,1934,13387,2668,0.879539084397384,0.12046091560261601,0.8338212394892557,0.16617876051074432,9679,218,737,8724,2075,7604,0.02252298791197438,0.07614422977580329,0.9013327823122224,0.21438165099700382,0.7856183490029962
844,3122,2368,754,2198,924,0.7584881486226778,0.24151185137732223,0.7040358744394619,0.29596412556053814,1283,27,175,1081,805,478,0.021044427123928292,0.1363990646921278,0.8425565081839439,0.627435697583788,0.372564302416212
845,1018,933,85,645,373,0.9165029469548134,0.08349705304518663,0.6335952848722987,0.3664047151277014,174,4,75,95,134,40,0.022988505747126436,0.43103448275862066,0.5459770114942529,0.7701149425287356,0.22988505747126436
846,8476,7363,1113,7078,1398,0.8686880604058518,0.1313119395941482,0.8350637092968382,0.16493629070316188,1846,151,320,1375,1231,615,0.0817984832069339,0.1733477789815818,0.7448537378114843,0.6668472372697725,0.33315276273022754
847,3426,2568,858,2697,729,0.7495621716287215,0.2504378283712785,0.787215411558669,0.212784588441331,2609,1172,149,1288,2054,555,0.4492142583365274,0.05711000383288616,0.49367573783058644,0.7872748179379072,0.21272518206209276
848,16206,13495,2711,13667,2539,0.8327162779217574,0.16728372207824263,0.8433296310008639,0.1566703689991361,5084,190,572,4322,3545,1539,0.037372147915027534,0.1125098347757671,0.8501180173092053,0.6972856018882769,0.30271439811172307
849,11158,8351,2807,9298,1860,0.7484316185696361,0.25156838143036386,0.8333034594013264,0.1666965405986736,6310,62,349,5899,3354,2956,0.0098256735340729,0.05530903328050713,0.93486529318542,0.5315372424722662,0.46846275752773375
850,17596,14662,2934,14920,2676,0.8332575585360309,0.16674244146396908,0.8479199818140486,0.15208001818595135,7361,171,528,6662,4060,3301,0.02323053932889553,0.07172938459448444,0.9050400760766201,0.5515554951772857,0.4484445048227143
851,2595,2189,406,1966,629,0.8435452793834297,0.15645472061657031,0.7576107899807322,0.24238921001926783,550,44,126,380,348,202,0.08,0.2290909090909091,0.6909090909090909,0.6327272727272727,0.36727272727272725
852,13412,10151,3261,10132,3280,0.7568595287801968,0.24314047121980317,0.7554428869668953,0.24455711303310468,3744,263,548,2933,2170,1574,0.0702457264957265,0.14636752136752137,0.7833867521367521,0.5795940170940171,0.4204059829059829
853,137,72,65,75,62,0.5255474452554745,0.4744525547445255,0.5474452554744526,0.45255474452554745,154,9,37,108,87,67,0.05844155844155844,0.24025974025974026,0.7012987012987013,0.564935064935065,0.43506493506493504
854,3844,2979,865,2844,1000,0.7749739854318418,0.22502601456815816,0.7398543184183143,0.2601456815816857,2015,55,183,1777,1271,744,0.02729528535980149,0.09081885856079404,0.8818858560794045,0.6307692307692307,0.36923076923076925
855,1865,1318,547,1303,562,0.7067024128686327,0.2932975871313673,0.6986595174262734,0.30134048257372653,811,63,147,601,417,394,0.07768187422934648,0.1812577065351418,0.7410604192355117,0.5141800246609125,0.48581997533908755
856,1017,925,92,641,376,0.9095378564405113,0.09046214355948869,0.6302851524090463,0.3697148475909538,182,4,84,94,141,41,0.02197802197802198,0.46153846153846156,0.5164835164835165,0.7747252747252747,0.22527472527472528
857,1243,1149,94,779,464,0.9243765084473049,0.0756234915526951,0.6267095736122285,0.37329042638777155,219,4,104,111,166,53,0.0182648401826484,0.4748858447488584,0.5068493150684932,0.7579908675799086,0.2420091324200913
858,11754,10188,1566,10111,1643,0.8667687595712098,0.1332312404287902,0.8602177981963587,0.13978220180364131,6555,84,446,6025,3684,2871,0.012814645308924484,0.06803966437833715,0.9191456903127384,0.5620137299771167,0.4379862700228833
859,2259,1894,365,1853,406,0.8384240814519699,0.1615759185480301,0.8202744577246569,0.17972554227534307,684,106,176,402,545,139,0.15497076023391812,0.2573099415204678,0.5877192982456141,0.7967836257309941,0.20321637426900585
860,1450,1304,146,890,560,0.8993103448275862,0.1006896551724138,0.6137931034482759,0.38620689655172413,402,4,184,214,341,61,0.009950248756218905,0.4577114427860697,0.5323383084577115,0.8482587064676617,0.1517412935323383
861,2529,1971,558,1999,530,0.7793594306049823,0.2206405693950178,0.7904310003954133,0.2095689996045868,1019,87,189,743,683,336,0.08537782139352307,0.18547595682041218,0.7291462217860648,0.6702649656526006,0.3297350343473994
862,5434,4218,1216,4178,1256,0.7762237762237763,0.22377622377622378,0.7688627162311373,0.23113728376886272,5358,29,240,5089,2625,2733,0.005412467338559164,0.04479283314669653,0.9497946995147443,0.4899216125419933,0.5100783874580067
863,944,684,260,717,227,0.7245762711864406,0.2754237288135593,0.7595338983050848,0.24046610169491525,849,45,136,668,642,207,0.053003533568904596,0.160188457008245,0.7868080094228505,0.7561837455830389,0.24381625441696114
864,5380,4247,1133,4768,612,0.7894052044609665,0.21059479553903346,0.8862453531598513,0.1137546468401487,2515,72,284,2159,1294,1221,0.028628230616302187,0.11292246520874752,0.8584493041749502,0.5145129224652087,0.48548707753479126
865,148,106,42,98,50,0.7162162162162162,0.28378378378378377,0.6621621621621622,0.33783783783783783,105,5,15,85,70,35,0.047619047619047616,0.14285714285714285,0.8095238095238095,0.6666666666666666,0.3333333333333333
866,1007,915,92,638,369,0.9086395233366436,0.0913604766633565,0.6335650446871897,0.36643495531281034,192,4,86,102,153,39,0.020833333333333332,0.4479166666666667,0.53125,0.796875,0.203125
867,5772,4580,1192,4630,1142,0.7934857934857935,0.20651420651420652,0.8021483021483021,0.19785169785169784,2912,86,293,2533,2469,443,0.029532967032967032,0.10061813186813187,0.8698489010989011,0.8478708791208791,0.15212912087912087
868,3186,2746,440,2584,602,0.8618957940991839,0.13810420590081607,0.8110483364720653,0.18895166352793472,1063,86,337,640,813,250,0.08090310442144873,0.31702728127939794,0.6020696142991533,0.7648165569143932,0.23518344308560676
869,2121,1596,525,1802,319,0.7524752475247525,0.24752475247524752,0.8495992456388496,0.1504007543611504,1418,48,150,1220,906,512,0.03385049365303244,0.10578279266572638,0.8603667136812412,0.6389280677009873,0.3610719322990127
870,13616,11218,2398,10898,2718,0.8238836662749707,0.17611633372502938,0.8003819036427732,0.1996180963572268,3631,108,421,3102,2875,756,0.02974387221151198,0.11594602038006059,0.8543101074084274,0.7917928945194161,0.20820710548058385
871,7720,6585,1135,6429,1291,0.852979274611399,0.14702072538860103,0.8327720207253886,0.1672279792746114,2735,184,296,2255,1521,1214,0.06727605118829982,0.10822669104204753,0.8244972577696527,0.5561243144424132,0.44387568555758683
872,10393,8770,1623,6958,3435,0.8438371981141153,0.15616280188588472,0.6694890791879149,0.33051092081208505,2692,73,331,2288,1345,1347,0.02711738484398217,0.12295690936106983,0.849925705794948,0.49962852897473997,0.50037147102526
873,80,75,5,29,51,0.9375,0.0625,0.3625,0.6375,240,0,1,239,132,108,0.0,0.004166666666666667,0.9958333333333333,0.55,0.45
874,12174,9495,2679,10424,1750,0.7799408575653031,0.2200591424346969,0.8562510267783802,0.14374897322161984,8285,157,911,7217,5778,2507,0.018949909474954736,0.10995775497887748,0.8710923355461678,0.6974049487024744,0.3025950512975257
875,1053,816,237,756,297,0.7749287749287749,0.22507122507122507,0.717948717948718,0.28205128205128205,401,62,132,207,316,85,0.1546134663341646,0.32917705735660846,0.516209476309227,0.7880299251870324,0.2119700748129676
876,7175,6470,705,5810,1365,0.9017421602787457,0.09825783972125436,0.8097560975609757,0.1902439024390244,2163,134,269,1760,1258,905,0.061950993989828944,0.12436430883032824,0.8136846971798428,0.5815996301433195,0.41840036985668055
877,1593,1135,458,1065,528,0.7124921531701193,0.28750784682988073,0.6685499058380414,0.3314500941619586,461,35,109,317,280,181,0.07592190889370933,0.23644251626898047,0.6876355748373102,0.6073752711496746,0.3926247288503254
878,3764,3076,688,2969,795,0.8172157279489904,0.18278427205100956,0.788788522848034,0.211211477151966,1965,455,247,1263,1567,398,0.23155216284987276,0.1256997455470738,0.6427480916030535,0.7974554707379135,0.20254452926208652
879,1232,993,239,1069,163,0.8060064935064936,0.1939935064935065,0.8676948051948052,0.13230519480519481,423,53,113,257,402,21,0.12529550827423167,0.26713947990543735,0.607565011820331,0.950354609929078,0.04964539007092199
880,17552,15696,1856,13164,4388,0.894257064721969,0.105742935278031,0.75,0.25,4011,31,357,3623,2240,1771,0.007728745948641236,0.08900523560209424,0.9032660184492646,0.5584642233856894,0.44153577661431065
881,1529,1155,374,1107,422,0.7553956834532374,0.2446043165467626,0.724002616088947,0.275997383911053,1237,116,139,982,689,548,0.09377526273241714,0.11236863379143087,0.793856103476152,0.5569927243330639,0.44300727566693615
882,11202,8883,2319,9333,1869,0.7929833958221746,0.2070166041778254,0.8331547937868238,0.16684520621317622,4707,1894,355,2458,3744,963,0.402379434884215,0.07541958784788613,0.5222009772678988,0.7954110898661568,0.2045889101338432
883,65,36,29,57,8,0.5538461538461539,0.4461538461538462,0.8769230769230769,0.12307692307692308,148,24,41,83,146,2,0.16216216216216217,0.27702702702702703,0.5608108108108109,0.9864864864864865,0.013513513513513514
884,2887,1813,1074,1919,968,0.6279875303082785,0.3720124696917215,0.6647038448216142,0.33529615517838585,2685,59,154,2472,2260,425,0.02197392923649907,0.05735567970204842,0.9206703910614525,0.8417132216014898,0.15828677839851024
885,4381,3820,561,3441,940,0.871947044053869,0.12805295594613103,0.7854371148139694,0.2145628851860306,1444,284,408,752,1185,259,0.19667590027700832,0.28254847645429365,0.5207756232686981,0.8206371191135734,0.1793628808864266
886,8941,7457,1484,7883,1058,0.8340230399284196,0.16597696007158036,0.8816687171457331,0.11833128285426686,3953,181,516,3256,2665,1288,0.04578800910700734,0.13053377181887174,0.8236782190741209,0.6741715153048318,0.32582848469516823
887,1930,1720,210,1563,367,0.8911917098445595,0.10880829015544041,0.8098445595854922,0.19015544041450777,616,29,140,447,384,232,0.04707792207792208,0.22727272727272727,0.7256493506493507,0.6233766233766234,0.37662337662337664
888,4411,3767,644,3427,984,0.8540013602357742,0.1459986397642258,0.7769213330310587,0.22307866696894127,1515,18,113,1384,452,1063,0.011881188118811881,0.0745874587458746,0.9135313531353135,0.2983498349834984,0.7016501650165017
889,470,321,149,399,71,0.6829787234042554,0.3170212765957447,0.8489361702127659,0.15106382978723404,277,13,57,207,228,49,0.04693140794223827,0.20577617328519857,0.7472924187725631,0.8231046931407943,0.17689530685920576
890,2748,1905,843,2239,509,0.6932314410480349,0.3067685589519651,0.8147743813682679,0.18522561863173218,2103,922,165,1016,1686,417,0.43842130290061815,0.07845934379457917,0.48311935330480266,0.8017118402282454,0.19828815977175462
891,1470,1052,418,1233,237,0.7156462585034014,0.28435374149659864,0.8387755102040816,0.16122448979591836,1107,36,162,909,841,266,0.032520325203252036,0.14634146341463414,0.8211382113821138,0.7597109304426377,0.24028906955736223
892,905,631,274,611,294,0.6972375690607735,0.3027624309392265,0.6751381215469613,0.32486187845303865,505,5,76,424,325,180,0.009900990099009901,0.1504950495049505,0.8396039603960396,0.6435643564356436,0.3564356435643564
893,2471,1969,502,2088,383,0.7968433832456495,0.20315661675435046,0.8450020234722785,0.15499797652772157,2320,29,289,2002,1248,1072,0.0125,0.12456896551724138,0.8629310344827587,0.5379310344827586,0.46206896551724136
894,21110,17958,3152,17103,4007,0.8506868782567504,0.14931312174324965,0.8101847465656087,0.1898152534343913,8524,633,437,7454,3138,5386,0.07426091037071797,0.0512670107930549,0.8744720788362271,0.3681370248709526,0.6318629751290474
895,3978,3201,777,3452,526,0.8046757164404224,0.19532428355957768,0.8677727501256913,0.1322272498743087,2735,95,197,2443,2003,732,0.03473491773308958,0.0720292504570384,0.893235831809872,0.7323583180987203,0.2676416819012797
896,1380,1044,336,1205,175,0.7565217391304347,0.24347826086956523,0.8731884057971014,0.12681159420289856,763,35,99,629,500,263,0.045871559633027525,0.12975098296199214,0.8243774574049804,0.6553079947575361,0.34469200524246396
897,5865,4645,1220,4293,1572,0.7919863597612958,0.20801364023870417,0.7319693094629156,0.2680306905370844,2216,77,254,1885,1091,1125,0.034747292418772564,0.11462093862815885,0.8506317689530686,0.49232851985559567,0.5076714801444043
898,218,176,42,186,32,0.8073394495412844,0.1926605504587156,0.8532110091743119,0.14678899082568808,409,25,70,314,306,103,0.061124694376528114,0.17114914425427874,0.7677261613691931,0.7481662591687042,0.25183374083129584
899,1049,763,286,744,305,0.7273593898951383,0.2726406101048618,0.7092469018112488,0.29075309818875117,308,25,75,208,197,111,0.08116883116883117,0.2435064935064935,0.6753246753246753,0.6396103896103896,0.36038961038961037
900,1148,919,229,970,178,0.8005226480836237,0.1994773519163763,0.8449477351916377,0.15505226480836237,543,45,130,368,433,110,0.08287292817679558,0.23941068139963168,0.6777163904235728,0.7974217311233885,0.20257826887661143
901,9071,7681,1390,7445,1626,0.8467644140668064,0.1532355859331937,0.8207474368867821,0.17925256311321794,3353,79,940,2334,2239,1114,0.023560990158067403,0.2803459588428273,0.6960930509991052,0.6677602147330749,0.33223978526692516
902,2396,1927,469,2065,331,0.8042570951585977,0.19574290484140233,0.8618530884808013,0.13814691151919867,745,76,193,476,598,147,0.10201342281879194,0.25906040268456376,0.6389261744966444,0.8026845637583893,0.19731543624161074
903,34322,27181,7141,26866,7456,0.7919410290775596,0.2080589709224404,0.782763242235301,0.21723675776469903,8059,220,856,6983,3743,4316,0.027298672291847625,0.10621665219009803,0.8664846755180543,0.46444968358357114,0.5355503164164288
904,8745,7765,980,5053,3692,0.8879359634076616,0.11206403659233848,0.5778158947970269,0.4221841052029731,3717,631,927,2159,3243,474,0.16976055959106806,0.24939467312348668,0.5808447672854452,0.8724778046811945,0.1275221953188055
905,1196,1099,97,761,435,0.9188963210702341,0.08110367892976589,0.6362876254180602,0.3637123745819398,242,4,85,153,203,39,0.01652892561983471,0.3512396694214876,0.6322314049586777,0.8388429752066116,0.16115702479338842
906,1399,1145,254,1047,352,0.8184417441029307,0.18155825589706934,0.7483917083631165,0.2516082916368835,544,63,184,297,369,175,0.11580882352941177,0.3382352941176471,0.5459558823529411,0.6783088235294118,0.32169117647058826
907,2320,1657,663,1844,476,0.7142241379310345,0.2857758620689655,0.7948275862068965,0.20517241379310344,949,27,105,817,618,331,0.02845100105374078,0.11064278187565858,0.8609062170706007,0.6512118018967334,0.3487881981032666
908,467,287,180,265,202,0.6145610278372591,0.3854389721627409,0.5674518201284796,0.43254817987152033,296,13,75,208,152,144,0.04391891891891892,0.2533783783783784,0.7027027027027027,0.5135135135135135,0.4864864864864865
909,7091,5346,1745,6192,899,0.7539134113665209,0.24608658863347907,0.8732195741080243,0.12678042589197575,2604,123,441,2040,1992,612,0.04723502304147465,0.1693548387096774,0.783410138248848,0.7649769585253456,0.2350230414746544
910,5195,3952,1243,4630,565,0.7607314725697787,0.23926852743022137,0.8912415784408084,0.10875842155919153,1378,122,236,1020,1138,240,0.08853410740203194,0.17126269956458637,0.7402031930333817,0.8258345428156749,0.1741654571843251
911,8793,7863,930,6910,1883,0.8942340498123508,0.10576595018764927,0.7858523825770499,0.21414761742295008,1858,87,516,1255,1291,567,0.04682454251883746,0.27771797631862216,0.6754574811625403,0.6948331539289558,0.3051668460710441
912,1546,1119,427,1030,516,0.7238033635187581,0.27619663648124193,0.666235446313066,0.33376455368693403,842,19,108,715,458,384,0.022565320665083134,0.12826603325415678,0.8491686460807601,0.5439429928741093,0.45605700712589076
913,1819,1503,316,1461,358,0.8262781748213304,0.1737218251786696,0.8031885651456845,0.19681143485431557,676,59,164,453,465,211,0.08727810650887574,0.24260355029585798,0.6701183431952663,0.6878698224852071,0.3121301775147929
914,9190,7585,1605,7188,2002,0.8253536452665942,0.17464635473340587,0.7821545157780195,0.2178454842219804,6702,557,266,5879,3651,3051,0.08310951954640405,0.03968964488212474,0.8772008355714712,0.544762757385855,0.45523724261414505
915,2682,2221,461,2133,549,0.8281133482475764,0.17188665175242357,0.7953020134228188,0.20469798657718122,1096,79,162,855,676,420,0.07208029197080291,0.1478102189781022,0.7801094890510949,0.6167883211678832,0.38321167883211676
916,9669,8123,1546,7770,1899,0.8401075602440791,0.159892439755921,0.8035991312441825,0.19640086875581755,4714,257,712,3745,2770,1944,0.054518455663979636,0.15103945693678406,0.7944420873992363,0.587611370386084,0.412388629613916
917,2080,1615,465,1645,435,0.7764423076923077,0.22355769230769232,0.7908653846153846,0.2091346153846154,963,55,208,700,662,301,0.05711318795430945,0.21599169262720663,0.726895119418484,0.6874350986500519,0.3125649013499481
918,3612,2795,817,2768,844,0.7738095238095238,0.2261904761904762,0.7663344407530454,0.2336655592469546,3896,106,211,3579,2173,1723,0.027207392197125257,0.05415811088295688,0.9186344969199178,0.5577515400410678,0.44224845995893225
919,5843,4225,1618,4028,1815,0.723087455074448,0.27691254492555195,0.689371897997604,0.31062810200239604,1213,68,215,930,688,525,0.05605935696619951,0.17724649629018963,0.7666941467436109,0.5671887881286067,0.43281121187139326
920,467,287,180,265,202,0.6145610278372591,0.3854389721627409,0.5674518201284796,0.43254817987152033,296,13,75,208,152,144,0.04391891891891892,0.2533783783783784,0.7027027027027027,0.5135135135135135,0.4864864864864865
921,2973,2212,761,2472,501,0.7440295997309115,0.25597040026908846,0.8314833501513622,0.16851664984863773,2165,32,167,1966,1113,1052,0.014780600461893764,0.07713625866050808,0.9080831408775981,0.5140877598152425,0.4859122401847575
922,868,646,222,699,169,0.7442396313364056,0.2557603686635945,0.8052995391705069,0.19470046082949308,746,44,128,574,439,307,0.058981233243967826,0.17158176943699732,0.7694369973190348,0.5884718498659517,0.41152815013404825
923,277,178,99,248,29,0.6425992779783394,0.3574007220216607,0.8953068592057761,0.10469314079422383,258,12,69,177,241,17,0.046511627906976744,0.26744186046511625,0.686046511627907,0.9341085271317829,0.06589147286821706
924,19217,17353,1864,12321,6896,0.9030025498256752,0.09699745017432482,0.6411510641619399,0.35884893583806005,7259,227,891,6141,4565,2694,0.031271525003444,0.12274417963906874,0.8459842953574872,0.6288745006199201,0.3711254993800799
925,392,326,66,353,39,0.8316326530612245,0.1683673469387755,0.9005102040816326,0.09948979591836735,171,25,44,102,146,25,0.14619883040935672,0.2573099415204678,0.5964912280701754,0.8538011695906432,0.14619883040935672
926,1015,720,295,665,350,0.7093596059113301,0.29064039408866993,0.6551724137931034,0.3448275862068966,490,11,122,357,290,200,0.022448979591836733,0.24897959183673468,0.7285714285714285,0.5918367346938775,0.40816326530612246
927,1553,1337,216,1156,397,0.8609143593045718,0.1390856406954282,0.7443657437218287,0.25563425627817127,453,7,96,350,283,170,0.01545253863134658,0.2119205298013245,0.7726269315673289,0.6247240618101545,0.37527593818984545
928,8353,7671,682,7589,764,0.9183526876571292,0.08164731234287083,0.9085358553813001,0.09146414461869987,1259,48,409,802,774,485,0.03812549642573471,0.32486100079428115,0.6370135027799841,0.6147736298649722,0.3852263701350278
929,19195,17817,1378,17524,1671,0.9282104714769471,0.07178952852305288,0.9129460797082574,0.08705392029174264,11068,66,490,10512,1462,9606,0.005963136971449223,0.04427177448500181,0.949765088543549,0.13209251897361762,0.8679074810263824
930,145,97,48,91,54,0.6689655172413793,0.3310344827586207,0.6275862068965518,0.3724137931034483,308,4,94,210,105,203,0.012987012987012988,0.3051948051948052,0.6818181818181818,0.3409090909090909,0.6590909090909091
931,7345,6265,1080,6200,1145,0.8529611980939414,0.14703880190605853,0.8441116405718175,0.15588835942818244,1634,137,267,1230,1228,406,0.08384332925336598,0.16340269277845776,0.7527539779681762,0.7515299877600979,0.2484700122399021
932,422,232,190,239,183,0.5497630331753555,0.45023696682464454,0.566350710900474,0.43364928909952605,324,15,103,206,206,118,0.046296296296296294,0.31790123456790126,0.6358024691358025,0.6358024691358025,0.36419753086419754
933,3392,2753,639,2823,569,0.8116155660377359,0.18838443396226415,0.832252358490566,0.16774764150943397,2313,28,319,1966,1367,946,0.012105490704712495,0.1379161262429745,0.849978383052313,0.5910073497622136,0.4089926502377864
934,25284,19813,5471,18245,7039,0.7836180984021516,0.21638190159784845,0.7216025945261826,0.2783974054738174,20247,104,551,19592,15262,4985,0.0051365634414975055,0.027213908233318516,0.967649528325184,0.753790685039759,0.246209314960241
935,3252,2281,971,2289,963,0.7014145141451414,0.29858548585485856,0.7038745387453874,0.29612546125461253,1456,113,266,1077,918,538,0.07760989010989011,0.18269230769230768,0.7396978021978022,0.6304945054945055,0.3695054945054945
936,2405,1816,589,2130,275,0.7550935550935551,0.24490644490644492,0.8856548856548857,0.11434511434511435,2127,119,315,1693,1632,495,0.05594734367653973,0.14809590973201692,0.7959567465914433,0.767277856135402,0.23272214386459802
937,7256,6257,999,6034,1222,0.8623208379272327,0.13767916207276737,0.831587651598677,0.16841234840132305,1408,115,322,971,1129,279,0.08167613636363637,0.22869318181818182,0.6896306818181818,0.8018465909090909,0.1981534090909091
938,145,97,48,91,54,0.6689655172413793,0.3310344827586207,0.6275862068965518,0.3724137931034483,308,4,94,210,105,203,0.012987012987012988,0.3051948051948052,0.6818181818181818,0.3409090909090909,0.6590909090909091
939,3409,2597,812,2313,1096,0.7618069815195072,0.23819301848049282,0.6784980932824876,0.32150190671751244,2113,157,499,1457,1669,444,0.0743019403691434,0.23615712257453858,0.689540937056318,0.7898722195929957,0.21012778040700425
940,2507,2112,395,2076,431,0.8424411647387315,0.15755883526126846,0.8280813721579577,0.1719186278420423,794,49,196,549,561,233,0.061712846347607056,0.24685138539042822,0.6914357682619647,0.7065491183879093,0.29345088161209065
941,3679,2893,786,3356,323,0.7863549877684153,0.21364501223158466,0.9122044033704811,0.08779559662951888,1539,84,179,1276,933,606,0.05458089668615984,0.11630929174788823,0.8291098115659519,0.6062378167641326,0.3937621832358674
942,2290,1807,483,1878,412,0.7890829694323144,0.2109170305676856,0.8200873362445414,0.1799126637554585,967,105,167,695,645,322,0.10858324715615306,0.17269906928645296,0.718717683557394,0.6670113753877973,0.3329886246122027
943,5426,3905,1521,4586,840,0.7196830077405086,0.28031699225949136,0.8451898267600443,0.15481017323995577,2875,40,236,2599,1772,1103,0.01391304347826087,0.08208695652173913,0.904,0.6163478260869565,0.38365217391304346
944,7534,5722,1812,6497,1037,0.759490310591983,0.24050968940801698,0.8623573135120786,0.1376426864879214,4372,100,260,4012,2635,1737,0.022872827081427266,0.059469350411710885,0.9176578225068619,0.6026989935956084,0.3973010064043916
945,10571,8060,2511,7517,3054,0.7624633431085044,0.2375366568914956,0.7110963957998298,0.28890360420017025,5339,203,361,4775,3031,2308,0.03802210151713804,0.06761565836298933,0.8943622401198726,0.5677093088593369,0.43229069114066304
946,154,97,57,126,28,0.6298701298701299,0.37012987012987014,0.8181818181818182,0.18181818181818182,244,35,60,149,194,50,0.14344262295081966,0.2459016393442623,0.610655737704918,0.7950819672131147,0.20491803278688525
947,1067,784,283,864,203,0.7347703842549204,0.26522961574507964,0.8097469540768509,0.190253045923149,629,23,86,520,458,171,0.03656597774244833,0.13672496025437203,0.8267090620031796,0.7281399046104928,0.2718600953895072
948,378,290,88,322,56,0.7671957671957672,0.2328042328042328,0.8518518518518519,0.14814814814814814,255,31,56,168,232,23,0.12156862745098039,0.2196078431372549,0.6588235294117647,0.9098039215686274,0.09019607843137255
949,2682,2221,461,2133,549,0.8281133482475764,0.17188665175242357,0.7953020134228188,0.20469798657718122,1097,81,162,854,676,421,0.07383773928896992,0.14767547857793983,0.7784867821330902,0.6162260711030082,0.3837739288969918
950,21109,17957,3152,17102,4007,0.8506798048225875,0.1493201951774125,0.810175754417547,0.18982424558245298,8524,633,437,7454,3138,5386,0.07426091037071797,0.0512670107930549,0.8744720788362271,0.3681370248709526,0.6318629751290474
951,5571,4551,1020,3563,2008,0.8169089929994615,0.1830910070005385,0.6395620175910968,0.36043798240890323,2912,82,295,2535,1958,954,0.02815934065934066,0.10130494505494506,0.8705357142857143,0.6723901098901099,0.3276098901098901
952,997,900,97,621,376,0.9027081243731193,0.09729187562688064,0.6228686058174524,0.37713139418254765,248,4,109,135,206,42,0.016129032258064516,0.43951612903225806,0.5443548387096774,0.8306451612903226,0.1693548387096774
953,1544,1264,280,1343,201,0.8186528497409327,0.18134715025906736,0.8698186528497409,0.13018134715025906,443,43,134,266,397,46,0.09706546275395034,0.30248306997742663,0.600451467268623,0.8961625282167043,0.1038374717832957
954,8303,6791,1512,7099,1204,0.8178971456100205,0.18210285438997953,0.8549921715042755,0.14500782849572444,4324,158,409,3757,1785,2539,0.03654024051803885,0.09458834412580944,0.8688714153561518,0.4128122109158187,0.5871877890841813
955,12248,9790,2458,9479,2769,0.7993141737426519,0.20068582625734813,0.7739222730241672,0.22607772697583278,1450,65,188,1197,766,684,0.04482758620689655,0.1296551724137931,0.8255172413793104,0.5282758620689655,0.47172413793103446
956,10180,8127,2053,8122,2058,0.7983300589390963,0.20166994106090375,0.7978388998035364,0.20216110019646366,4759,210,419,4130,2700,2059,0.044126917419625974,0.08804370666106325,0.8678293759193108,0.5673460811094768,0.43265391889052324
957,131,68,63,113,18,0.5190839694656488,0.48091603053435117,0.8625954198473282,0.13740458015267176,176,4,46,126,108,68,0.022727272727272728,0.26136363636363635,0.7159090909090909,0.6136363636363636,0.38636363636363635
958,1365,859,506,823,542,0.6293040293040293,0.3706959706959707,0.6029304029304029,0.39706959706959705,549,19,140,390,329,220,0.03460837887067395,0.2550091074681239,0.7103825136612022,0.599271402550091,0.4007285974499089
959,107,76,31,80,27,0.7102803738317757,0.2897196261682243,0.7476635514018691,0.2523364485981308,225,4,92,129,186,39,0.017777777777777778,0.4088888888888889,0.5733333333333334,0.8266666666666667,0.17333333333333334
960,3267,2543,724,2368,899,0.778389960208142,0.22161003979185798,0.7248239975512702,0.2751760024487297,2016,122,203,1691,1311,705,0.060515873015873016,0.10069444444444445,0.8387896825396826,0.6502976190476191,0.34970238095238093
961,1016,826,190,887,129,0.812992125984252,0.18700787401574803,0.8730314960629921,0.12696850393700787,309,43,117,149,230,79,0.13915857605177995,0.3786407766990291,0.48220064724919093,0.7443365695792881,0.255663430420712
962,2931,2481,450,2019,912,0.8464687819856704,0.1535312180143296,0.6888433981576254,0.3111566018423746,643,55,178,410,366,277,0.08553654743390357,0.27682737169517885,0.6376360808709176,0.5692068429237948,0.4307931570762053
963,892,725,167,629,263,0.8127802690582959,0.18721973094170405,0.7051569506726457,0.2948430493273543,307,55,125,127,271,36,0.1791530944625407,0.40716612377850164,0.41368078175895767,0.8827361563517915,0.11726384364820847
964,3728,3201,527,2886,842,0.858637339055794,0.14136266094420602,0.7741416309012875,0.22585836909871246,1207,87,245,875,1040,167,0.07207953603976802,0.20298260149130073,0.7249378624689312,0.8616404308202155,0.1383595691797846
965,1916,1524,392,1421,495,0.7954070981210856,0.2045929018789144,0.7416492693110647,0.25835073068893527,750,89,217,444,491,259,0.11866666666666667,0.28933333333333333,0.592,0.6546666666666666,0.3453333333333333
966,7412,6423,989,6229,1183,0.8665677280086347,0.13343227199136534,0.8403939557474366,0.15960604425256342,3447,150,343,2954,1052,2395,0.04351610095735422,0.09950681752248332,0.8569770815201625,0.3051929213809109,0.6948070786190891
967,1207,888,319,1142,65,0.7357083678541839,0.2642916321458161,0.9461474730737366,0.053852526926263466,1737,6,431,1300,1456,281,0.0034542314335060447,0.24812895797351756,0.7484168105929764,0.8382268278641336,0.16177317213586645
968,12655,11150,1505,10162,2493,0.8810746740418807,0.11892532595811932,0.8030027657052549,0.19699723429474517,4184,172,687,3325,2816,1368,0.04110898661567878,0.16419694072657745,0.7946940726577438,0.6730401529636711,0.32695984703632885
969,649,534,115,575,74,0.8228043143297381,0.17719568567026195,0.8859784283513097,0.1140215716486903,280,5,39,236,209,71,0.017857142857142856,0.1392857142857143,0.8428571428571429,0.7464285714285714,0.25357142857142856
970,4502,3251,1251,3918,584,0.7221235006663705,0.2778764993336295,0.8702798756108396,0.12972012438916036,2512,83,255,2174,1501,1011,0.03304140127388535,0.10151273885350319,0.8654458598726115,0.597531847133758,0.40246815286624205
971,19085,16456,2629,15990,3095,0.8622478386167147,0.1377521613832853,0.8378307571391145,0.16216924286088552,11293,205,1213,9875,3825,7468,0.0181528380412645,0.10741167094660409,0.8744354910121314,0.3387053927211547,0.6612946072788453
972,1596,1078,518,1203,393,0.6754385964912281,0.32456140350877194,0.7537593984962406,0.2462406015037594,1410,45,169,1196,823,587,0.031914893617021274,0.1198581560283688,0.8482269503546099,0.5836879432624114,0.41631205673758864
973,2424,1951,473,2088,336,0.8048679867986799,0.19513201320132012,0.8613861386138614,0.13861386138613863,754,76,194,484,607,147,0.10079575596816977,0.2572944297082228,0.6419098143236074,0.8050397877984085,0.19496021220159152
974,1013,922,91,629,384,0.910167818361303,0.08983218163869694,0.6209279368213229,0.3790720631786772,185,4,81,100,146,39,0.021621621621621623,0.43783783783783786,0.5405405405405406,0.7891891891891892,0.21081081081081082
975,23380,19131,4249,18347,5033,0.8182634730538922,0.18173652694610778,0.7847305389221557,0.2152694610778443,14870,256,999,13615,9054,5816,0.017215870880968393,0.067182246133154,0.9156018829858776,0.6088769334229993,0.3911230665770007
976,1169,962,207,982,187,0.8229255774165953,0.1770744225834046,0.8400342172797263,0.15996578272027373,509,46,149,314,399,110,0.09037328094302555,0.29273084479371314,0.6168958742632613,0.7838899803536346,0.21611001964636542
977,2250,1846,404,1880,370,0.8204444444444444,0.17955555555555555,0.8355555555555556,0.16444444444444445,788,85,166,537,522,266,0.10786802030456853,0.21065989847715735,0.6814720812182741,0.6624365482233503,0.33756345177664976
978,1347,1191,156,1142,205,0.8841870824053452,0.11581291759465479,0.8478099480326652,0.15219005196733482,369,44,125,200,318,51,0.11924119241192412,0.33875338753387535,0.5420054200542005,0.8617886178861789,0.13821138211382114
979,184,127,57,163,21,0.6902173913043478,0.30978260869565216,0.8858695652173914,0.11413043478260869,160,4,28,128,151,9,0.025,0.175,0.8,0.94375,0.05625
980,939,854,85,587,352,0.9094781682641108,0.09052183173588925,0.625133120340788,0.37486687965921195,186,4,84,98,147,39,0.021505376344086023,0.45161290322580644,0.5268817204301075,0.7903225806451613,0.20967741935483872
981,1140,1040,100,714,426,0.9122807017543859,0.08771929824561403,0.6263157894736842,0.3736842105263158,201,4,84,113,154,47,0.01990049751243781,0.417910447761194,0.5621890547263682,0.7661691542288557,0.23383084577114427
982,1011,717,294,663,348,0.7091988130563798,0.29080118694362017,0.655786350148368,0.34421364985163205,489,11,121,357,290,199,0.022494887525562373,0.2474437627811861,0.7300613496932515,0.5930470347648262,0.4069529652351738
983,191,108,83,184,7,0.5654450261780105,0.43455497382198954,0.9633507853403142,0.03664921465968586,180,7,45,128,175,5,0.03888888888888889,0.25,0.7111111111111111,0.9722222222222222,0.027777777777777776
984,226,150,76,196,30,0.6637168141592921,0.336283185840708,0.8672566371681416,0.13274336283185842,254,29,77,148,222,32,0.1141732283464567,0.3031496062992126,0.5826771653543307,0.8740157480314961,0.12598425196850394
985,2688,1664,1024,1572,1116,0.6190476190476191,0.38095238095238093,0.5848214285714286,0.41517857142857145,3300,39,949,2312,1497,1803,0.011818181818181818,0.2875757575757576,0.7006060606060606,0.4536363636363636,0.5463636363636364
986,10400,8371,2029,9156,1244,0.8049038461538461,0.19509615384615384,0.8803846153846154,0.11961538461538461,4669,139,329,4201,2771,1898,0.029770828871278646,0.0704647676161919,0.8997644035125294,0.5934889698008139,0.4065110301991861
987,943,854,89,583,360,0.9056203605514316,0.09437963944856839,0.6182396606574762,0.38176033934252385,233,4,96,133,193,40,0.017167381974248927,0.41201716738197425,0.5708154506437768,0.8283261802575107,0.17167381974248927
988,154,101,53,106,48,0.6558441558441559,0.34415584415584416,0.6883116883116883,0.3116883116883117,173,29,37,107,113,60,0.1676300578034682,0.2138728323699422,0.6184971098265896,0.653179190751445,0.3468208092485549
989,2127,1956,171,1402,725,0.919605077574048,0.08039492242595205,0.6591443347437705,0.34085566525622946,356,4,112,240,255,101,0.011235955056179775,0.3146067415730337,0.6741573033707865,0.7162921348314607,0.28370786516853935
990,1479,1179,300,1207,272,0.7971602434077079,0.2028397565922921,0.8160919540229885,0.1839080459770115,548,85,136,327,433,115,0.1551094890510949,0.24817518248175183,0.5967153284671532,0.7901459854014599,0.20985401459854014
991,842,647,195,635,207,0.7684085510688836,0.23159144893111638,0.7541567695961995,0.24584323040380046,285,7,42,236,128,157,0.02456140350877193,0.14736842105263157,0.8280701754385965,0.44912280701754387,0.5508771929824562
992,2535,2140,395,2096,439,0.8441814595660749,0.15581854043392504,0.8268244575936884,0.17317554240631164,739,98,189,452,579,160,0.13261163734776726,0.2557510148849797,0.6116373477672531,0.7834912043301759,0.2165087956698241
993,2087,1688,399,1709,378,0.8088164829899377,0.19118351701006228,0.8188787733588884,0.18112122664111163,827,119,208,500,631,196,0.14389359129383314,0.25151148730350664,0.6045949214026602,0.7629987908101572,0.2370012091898428
994,1479,1179,300,1207,272,0.7971602434077079,0.2028397565922921,0.8160919540229885,0.1839080459770115,548,85,136,327,433,115,0.1551094890510949,0.24817518248175183,0.5967153284671532,0.7901459854014599,0.20985401459854014
995,2341,1826,515,2019,322,0.7800085433575396,0.21999145664246048,0.8624519436138403,0.13754805638615977,1589,222,378,989,1457,132,0.13971050975456262,0.23788546255506607,0.6224040276903713,0.9169288860918817,0.08307111390811832
996,2759,2293,466,2261,498,0.8310982239942007,0.1689017760057992,0.8194998187749184,0.18050018122508155,1067,115,191,761,717,350,0.1077788191190253,0.1790065604498594,0.7132146204311153,0.6719775070290535,0.3280224929709466
997,1062,968,94,672,390,0.911487758945386,0.08851224105461393,0.632768361581921,0.3672316384180791,309,4,105,200,254,55,0.012944983818770227,0.33980582524271846,0.6472491909385113,0.8220064724919094,0.1779935275080906
998,3879,2681,1198,3186,693,0.6911575148234081,0.3088424851765919,0.8213457076566125,0.17865429234338748,2731,1319,184,1228,2218,513,0.4829732698645185,0.06737458806298059,0.4496521420725009,0.8121567191504944,0.1878432808495057
999,659,518,141,568,91,0.7860394537177542,0.21396054628224584,0.8619119878603946,0.13808801213960548,302,37,92,173,274,28,0.12251655629139073,0.304635761589404,0.5728476821192053,0.9072847682119205,0.09271523178807947
1000,37825,32449,5376,31936,5889,0.857871777924653,0.142128222075347,0.8443093192333113,0.1556906807666887,12804,340,1367,11097,8177,4627,0.02655420181193377,0.10676351140268667,0.8666822867853796,0.6386285535770072,0.3613714464229928
1001,2687,1663,1024,1572,1115,0.6189058429475252,0.3810941570524749,0.5850390770375884,0.4149609229624116,3300,39,949,2312,1497,1803,0.011818181818181818,0.2875757575757576,0.7006060606060606,0.4536363636363636,0.5463636363636364
1002,163,89,74,84,79,0.5460122699386503,0.4539877300613497,0.5153374233128835,0.48466257668711654,145,5,36,104,72,73,0.034482758620689655,0.2482758620689655,0.7172413793103448,0.496551724137931,0.503448275862069
1003,2392,1840,552,2012,380,0.7692307692307693,0.23076923076923078,0.8411371237458194,0.1588628762541806,1953,59,163,1731,1047,906,0.030209933435739886,0.08346134152585766,0.8863287250384024,0.5360983102918587,0.46390168970814133
1004,23333,19840,3493,18615,4718,0.85029786139802,0.14970213860198003,0.7977971113873056,0.20220288861269448,16668,150,670,15848,6894,9774,0.008999280057595392,0.04019678425725942,0.9508039356851452,0.4136069114470842,0.5863930885529157
1005,7160,5545,1615,5107,2053,0.7744413407821229,0.2255586592178771,0.713268156424581,0.286731843575419,2288,147,301,1840,1373,915,0.06424825174825174,0.13155594405594406,0.8041958041958042,0.6000874125874126,0.3999125874125874
1006,6725,5555,1170,5917,808,0.8260223048327138,0.17397769516728626,0.8798513011152417,0.12014869888475836,2411,194,471,1746,2240,171,0.080464537536292,0.19535462463708006,0.724180837826628,0.92907507258399,0.07092492741600996
1007,1359,1244,115,866,493,0.9153789551140544,0.08462104488594555,0.637233259749816,0.36276674025018396,509,4,157,348,434,75,0.007858546168958742,0.30844793713163066,0.6836935166994106,0.8526522593320236,0.14734774066797643
1008,2497,1877,620,2042,455,0.7517020424509411,0.24829795754905887,0.8177813376051262,0.18221866239487386,1541,115,249,1177,1081,460,0.07462686567164178,0.16158338741077222,0.7637897469175859,0.7014925373134329,0.29850746268656714
1009,2686,2562,124,2248,438,0.9538346984363366,0.04616530156366344,0.8369322412509308,0.16306775874906926,741,28,153,560,338,403,0.037786774628879895,0.20647773279352227,0.7557354925775979,0.45614035087719296,0.543859649122807
1010,1865,1456,409,1455,410,0.7806970509383379,0.2193029490616622,0.7801608579088471,0.21983914209115282,1010,18,119,873,705,305,0.01782178217821782,0.11782178217821782,0.8643564356435643,0.698019801980198,0.30198019801980197
1011,6116,4876,1240,4791,1325,0.7972531066056245,0.2027468933943754,0.7833551340745586,0.21664486592544147,3491,178,331,2982,1744,1747,0.05098825551417932,0.09481523918647952,0.8541965052993412,0.49957032368948723,0.5004296763105127
1012,2458,2097,361,1945,513,0.8531326281529699,0.1468673718470301,0.791293734743694,0.20870626525630595,627,14,85,528,382,245,0.022328548644338118,0.13556618819776714,0.8421052631578947,0.6092503987240829,0.39074960127591707
1013,5579,4672,907,4353,1226,0.8374260620182828,0.16257393798171715,0.7802473561570173,0.21975264384298263,2608,384,336,1888,1919,689,0.147239263803681,0.12883435582822086,0.7239263803680982,0.7358128834355828,0.2641871165644172
1014,1355,987,368,1174,181,0.7284132841328413,0.27158671586715866,0.8664206642066421,0.13357933579335793,1054,39,160,855,718,336,0.03700189753320683,0.15180265654648956,0.8111954459203036,0.681214421252372,0.3187855787476281
1015,7361,6139,1222,5989,1372,0.8339899470180682,0.1660100529819318,0.8136122809400896,0.18638771905991033,4263,80,378,3805,2071,2192,0.018766127140511377,0.08866995073891626,0.8925639221205723,0.4858081163499883,0.5141918836500118
1016,11959,10603,1356,10253,1706,0.8866125930261728,0.11338740697382724,0.8573459319341082,0.1426540680658918,1884,158,370,1356,1298,586,0.08386411889596602,0.19639065817409768,0.7197452229299363,0.6889596602972399,0.31104033970276007
1017,27621,23683,3938,23963,3658,0.8574273197929112,0.1425726802070888,0.867564534231201,0.1324354657687991,5841,18,571,5252,3284,2557,0.0030816640986132513,0.09775723335045369,0.8991611025509331,0.5622324944358843,0.43776750556411576
1018,1001,907,94,623,378,0.906093906093906,0.0939060939060939,0.6223776223776224,0.3776223776223776,204,4,94,106,165,39,0.0196078431372549,0.46078431372549017,0.5196078431372549,0.8088235294117647,0.19117647058823528
1019,16951,12669,4282,14242,2709,0.7473895345407351,0.25261046545926497,0.8401864196802549,0.15981358031974516,16820,4960,410,11450,10088,6732,0.29488703923900117,0.02437574316290131,0.6807372175980975,0.5997621878715814,0.4002378121284185
1020,4019,3338,681,2259,1760,0.8305548643941278,0.1694451356058721,0.5620801194326946,0.4379198805673053,1193,16,328,849,885,308,0.013411567476948869,0.2749371332774518,0.7116512992455993,0.7418273260687342,0.2581726739312657
1021,1602,1139,463,1315,287,0.7109862671660424,0.28901373283395754,0.8208489388264669,0.17915106117353308,1257,24,134,1099,813,444,0.01909307875894988,0.10660302307080351,0.8743038981702467,0.6467780429594272,0.3532219570405728
1022,1113,851,262,973,140,0.7646001796945193,0.23539982030548068,0.8742138364779874,0.12578616352201258,455,103,148,204,377,78,0.22637362637362637,0.3252747252747253,0.44835164835164837,0.8285714285714286,0.17142857142857143
1023,31208,27853,3355,25364,5844,0.8924955139707768,0.10750448602922327,0.812740322994104,0.18725967700589594,8321,787,1251,6283,4654,3667,0.09457997836798462,0.15034250691022713,0.7550775147217883,0.5593077755077515,0.44069222449224854
1024,13507,11050,2457,9289,4218,0.8180943214629451,0.18190567853705486,0.6877174798252758,0.31228252017472424,6453,389,514,5550,4260,2193,0.06028203936153727,0.07965287463195413,0.8600650860065086,0.6601580660158066,0.3398419339841934
1025,1047,739,308,698,349,0.7058261700095511,0.2941738299904489,0.6666666666666666,0.3333333333333333,480,35,109,336,293,187,0.07291666666666667,0.22708333333333333,0.7,0.6104166666666667,0.38958333333333334
1026,987,893,94,620,367,0.9047619047619048,0.09523809523809523,0.6281661600810537,0.3718338399189463,235,4,94,137,188,47,0.01702127659574468,0.4,0.5829787234042553,0.8,0.2
1027,479,341,138,416,63,0.7118997912317327,0.2881002087682672,0.8684759916492694,0.1315240083507307,422,44,107,271,319,103,0.10426540284360189,0.25355450236966826,0.6421800947867299,0.7559241706161137,0.24407582938388625
1028,404,331,73,310,94,0.8193069306930693,0.1806930693069307,0.7673267326732673,0.23267326732673269,273,31,48,194,216,57,0.11355311355311355,0.17582417582417584,0.7106227106227107,0.7912087912087912,0.2087912087912088
1029,490,347,143,425,65,0.7081632653061225,0.29183673469387755,0.8673469387755102,0.1326530612244898,431,44,111,276,327,104,0.10208816705336426,0.25754060324825984,0.6403712296983759,0.7587006960556845,0.24129930394431554
1030,1672,1377,295,1385,287,0.8235645933014354,0.17643540669856458,0.8283492822966507,0.17165071770334928,667,100,185,382,532,135,0.14992503748125938,0.2773613193403298,0.5727136431784108,0.7976011994002998,0.20239880059970014
1031,4750,3683,1067,4135,615,0.7753684210526316,0.22463157894736843,0.8705263157894737,0.12947368421052632,1983,92,244,1647,1270,713,0.04639435199193142,0.12304589006555723,0.8305597579425114,0.6404437720625316,0.3595562279374685
1032,4489,4061,428,4183,306,0.9046558253508576,0.09534417464914235,0.9318333704611272,0.0681666295388728,1887,64,648,1175,1174,713,0.03391626921038686,0.34340222575516693,0.6226815050344462,0.6221515633280339,0.3778484366719661
1033,2737,1947,790,2168,569,0.711362805991962,0.288637194008038,0.7921081476068689,0.20789185239313115,2038,828,130,1080,1541,497,0.40628066732090284,0.06378802747791953,0.5299313052011776,0.7561334641805691,0.24386653581943082
1034,1128,1030,98,707,421,0.9131205673758865,0.08687943262411348,0.62677304964539,0.37322695035460995,264,4,110,150,205,59,0.015151515151515152,0.4166666666666667,0.5681818181818182,0.7765151515151515,0.22348484848484848
1035,85,58,27,78,7,0.6823529411764706,0.3176470588235294,0.9176470588235294,0.08235294117647059,137,4,29,104,114,23,0.029197080291970802,0.2116788321167883,0.7591240875912408,0.8321167883211679,0.1678832116788321
1036,140,63,77,67,73,0.45,0.55,0.4785714285714286,0.5214285714285715,159,4,52,103,97,62,0.025157232704402517,0.3270440251572327,0.6477987421383647,0.610062893081761,0.389937106918239
1037,2299,1933,366,1896,403,0.8408003479773815,0.15919965202261854,0.8247063940843845,0.1752936059156155,821,99,166,556,565,256,0.12058465286236297,0.20219244823386115,0.6772228989037758,0.6881851400730816,0.3118148599269184
1038,57,32,25,49,8,0.5614035087719298,0.43859649122807015,0.8596491228070176,0.14035087719298245,94,3,29,62,89,5,0.031914893617021274,0.30851063829787234,0.6595744680851063,0.9468085106382979,0.05319148936170213
1039,2664,1931,733,2136,528,0.7248498498498499,0.27515015015015015,0.8018018018018018,0.1981981981981982,845,43,174,628,413,432,0.05088757396449704,0.20591715976331362,0.7431952662721893,0.4887573964497041,0.5112426035502958
1040,462,366,96,413,49,0.7922077922077922,0.2077922077922078,0.8939393939393939,0.10606060606060606,429,40,84,305,357,72,0.09324009324009325,0.1958041958041958,0.710955710955711,0.8321678321678322,0.16783216783216784
1041,137,72,65,75,62,0.5255474452554745,0.4744525547445255,0.5474452554744526,0.45255474452554745,154,9,37,108,87,67,0.05844155844155844,0.24025974025974026,0.7012987012987013,0.564935064935065,0.43506493506493504
1042,83,41,42,68,15,0.4939759036144578,0.5060240963855421,0.8192771084337349,0.18072289156626506,385,8,226,151,333,52,0.02077922077922078,0.587012987012987,0.3922077922077922,0.8649350649350649,0.13506493506493505
1043,13507,11050,2457,9289,4218,0.8180943214629451,0.18190567853705486,0.6877174798252758,0.31228252017472424,6453,389,514,5550,4260,2193,0.06028203936153727,0.07965287463195413,0.8600650860065086,0.6601580660158066,0.3398419339841934
1044,1203,1101,102,740,463,0.9152119700748129,0.08478802992518704,0.6151288445552785,0.3848711554447215,298,4,130,164,254,44,0.013422818791946308,0.436241610738255,0.5503355704697986,0.8523489932885906,0.1476510067114094
1045,944,855,89,586,358,0.9057203389830508,0.09427966101694915,0.6207627118644068,0.3792372881355932,200,4,87,109,158,42,0.02,0.435,0.545,0.79,0.21
1046,6634,4972,1662,5074,1560,0.7494724148326801,0.2505275851673199,0.7648477539945734,0.23515224600542659,3385,52,310,3023,1873,1512,0.01536189069423929,0.0915805022156573,0.8930576070901034,0.5533234859675037,0.4466765140324963
1047,1460,1349,111,932,528,0.923972602739726,0.07602739726027398,0.6383561643835617,0.36164383561643837,306,4,110,192,219,87,0.013071895424836602,0.35947712418300654,0.6274509803921569,0.7156862745098039,0.28431372549019607
1048,41,17,24,29,12,0.4146341463414634,0.5853658536585366,0.7073170731707317,0.2926829268292683,102,3,23,76,92,10,0.029411764705882353,0.22549019607843138,0.7450980392156863,0.9019607843137255,0.09803921568627451
1049,4550,3715,835,3594,956,0.8164835164835165,0.1835164835164835,0.7898901098901099,0.21010989010989012,1230,107,230,893,827,403,0.08699186991869919,0.18699186991869918,0.7260162601626017,0.6723577235772358,0.3276422764227642
1050,1172,966,206,984,188,0.8242320819112628,0.1757679180887372,0.8395904436860068,0.16040955631399317,510,46,149,315,400,110,0.09019607843137255,0.29215686274509806,0.6176470588235294,0.7843137254901961,0.21568627450980393
1051,9766,7550,2216,7783,1983,0.7730903133319681,0.22690968666803193,0.7969485971738686,0.2030514028261315,3170,126,437,2607,2143,1027,0.03974763406940063,0.13785488958990536,0.822397476340694,0.6760252365930599,0.32397476340694004
1052,669,532,137,577,92,0.7952167414050823,0.20478325859491778,0.8624813153961136,0.1375186846038864,281,41,90,150,264,17,0.14590747330960854,0.3202846975088968,0.5338078291814946,0.9395017793594306,0.060498220640569395
1053,2096,1695,401,1719,377,0.8086832061068703,0.19131679389312978,0.8201335877862596,0.17986641221374045,694,88,165,441,545,149,0.12680115273775217,0.2377521613832853,0.6354466858789626,0.7853025936599424,0.21469740634005763
1054,431,288,143,347,84,0.6682134570765661,0.33178654292343385,0.8051044083526682,0.19489559164733178,533,38,89,406,339,194,0.07129455909943715,0.1669793621013133,0.7617260787992496,0.6360225140712945,0.36397748592870544
1055,7537,5724,1813,6499,1038,0.7594533634071912,0.2405466365928088,0.8622794215204989,0.13772057847950112,4372,100,260,4012,2635,1737,0.022872827081427266,0.059469350411710885,0.9176578225068619,0.6026989935956084,0.3973010064043916
1056,4588,3838,750,3806,782,0.8365300784655624,0.16346992153443765,0.8295553618134264,0.17044463818657368,1782,102,301,1379,1219,563,0.05723905723905724,0.16891133557800225,0.7738496071829405,0.6840628507295174,0.3159371492704826
1057,2316,1816,500,1858,458,0.7841105354058722,0.2158894645941278,0.802245250431779,0.19775474956822106,856,58,224,574,696,160,0.06775700934579439,0.2616822429906542,0.6705607476635514,0.8130841121495327,0.18691588785046728
1058,1062,746,316,685,377,0.7024482109227872,0.2975517890772128,0.6450094161958568,0.3549905838041431,770,16,148,606,356,414,0.02077922077922078,0.19220779220779222,0.787012987012987,0.4623376623376623,0.5376623376623376
1059,13261,10948,2313,10205,3056,0.8255787647990348,0.17442123520096522,0.7695498077068095,0.23045019229319055,6684,65,448,6171,3113,3571,0.009724715739078396,0.06702573309395571,0.9232495511669659,0.46573907839616996,0.5342609216038301
1060,7165,6247,918,5818,1347,0.8718771807397069,0.1281228192602931,0.8120027913468248,0.18799720865317515,855,41,363,451,700,155,0.047953216374269005,0.4245614035087719,0.5274853801169591,0.8187134502923976,0.18128654970760233
1061,2597,2189,408,1966,631,0.842895648825568,0.15710435117443203,0.7570273392375818,0.24297266076241816,551,44,127,380,348,203,0.07985480943738657,0.23049001814882034,0.6896551724137931,0.631578947368421,0.3684210526315789
1062,8666,7807,859,7195,1471,0.9008769905377336,0.09912300946226633,0.8302561735518117,0.16974382644818833,946,64,287,595,732,214,0.06765327695560254,0.3033826638477801,0.6289640591966174,0.773784355179704,0.226215644820296
1063,1479,1179,300,1207,272,0.7971602434077079,0.2028397565922921,0.8160919540229885,0.1839080459770115,548,85,136,327,433,115,0.1551094890510949,0.24817518248175183,0.5967153284671532,0.7901459854014599,0.20985401459854014
1064,191,108,83,184,7,0.5654450261780105,0.43455497382198954,0.9633507853403142,0.03664921465968586,180,7,45,128,175,5,0.03888888888888889,0.25,0.7111111111111111,0.9722222222222222,0.027777777777777776
1065,12424,10775,1649,10193,2231,0.8672730199613651,0.1327269800386349,0.8204282034771411,0.17957179652285898,4192,169,676,3347,2834,1358,0.04031488549618321,0.16125954198473283,0.798425572519084,0.6760496183206107,0.32395038167938933
1066,1021,842,179,867,154,0.8246816846229187,0.17531831537708129,0.8491674828599413,0.15083251714005877,403,44,109,250,322,81,0.10918114143920596,0.2704714640198511,0.6203473945409429,0.7990074441687345,0.20099255583126552
1067,13768,13136,632,7103,6665,0.9540964555490994,0.04590354445090064,0.5159064497385241,0.4840935502614759,5538,361,1152,4025,3779,1759,0.06518598772119899,0.20801733477789816,0.7267966775009028,0.6823763091368725,0.3176236908631275
1068,5295,4499,796,4309,986,0.8496694995278564,0.15033050047214352,0.8137865911237016,0.1862134088762984,2549,165,473,1911,1646,903,0.06473126716359356,0.18556296586896823,0.7497057669674382,0.6457434287956061,0.35425657120439386
1069,12561,9737,2824,9290,3271,0.7751771355783775,0.22482286442162247,0.739590796911074,0.26040920308892607,6978,385,1395,5198,5756,1222,0.055173402120951565,0.1999140154772141,0.7449125824018343,0.82487818859272,0.17512181140728003
1070,3363,2855,508,2805,558,0.8489443948855189,0.15105560511448113,0.8340767172167708,0.16592328278322926,819,80,204,535,638,181,0.09768009768009768,0.2490842490842491,0.6532356532356532,0.778998778998779,0.221001221001221
1071,1479,1179,300,1207,272,0.7971602434077079,0.2028397565922921,0.8160919540229885,0.1839080459770115,548,85,136,327,433,115,0.1551094890510949,0.24817518248175183,0.5967153284671532,0.7901459854014599,0.20985401459854014
1072,1013,718,295,664,349,0.7087857847976308,0.2912142152023692,0.6554787759131293,0.3445212240868707,490,11,122,357,290,200,0.022448979591836733,0.24897959183673468,0.7285714285714285,0.5918367346938775,0.40816326530612246
1073,29703,24566,5137,24118,5585,0.827054506278827,0.17294549372117293,0.8119718546948119,0.18802814530518802,8819,343,1349,7127,6470,2349,0.03889329855992743,0.15296518879691576,0.8081415126431568,0.7336432702120422,0.2663567297879578
1074,27665,23014,4651,22521,5144,0.8318814386408819,0.168118561359118,0.8140610880173504,0.18593891198264956,11221,273,654,10294,6195,5026,0.024329382407985028,0.05828357543890919,0.9173870421531057,0.5520898315658141,0.4479101684341859
1075,5308,4275,1033,4254,1054,0.8053880934438583,0.19461190655614166,0.8014318010550113,0.1985681989449887,1683,117,277,1289,1146,537,0.06951871657754011,0.16458704693998813,0.7658942364824718,0.6809269162210339,0.31907308377896615
1076,363,232,131,285,78,0.6391184573002755,0.3608815426997245,0.7851239669421488,0.21487603305785125,394,6,126,262,364,30,0.015228426395939087,0.3197969543147208,0.6649746192893401,0.9238578680203046,0.07614213197969544
1077,1390,1091,299,1056,334,0.7848920863309352,0.21510791366906476,0.7597122302158273,0.24028776978417266,567,84,135,348,372,195,0.14814814814814814,0.23809523809523808,0.6137566137566137,0.656084656084656,0.3439153439153439
1078,1529,1138,391,1030,499,0.7442773054283846,0.25572269457161545,0.6736429038587312,0.3263570961412688,1100,52,158,890,437,663,0.04727272727272727,0.14363636363636365,0.8090909090909091,0.3972727272727273,0.6027272727272728
1079,0,0,0,0,0,0.0,0.0,0.0,0.0,0,0,0,0,0,0,0.0,0.0,0.0,0.0,0.0
1080,301,206,95,264,37,0.6843853820598007,0.31561461794019935,0.8770764119601329,0.12292358803986711,238,19,57,162,219,19,0.07983193277310924,0.23949579831932774,0.680672268907563,0.9201680672268907,0.07983193277310924
1081,1093,1008,85,668,425,0.9222323879231473,0.0777676120768527,0.6111619396157365,0.3888380603842635,175,4,79,92,136,39,0.022857142857142857,0.4514285714285714,0.5257142857142857,0.7771428571428571,0.22285714285714286
1082,2432,1902,530,1922,510,0.7820723684210527,0.21792763157894737,0.790296052631579,0.20970394736842105,1031,84,167,780,657,374,0.08147429679922405,0.16197866149369544,0.7565470417070805,0.6372453928225025,0.3627546071774976
1083,842,647,195,635,207,0.7684085510688836,0.23159144893111638,0.7541567695961995,0.24584323040380046,285,7,42,236,128,157,0.02456140350877193,0.14736842105263157,0.8280701754385965,0.44912280701754387,0.5508771929824562
1084,1125,1039,86,716,409,0.9235555555555556,0.07644444444444444,0.6364444444444445,0.3635555555555556,255,4,95,156,194,61,0.01568627450980392,0.37254901960784315,0.611764705882353,0.7607843137254902,0.23921568627450981
1085,109,77,32,81,28,0.7064220183486238,0.29357798165137616,0.7431192660550459,0.25688073394495414,224,4,92,128,187,37,0.017857142857142856,0.4107142857142857,0.5714285714285714,0.8348214285714286,0.16517857142857142
1086,1312,1071,241,1022,290,0.8163109756097561,0.1836890243902439,0.7789634146341463,0.22103658536585366,747,14,91,642,340,407,0.018741633199464525,0.12182061579651941,0.8594377510040161,0.45515394912985274,0.5448460508701473
1087,1236,1018,218,951,285,0.8236245954692557,0.17637540453074432,0.7694174757281553,0.23058252427184467,413,74,127,212,304,109,0.1791767554479419,0.3075060532687651,0.513317191283293,0.7360774818401937,0.2639225181598063
1088,7170,5688,1482,5825,1345,0.793305439330544,0.20669456066945607,0.8124128312412832,0.18758716875871687,3498,193,359,2946,2024,1474,0.055174385363064606,0.10263007432818753,0.8421955403087479,0.5786163522012578,0.42138364779874216
1089,2824,2161,663,2015,809,0.7652266288951841,0.23477337110481586,0.7135269121813032,0.2864730878186969,1315,93,180,1042,801,514,0.07072243346007605,0.13688212927756654,0.7923954372623574,0.6091254752851711,0.3908745247148289
1090,482,317,165,392,90,0.6576763485477178,0.34232365145228216,0.8132780082987552,0.18672199170124482,562,29,105,428,411,151,0.051601423487544484,0.18683274021352314,0.7615658362989324,0.7313167259786477,0.26868327402135234
1091,429,285,144,353,76,0.6643356643356644,0.3356643356643357,0.8228438228438228,0.17715617715617715,570,33,94,443,446,124,0.05789473684210526,0.1649122807017544,0.7771929824561403,0.7824561403508772,0.21754385964912282
1092,12326,10091,2235,10039,2287,0.8186759694953756,0.18132403050462437,0.8144572448482882,0.18554275515171184,5787,103,664,5020,3955,1832,0.017798513910489026,0.11473993433557975,0.8674615517539312,0.6834283739415933,0.3165716260584068
1093,2048,1322,726,1546,502,0.6455078125,0.3544921875,0.7548828125,0.2451171875,906,53,207,646,802,104,0.05849889624724062,0.22847682119205298,0.7130242825607064,0.8852097130242825,0.11479028697571744
1094,5464,4212,1252,3959,1505,0.7708638360175696,0.22913616398243045,0.7245607613469985,0.27543923865300146,2561,277,362,1922,1367,1194,0.10816087465833658,0.14135103475205,0.7504880905896134,0.5337758688012495,0.4662241311987505
1095,2607,2158,449,2122,485,0.82777138473341,0.17222861526658995,0.8139624088991178,0.18603759110088225,816,102,180,534,585,231,0.125,0.22058823529411764,0.6544117647058824,0.7169117647058824,0.28308823529411764
1096,29059,26832,2227,25884,3175,0.9233628135861524,0.07663718641384769,0.8907395299218831,0.10926047007811693,8008,134,1132,6742,5027,2981,0.016733266733266732,0.14135864135864135,0.8419080919080919,0.6277472527472527,0.37225274725274726
1097,12656,11151,1505,10162,2494,0.8810840707964602,0.11891592920353983,0.8029393173198482,0.1970606826801517,4184,172,687,3325,2816,1368,0.04110898661567878,0.16419694072657745,0.7946940726577438,0.6730401529636711,0.32695984703632885
1098,6139,4889,1250,4929,1210,0.7963837758592605,0.20361622414073954,0.8028994950317642,0.19710050496823586,3190,278,357,2555,1930,1260,0.0871473354231975,0.11191222570532916,0.8009404388714734,0.6050156739811913,0.3949843260188088
1099,3058,2287,771,2467,591,0.7478744277305428,0.25212557226945714,0.8067364290385873,0.1932635709614127,1614,53,222,1339,1243,371,0.03283767038413878,0.137546468401487,0.8296158612143743,0.7701363073110284,0.2298636926889715
1100,454,361,93,407,47,0.7951541850220264,0.20484581497797358,0.8964757709251101,0.10352422907488987,429,40,83,306,357,72,0.09324009324009325,0.19347319347319347,0.7132867132867133,0.8321678321678322,0.16783216783216784
1101,386,280,106,326,60,0.7253886010362695,0.27461139896373055,0.844559585492228,0.15544041450777202,405,23,126,256,329,76,0.056790123456790124,0.3111111111111111,0.6320987654320988,0.8123456790123457,0.18765432098765433
1102,1765,1513,252,1518,247,0.8572237960339943,0.14277620396600565,0.860056657223796,0.13994334277620396,1066,158,204,704,976,90,0.14821763602251406,0.19136960600375236,0.6604127579737336,0.9155722326454033,0.08442776735459662
1103,364,199,165,217,147,0.5467032967032966,0.4532967032967033,0.5961538461538461,0.40384615384615385,245,31,84,130,164,81,0.12653061224489795,0.34285714285714286,0.5306122448979592,0.6693877551020408,0.3306122448979592
1104,6923,5717,1206,5845,1078,0.825798064422938,0.17420193557706196,0.8442871587462083,0.1557128412537917,2032,75,621,1336,1376,656,0.036909448818897635,0.30561023622047245,0.65748031496063,0.6771653543307087,0.3228346456692913
1105,3525,3023,502,2959,566,0.8575886524822695,0.1424113475177305,0.8394326241134752,0.1605673758865248,667,99,185,383,498,169,0.14842578710644677,0.2773613193403298,0.5742128935532234,0.7466266866566716,0.25337331334332835
1106,369,194,175,324,45,0.5257452574525745,0.4742547425474255,0.8780487804878049,0.12195121951219512,642,30,110,502,460,182,0.04672897196261682,0.17133956386292834,0.7819314641744548,0.7165109034267912,0.2834890965732087
1107,9675,8205,1470,7189,2486,0.8480620155038759,0.15193798449612403,0.7430490956072351,0.25695090439276486,1730,76,248,1406,1056,674,0.04393063583815029,0.14335260115606938,0.8127167630057803,0.6104046242774567,0.3895953757225434
1108,479,335,144,405,74,0.6993736951983298,0.30062630480167013,0.8455114822546973,0.1544885177453027,251,18,51,182,216,35,0.07171314741035857,0.20318725099601595,0.7250996015936255,0.8605577689243028,0.1394422310756972
1109,1481,1181,300,1211,270,0.7974341661039838,0.2025658338960162,0.8176907494935854,0.18230925050641458,552,83,137,332,427,125,0.1503623188405797,0.24818840579710144,0.6014492753623188,0.7735507246376812,0.22644927536231885
1110,994,905,89,624,370,0.9104627766599598,0.08953722334004025,0.6277665995975855,0.3722334004024145,170,4,75,91,130,40,0.023529411764705882,0.4411764705882353,0.5352941176470588,0.7647058823529411,0.23529411764705882
1111,4001,2667,1334,2681,1320,0.6665833541614596,0.33341664583854036,0.670082479380155,0.32991752061984503,905,39,144,722,590,315,0.0430939226519337,0.1591160220994475,0.7977900552486188,0.6519337016574586,0.34806629834254144
1112,6578,5268,1310,5302,1276,0.800851322590453,0.19914867740954698,0.8060200668896321,0.1939799331103679,3103,190,371,2542,1919,1184,0.06123106670963584,0.11956171446986787,0.8192072188204963,0.6184337737673219,0.38156622623267805
1113,3283,2606,677,2872,411,0.7937861711848919,0.20621382881510814,0.8748096253426744,0.1251903746573256,900,93,242,565,762,138,0.10333333333333333,0.2688888888888889,0.6277777777777778,0.8466666666666667,0.15333333333333332
1114,74,48,26,56,18,0.6486486486486487,0.35135135135135137,0.7567567567567568,0.24324324324324326,127,3,47,77,114,13,0.023622047244094488,0.3700787401574803,0.6062992125984252,0.8976377952755905,0.10236220472440945
1115,5775,4540,1235,5066,709,0.7861471861471861,0.21385281385281385,0.8772294372294372,0.12277056277056277,2396,123,275,1998,1533,863,0.05133555926544241,0.1147746243739566,0.833889816360601,0.6398163606010017,0.36018363939899833
1116,16007,13573,2434,14333,1674,0.8479415255825576,0.15205847441744236,0.8954207534203786,0.10457924657962142,4210,238,499,3473,3651,559,0.056532066508313536,0.11852731591448931,0.8249406175771972,0.8672209026128266,0.1327790973871734
1117,1630,1185,445,1378,252,0.7269938650306749,0.27300613496932513,0.845398773006135,0.15460122699386503,1348,30,112,1206,794,554,0.02225519287833828,0.0830860534124629,0.8946587537091988,0.5890207715133531,0.41097922848664686
1118,11426,8869,2557,8412,3014,0.77621214773324,0.22378785226676,0.7362156485209173,0.2637843514790828,6270,399,1262,4609,5069,1201,0.06363636363636363,0.20127591706539075,0.7350877192982456,0.8084529505582138,0.19154704944178627
1119,11197,8670,2527,8341,2856,0.7743145485397874,0.22568545146021254,0.74493167812807,0.25506832187192996,5703,221,1175,4307,4766,937,0.0387515342802034,0.20603191302823076,0.7552165526915658,0.835700508504296,0.16429949149570403
1120,902,728,174,777,125,0.8070953436807096,0.19290465631929046,0.8614190687361419,0.1385809312638581,334,40,112,182,313,21,0.11976047904191617,0.33532934131736525,0.5449101796407185,0.937125748502994,0.06287425149700598
1121,1365,859,506,823,542,0.6293040293040293,0.3706959706959707,0.6029304029304029,0.39706959706959705,549,19,140,390,329,220,0.03460837887067395,0.2550091074681239,0.7103825136612022,0.599271402550091,0.4007285974499089
1122,8193,6093,2100,6978,1215,0.7436836323690955,0.25631636763090443,0.8517026730135482,0.14829732698645184,7132,580,426,6126,4723,2409,0.08132361189007291,0.05973079080201907,0.858945597307908,0.6622265844083006,0.3377734155916994
1123,1904,1394,510,1652,252,0.7321428571428571,0.26785714285714285,0.8676470588235294,0.1323529411764706,2825,42,455,2328,1749,1076,0.014867256637168142,0.16106194690265488,0.824070796460177,0.6191150442477876,0.3808849557522124
1124,976,888,88,615,361,0.9098360655737705,0.09016393442622951,0.6301229508196722,0.3698770491803279,285,4,97,184,210,75,0.014035087719298246,0.34035087719298246,0.6456140350877193,0.7368421052631579,0.2631578947368421
1125,3279,2470,809,2360,919,0.7532784385483379,0.2467215614516621,0.7197316254955779,0.2802683745044221,2126,32,181,1913,1256,870,0.015051740357478834,0.08513640639698965,0.8998118532455315,0.5907808090310442,0.40921919096895576
1126,1014,917,97,627,387,0.9043392504930966,0.09566074950690336,0.6183431952662722,0.3816568047337278,247,4,98,145,206,41,0.016194331983805668,0.3967611336032389,0.5870445344129555,0.8340080971659919,0.1659919028340081
1127,1528,1163,365,1176,352,0.7611256544502618,0.23887434554973822,0.7696335078534031,0.23036649214659685,442,37,129,276,284,158,0.083710407239819,0.2918552036199095,0.6244343891402715,0.6425339366515838,0.3574660633484163
1128,1490,1381,109,951,539,0.9268456375838926,0.07315436241610739,0.6382550335570469,0.361744966442953,267,4,101,162,220,47,0.0149812734082397,0.3782771535580524,0.6067415730337079,0.8239700374531835,0.1760299625468165
1129,40,25,15,37,3,0.625,0.375,0.925,0.075,67,8,17,42,63,4,0.11940298507462686,0.2537313432835821,0.6268656716417911,0.9402985074626866,0.05970149253731343
1130,2153,1778,375,1879,274,0.8258244310264747,0.17417556897352532,0.8727357176033441,0.12726428239665583,765,48,203,514,658,107,0.06274509803921569,0.265359477124183,0.6718954248366014,0.8601307189542484,0.13986928104575164
1131,302,191,111,260,42,0.6324503311258278,0.3675496688741722,0.8609271523178808,0.1390728476821192,457,8,118,331,329,128,0.0175054704595186,0.25820568927789933,0.7242888402625821,0.7199124726477024,0.2800875273522976
1132,5267,4454,813,4375,892,0.8456426808429847,0.15435731915701537,0.8306436301499905,0.16935636985000949,1654,108,273,1273,1167,487,0.06529625151148731,0.16505441354292624,0.7696493349455864,0.7055622732769045,0.29443772672309554
1133,3519,2831,688,2746,773,0.8044899119067918,0.1955100880932083,0.780335322534811,0.21966467746518897,661,46,147,468,534,127,0.06959152798789713,0.22239031770045387,0.708018154311649,0.8078668683812406,0.19213313161875945
1134,851,629,222,636,215,0.7391304347826086,0.2608695652173913,0.7473560517038778,0.2526439482961222,246,15,50,181,163,83,0.06097560975609756,0.2032520325203252,0.7357723577235772,0.6626016260162602,0.33739837398373984
1135,1030,984,46,991,39,0.9553398058252427,0.04466019417475728,0.962135922330097,0.037864077669902914,82,0,23,59,79,3,0.0,0.2804878048780488,0.7195121951219512,0.9634146341463414,0.036585365853658534
1136,17699,14825,2874,13528,4171,0.8376179445166394,0.16238205548336065,0.7643369681902933,0.23566303180970677,11418,335,508,10575,5676,5742,0.02933963916622876,0.04449115431774391,0.9261692065160273,0.49710982658959535,0.5028901734104047
1137,11804,9777,2027,9331,2473,0.8282785496441885,0.1717214503558116,0.7904947475432057,0.2095052524567943,5885,224,449,5212,1112,4773,0.038062871707731524,0.07629566694987255,0.885641461342396,0.18895497026338148,0.8110450297366185
1138,1085,747,338,898,187,0.688479262672811,0.31152073732718893,0.8276497695852535,0.17235023041474654,895,50,130,715,628,267,0.055865921787709494,0.1452513966480447,0.7988826815642458,0.7016759776536313,0.29832402234636873
1139,212,124,88,122,90,0.5849056603773585,0.41509433962264153,0.5754716981132075,0.42452830188679247,171,18,51,102,117,54,0.10526315789473684,0.2982456140350877,0.5964912280701754,0.6842105263157895,0.3157894736842105
1140,4580,3765,815,3685,895,0.8220524017467249,0.1779475982532751,0.8045851528384279,0.19541484716157206,974,79,208,687,730,244,0.0811088295687885,0.2135523613963039,0.7053388090349076,0.7494866529774127,0.25051334702258726
1141,171,141,30,152,19,0.8245614035087719,0.17543859649122806,0.8888888888888888,0.1111111111111111,125,4,21,100,113,12,0.032,0.168,0.8,0.904,0.096
1142,573,372,201,326,247,0.6492146596858639,0.3507853403141361,0.568935427574171,0.43106457242582896,267,15,73,179,167,100,0.056179775280898875,0.27340823970037453,0.6704119850187266,0.6254681647940075,0.37453183520599254
1143,4259,3287,972,3113,1146,0.7717774125381545,0.2282225874618455,0.730922751819676,0.269077248180324,4362,65,142,4155,2552,1810,0.014901421366345712,0.03255387436955525,0.952544704264099,0.5850527281063732,0.4149472718936268
1144,6559,4567,1992,5276,1283,0.6962951669461808,0.3037048330538192,0.8043909132489708,0.19560908675102912,9098,64,887,8147,5380,3718,0.007034513079797758,0.09749395471532205,0.8954715322048802,0.591338755770499,0.408661244229501
1145,3768,2914,854,2649,1119,0.7733545647558386,0.22664543524416136,0.7030254777070064,0.29697452229299365,2127,90,202,1835,1185,942,0.04231311706629055,0.09496944052656324,0.8627174424071462,0.5571227080394923,0.44287729196050774
1146,999,904,95,621,378,0.9049049049049049,0.09509509509509509,0.6216216216216216,0.3783783783783784,209,4,91,114,170,39,0.019138755980861243,0.4354066985645933,0.5454545454545454,0.8133971291866029,0.18660287081339713
1147,2670,2137,533,2350,320,0.800374531835206,0.199625468164794,0.8801498127340824,0.1198501872659176,746,52,157,537,633,113,0.06970509383378017,0.21045576407506703,0.7198391420911529,0.8485254691689008,0.15147453083109919
1148,154,101,53,106,48,0.6558441558441559,0.34415584415584416,0.6883116883116883,0.3116883116883117,173,29,37,107,113,60,0.1676300578034682,0.2138728323699422,0.6184971098265896,0.653179190751445,0.3468208092485549
1149,6139,4889,1250,4929,1210,0.7963837758592605,0.20361622414073954,0.8028994950317642,0.19710050496823586,3190,278,357,2555,1930,1260,0.0871473354231975,0.11191222570532916,0.8009404388714734,0.6050156739811913,0.3949843260188088
1150,220,142,78,185,35,0.6454545454545455,0.35454545454545455,0.8409090909090909,0.1590909090909091,388,29,117,242,316,72,0.07474226804123711,0.3015463917525773,0.6237113402061856,0.8144329896907216,0.18556701030927836
1151,3844,2979,865,2842,1002,0.7749739854318418,0.22502601456815816,0.7393340270551508,0.2606659729448491,2030,55,177,1798,1269,761,0.027093596059113302,0.08719211822660099,0.8857142857142857,0.6251231527093596,0.3748768472906404
1152,12290,9571,2719,9131,3159,0.7787632221318145,0.22123677786818552,0.7429617575264442,0.2570382424735557,6827,382,1360,5085,5549,1278,0.05595429910648894,0.19920902299692397,0.744836677896587,0.8128021092720082,0.18719789072799178
1153,624,415,209,586,38,0.6650641025641025,0.3349358974358974,0.9391025641025641,0.060897435897435896,214,7,87,120,194,20,0.03271028037383177,0.40654205607476634,0.5607476635514018,0.9065420560747663,0.09345794392523364
1154,1654,1127,527,1636,18,0.6813784764207981,0.3186215235792019,0.9891172914147521,0.010882708585247884,3746,5,226,3515,2930,816,0.0013347570742124934,0.0603310197544047,0.9383342231713828,0.7821676454885211,0.21783235451147892
1155,5943,4879,1064,4743,1200,0.8209658421672555,0.1790341578327444,0.7980817768803634,0.20191822311963656,1743,115,312,1316,1197,546,0.06597819850831899,0.17900172117039587,0.7550200803212851,0.6867469879518072,0.3132530120481928
1156,1053,816,237,756,297,0.7749287749287749,0.22507122507122507,0.717948717948718,0.28205128205128205,400,61,132,207,315,85,0.1525,0.33,0.5175,0.7875,0.2125
1157,6086,4880,1206,5011,1075,0.801840289188301,0.19815971081169897,0.8233651002300362,0.17663489976996385,2903,150,355,2398,1955,948,0.05167068549776094,0.12228728901136755,0.8260420254908715,0.6734412676541509,0.32655873234584915
1158,10625,8136,2489,7620,3005,0.7657411764705883,0.23425882352941177,0.7171764705882353,0.2828235294117647,3605,137,373,3095,1589,2016,0.038002773925104025,0.10346740638002774,0.8585298196948682,0.4407766990291262,0.5592233009708738
1159,2051,1694,357,1722,329,0.825938566552901,0.17406143344709898,0.8395904436860068,0.16040955631399317,932,151,149,632,615,317,0.16201716738197425,0.15987124463519314,0.6781115879828327,0.6598712446351931,0.34012875536480686
1160,14917,13259,1658,12142,2775,0.8888516457732788,0.11114835422672119,0.813970637527653,0.186029362472347,7342,104,344,6894,2835,4507,0.014165077635521656,0.046853718332879324,0.938981204031599,0.38613456823753745,0.6138654317624626
1161,20733,17016,3717,16015,4718,0.8207205903631891,0.17927940963681088,0.7724400713837843,0.22755992861621568,5540,61,771,4708,2403,3137,0.011010830324909748,0.13916967509025271,0.8498194945848375,0.43375451263537906,0.566245487364621
1162,1881,1475,406,1624,257,0.7841573631047315,0.21584263689526847,0.8633705475810739,0.1366294524189261,593,52,154,387,509,84,0.08768971332209106,0.2596964586846543,0.6526138279932546,0.8583473861720068,0.14165261382799327
1163,1536,1291,245,1235,301,0.8404947916666666,0.15950520833333334,0.8040364583333334,0.19596354166666666,578,78,177,323,494,84,0.13494809688581316,0.3062283737024221,0.5588235294117647,0.8546712802768166,0.1453287197231834
1164,21260,16604,4656,16135,5125,0.7809971777986829,0.21900282220131703,0.7589369708372531,0.24106302916274694,13303,786,2117,10400,10649,2654,0.05908441704878599,0.15913703675862587,0.7817785461925881,0.8004961286927761,0.19950387130722394
1165,2530,1920,610,2263,267,0.758893280632411,0.24110671936758893,0.8944664031620554,0.10553359683794467,1239,66,176,997,810,429,0.053268765133171914,0.1420500403551251,0.804681194511703,0.6537530266343826,0.34624697336561744
1166,20164,17826,2338,16120,4044,0.8840507835746876,0.11594921642531243,0.7994445546518548,0.2005554453481452,14991,2070,2390,10531,9996,4995,0.1380828497098259,0.15942899072777,0.7024881595624041,0.6668000800480288,0.3331999199519712
1167,863,550,313,548,315,0.6373117033603708,0.3626882966396292,0.6349942062572422,0.3650057937427578,1518,37,138,1343,281,1237,0.024374176548089592,0.09090909090909091,0.8847167325428195,0.18511198945981555,0.8148880105401844
1168,1645,1091,554,1341,304,0.6632218844984803,0.33677811550151976,0.8151975683890578,0.18480243161094226,1201,42,144,1015,1058,143,0.034970857618651124,0.11990008326394672,0.8451290591174022,0.880932556203164,0.11906744379683597
1169,4167,3422,745,3388,779,0.8212143028557716,0.17878569714422846,0.8130549556035517,0.1869450443964483,1602,98,310,1194,1161,441,0.06117353308364544,0.19350811485642946,0.7453183520599251,0.7247191011235955,0.2752808988764045
1170,2073,1637,436,1575,498,0.7896767969126869,0.21032320308731306,0.7597684515195369,0.2402315484804631,775,65,206,504,451,324,0.08387096774193549,0.2658064516129032,0.6503225806451612,0.5819354838709677,0.4180645161290323
1171,21815,19333,2482,18158,3657,0.8862250744900297,0.1137749255099702,0.8323630529452212,0.16763694705477883,5743,210,616,4917,2944,2799,0.036566254570781824,0.10726101340762667,0.8561727320215915,0.512624064078008,0.48737593592199197
1172,14384,12231,2153,11438,2946,0.8503197997775306,0.14968020022246942,0.7951890989988877,0.20481090100111235,12475,154,527,11794,4801,7674,0.012344689378757516,0.042244488977955914,0.9454108216432866,0.3848496993987976,0.6151503006012025
1173,1074,726,348,958,116,0.6759776536312849,0.3240223463687151,0.8919925512104283,0.10800744878957169,453,11,69,373,338,115,0.024282560706401765,0.152317880794702,0.8233995584988962,0.7461368653421634,0.25386313465783666
1174,12280,10125,2155,8995,3285,0.8245114006514658,0.1754885993485342,0.7324918566775245,0.2675081433224756,3771,245,540,2986,2469,1302,0.06496950411031556,0.1431980906921241,0.7918324051975604,0.654733492442323,0.345266507557677
1175,138,83,55,115,23,0.6014492753623188,0.39855072463768115,0.8333333333333334,0.16666666666666666,196,30,63,103,176,20,0.15306122448979592,0.32142857142857145,0.5255102040816326,0.8979591836734694,0.10204081632653061
1176,1169,962,207,982,187,0.8229255774165953,0.1770744225834046,0.8400342172797263,0.15996578272027373,509,46,149,314,399,110,0.09037328094302555,0.29273084479371314,0.6168958742632613,0.7838899803536346,0.21611001964636542
1177,22415,17190,5225,16640,5775,0.7668971670756191,0.233102832924381,0.7423600267677894,0.25763997323221055,11618,534,677,10407,6768,4850,0.04596316061284214,0.05827164744362197,0.8957651919435359,0.5825443277672577,0.41745567223274227
1178,26602,21369,5233,21123,5479,0.8032854672581009,0.1967145327418991,0.7940380422524622,0.20596195774753778,20400,239,620,19541,9946,10454,0.011715686274509803,0.030392156862745098,0.9578921568627451,0.48754901960784314,0.5124509803921569
1179,11265,9441,1824,7595,3670,0.8380825565912117,0.16191744340878828,0.6742121615623613,0.3257878384376387,4185,42,183,3960,2742,1443,0.01003584229390681,0.04372759856630824,0.946236559139785,0.6551971326164875,0.34480286738351257
1180,5760,4454,1306,5102,658,0.7732638888888889,0.2267361111111111,0.8857638888888889,0.11423611111111111,3622,68,584,2970,2066,1556,0.018774157923799006,0.1612368856985091,0.8199889563776919,0.5704030922142462,0.4295969077857537
1181,2478,2032,446,2046,432,0.8200161420500404,0.17998385794995964,0.8256658595641646,0.17433414043583534,676,93,169,414,533,143,0.13757396449704143,0.25,0.6124260355029586,0.7884615384615384,0.21153846153846154
1182,4545,4116,429,4239,306,0.9056105610561056,0.09438943894389439,0.9326732673267327,0.06732673267326733,1689,67,685,937,1227,462,0.03966844286560095,0.4055654233274127,0.5547661338069864,0.7264653641207816,0.27353463587921845
1183,12656,11151,1505,10162,2494,0.8810840707964602,0.11891592920353983,0.8029393173198482,0.1970606826801517,4184,173,687,3324,2816,1368,0.041347992351816444,0.16419694072657745,0.7944550669216062,0.6730401529636711,0.32695984703632885
1184,544,382,162,408,136,0.7022058823529411,0.2977941176470588,0.75,0.25,731,33,142,556,538,193,0.04514363885088919,0.19425444596443228,0.7606019151846786,0.7359781121751026,0.2640218878248974
1185,70,45,25,53,17,0.6428571428571429,0.35714285714285715,0.7571428571428571,0.24285714285714285,52,1,9,42,48,4,0.019230769230769232,0.17307692307692307,0.8076923076923077,0.9230769230769231,0.07692307692307693
1186,4144,3279,865,3387,757,0.7912644787644788,0.20873552123552125,0.8173262548262549,0.18267374517374518,1589,100,289,1200,1135,454,0.06293266205160478,0.18187539332913782,0.7551919446192574,0.7142857142857143,0.2857142857142857
1187,467,287,180,265,202,0.6145610278372591,0.3854389721627409,0.5674518201284796,0.43254817987152033,296,13,75,208,152,144,0.04391891891891892,0.2533783783783784,0.7027027027027027,0.5135135135135135,0.4864864864864865
1188,47608,43241,4367,44351,3257,0.908271719038817,0.09172828096118299,0.9315871282137456,0.06841287178625441,11661,32,2003,9626,5846,5815,0.002744190035159935,0.17176914501329216,0.8254866649515479,0.5013292170482806,0.4986707829517194
1189,1883,1475,408,1626,257,0.7833244822092406,0.21667551779075941,0.8635156664896442,0.13648433351035583,592,52,153,387,508,84,0.08783783783783784,0.25844594594594594,0.6537162162162162,0.8581081081081081,0.14189189189189189
1190,3294,2770,524,2662,632,0.840922890103218,0.15907710989678203,0.8081360048573163,0.19186399514268368,1415,24,151,1240,800,615,0.01696113074204947,0.10671378091872792,0.8763250883392226,0.5653710247349824,0.43462897526501765
1191,5519,4417,1102,4892,627,0.8003261460409494,0.19967385395905055,0.8863924624026092,0.11360753759739083,8250,114,764,7372,4966,3284,0.013818181818181818,0.09260606060606061,0.8935757575757576,0.6019393939393939,0.39806060606060606
1192,2768,2297,471,2284,484,0.8298410404624278,0.17015895953757226,0.8251445086705202,0.17485549132947978,708,85,275,348,662,46,0.12005649717514125,0.3884180790960452,0.4915254237288136,0.9350282485875706,0.06497175141242938
1193,1081,982,99,679,402,0.9084181313598519,0.09158186864014801,0.6281221091581869,0.37187789084181316,224,4,95,125,181,43,0.017857142857142856,0.42410714285714285,0.5580357142857143,0.8080357142857143,0.19196428571428573
1194,1498,1194,304,1316,182,0.7970627503337784,0.20293724966622162,0.8785046728971962,0.12149532710280374,510,44,129,337,454,56,0.08627450980392157,0.2529411764705882,0.6607843137254902,0.8901960784313725,0.10980392156862745
1195,4326,3424,902,3156,1170,0.7914932963476653,0.20850670365233473,0.7295423023578363,0.27045769764216365,1718,95,185,1438,1034,684,0.05529685681024447,0.10768335273573923,0.8370197904540163,0.6018626309662398,0.3981373690337602
1196,1020,821,199,875,145,0.8049019607843138,0.19509803921568628,0.8578431372549019,0.14215686274509803,372,42,124,206,348,24,0.11290322580645161,0.3333333333333333,0.553763440860215,0.9354838709677419,0.06451612903225806
1197,1554,1354,200,1252,302,0.8712998712998713,0.1287001287001287,0.8056628056628057,0.19433719433719435,470,17,63,390,346,124,0.036170212765957444,0.13404255319148936,0.8297872340425532,0.7361702127659574,0.26382978723404255
1198,1930,1418,512,1442,488,0.7347150259067358,0.26528497409326424,0.7471502590673575,0.2528497409326425,1734,41,190,1503,1131,603,0.02364475201845444,0.10957324106113034,0.8667820069204152,0.6522491349480969,0.3477508650519031
1199,1399,1145,254,1047,352,0.8184417441029307,0.18155825589706934,0.7483917083631165,0.2516082916368835,544,63,184,297,369,175,0.11580882352941177,0.3382352941176471,0.5459558823529411,0.6783088235294118,0.32169117647058826
1200,12654,11150,1504,10160,2494,0.8811443021969337,0.11885569780306622,0.802908171329224,0.19709182867077604,4184,171,687,3326,2816,1368,0.04086998087954111,0.16419694072657745,0.7949330783938815,0.6730401529636711,0.32695984703632885
1201,2247,1679,568,1640,607,0.7472185135736538,0.25278148642634624,0.7298620382732532,0.27013796172674676,992,72,232,688,696,296,0.07258064516129033,0.23387096774193547,0.6935483870967742,0.7016129032258065,0.29838709677419356
1202,9787,8322,1465,7512,2275,0.8503116378869929,0.14968836211300704,0.7675487892101768,0.23245121078982323,3009,54,276,2679,1726,1283,0.01794616151545364,0.09172482552342971,0.8903290129611167,0.573612495845796,0.42638750415420407
1203,858,579,279,777,81,0.6748251748251748,0.32517482517482516,0.9055944055944056,0.0944055944055944,296,25,101,170,212,84,0.08445945945945946,0.34121621621621623,0.5743243243243243,0.7162162162162162,0.28378378378378377
1204,299,175,124,274,25,0.5852842809364549,0.41471571906354515,0.9163879598662207,0.08361204013377926,270,14,41,215,215,55,0.05185185185185185,0.15185185185185185,0.7962962962962963,0.7962962962962963,0.2037037037037037
1205,4001,2667,1334,2681,1320,0.6665833541614596,0.33341664583854036,0.670082479380155,0.32991752061984503,905,39,144,722,590,315,0.0430939226519337,0.1591160220994475,0.7977900552486188,0.6519337016574586,0.34806629834254144
1206,2320,1676,644,1964,356,0.7224137931034482,0.2775862068965517,0.846551724137931,0.15344827586206897,1152,34,221,897,866,286,0.029513888888888888,0.1918402777777778,0.7786458333333334,0.7517361111111112,0.2482638888888889
1207,935,847,88,580,355,0.9058823529411765,0.09411764705882353,0.6203208556149733,0.37967914438502676,203,4,90,109,164,39,0.019704433497536946,0.4433497536945813,0.5369458128078818,0.8078817733990148,0.1921182266009852
1208,6083,4881,1202,4881,1202,0.8024001315140555,0.19759986848594444,0.8024001315140555,0.19759986848594444,2632,186,314,2132,1590,1042,0.07066869300911854,0.11930091185410334,0.8100303951367781,0.6041033434650456,0.3958966565349544
1209,981,892,89,601,380,0.90927624872579,0.09072375127421,0.6126401630988787,0.3873598369011213,178,4,80,94,139,39,0.02247191011235955,0.449438202247191,0.5280898876404494,0.7808988764044944,0.21910112359550563
1210,11387,9079,2308,9325,2062,0.7973127250373233,0.20268727496267674,0.8189163080706068,0.18108369192939316,3367,163,437,2767,2049,1318,0.04841104841104841,0.1297891297891298,0.8217998217998218,0.6085536085536085,0.39144639144639143
1211,1666,1275,391,1217,449,0.7653061224489796,0.23469387755102042,0.7304921968787516,0.2695078031212485,863,69,153,641,394,469,0.07995365005793743,0.1772885283893395,0.7427578215527231,0.45654692931633833,0.5434530706836617
1212,851,629,222,636,215,0.7391304347826086,0.2608695652173913,0.7473560517038778,0.2526439482961222,246,15,50,181,163,83,0.06097560975609756,0.2032520325203252,0.7357723577235772,0.6626016260162602,0.33739837398373984
1213,5573,4553,1020,3563,2010,0.8169746994437467,0.18302530055625335,0.6393324959626772,0.3606675040373228,2912,82,295,2535,1958,954,0.02815934065934066,0.10130494505494506,0.8705357142857143,0.6723901098901099,0.3276098901098901
1214,2092,1657,435,1824,268,0.7920650095602294,0.20793499043977057,0.8718929254302104,0.12810707456978968,625,60,171,394,527,98,0.096,0.2736,0.6304,0.8432,0.1568
1215,3698,3095,603,2131,1567,0.8369388858842618,0.16306111411573823,0.5762574364521363,0.4237425635478637,1947,23,301,1623,1120,827,0.011813045711350795,0.15459681561376476,0.8335901386748844,0.5752439650744735,0.42475603492552644
1216,148,106,42,98,50,0.7162162162162162,0.28378378378378377,0.6621621621621622,0.33783783783783783,105,5,15,85,70,35,0.047619047619047616,0.14285714285714285,0.8095238095238095,0.6666666666666666,0.3333333333333333
1217,1865,1318,547,1303,562,0.7067024128686327,0.2932975871313673,0.6986595174262734,0.30134048257372653,811,63,147,601,417,394,0.07768187422934648,0.1812577065351418,0.7410604192355117,0.5141800246609125,0.48581997533908755
1218,1436,1333,103,891,545,0.9282729805013927,0.07172701949860724,0.6204735376044568,0.37952646239554316,207,4,95,108,164,43,0.01932367149758454,0.45893719806763283,0.5217391304347826,0.7922705314009661,0.20772946859903382
1219,12656,11151,1505,10162,2494,0.8810840707964602,0.11891592920353983,0.8029393173198482,0.1970606826801517,4184,172,687,3325,2816,1368,0.04110898661567878,0.16419694072657745,0.7946940726577438,0.6730401529636711,0.32695984703632885
1220,2549,1885,664,2132,417,0.7395056885052962,0.2604943114947038,0.8364064338956454,0.16359356610435466,2029,34,157,1838,1022,1007,0.016757023164120255,0.07737801872843765,0.905864958107442,0.5036964021685559,0.49630359783144407
1221,8192,6092,2100,6977,1215,0.74365234375,0.25634765625,0.8516845703125,0.1483154296875,7133,580,428,6125,4723,2410,0.08131221085097434,0.06000280386933969,0.858684985279686,0.6621337445675032,0.3378662554324968
1222,949,729,220,682,267,0.768177028451001,0.23182297154899895,0.7186512118018967,0.2813487881981033,473,42,109,322,334,139,0.08879492600422834,0.23044397463002114,0.6807610993657506,0.7061310782241015,0.2938689217758985
1223,5950,4416,1534,5095,855,0.7421848739495799,0.2578151260504202,0.8563025210084033,0.14369747899159663,3905,82,222,3601,2325,1580,0.020998719590268885,0.056850192061459665,0.9221510883482714,0.5953905249679897,0.4046094750320102
1224,1133,1043,90,715,418,0.9205648720211828,0.0794351279788173,0.6310679611650486,0.36893203883495146,215,4,99,112,170,45,0.018604651162790697,0.4604651162790698,0.5209302325581395,0.7906976744186046,0.20930232558139536
1225,3798,3310,488,2996,802,0.8715113217482886,0.12848867825171142,0.7888362295945235,0.21116377040547657,689,11,167,511,522,167,0.015965166908563134,0.24238026124818576,0.7416545718432511,0.7576197387518142,0.24238026124818576
1226,12248,9790,2458,9479,2769,0.7993141737426519,0.20068582625734813,0.7739222730241672,0.22607772697583278,1450,65,188,1197,766,684,0.04482758620689655,0.1296551724137931,0.8255172413793104,0.5282758620689655,0.47172413793103446
1227,20350,16734,3616,16550,3800,0.8223095823095823,0.17769041769041768,0.8132678132678133,0.18673218673218672,27129,86,2542,24501,11138,15991,0.003170039441188396,0.09370046813373144,0.9031294924250802,0.4105569685576321,0.589443031442368
1228,5211,4523,688,4403,808,0.8679715985415467,0.13202840145845327,0.8449433889848398,0.15505661101516025,1792,95,237,1460,1500,292,0.053013392857142856,0.13225446428571427,0.8147321428571429,0.8370535714285714,0.16294642857142858
1229,5677,4953,724,4719,958,0.8724678527391228,0.12753214726087722,0.8312488990664083,0.1687511009335917,6643,1518,1923,3202,5614,1029,0.22851121481258468,0.2894776456420292,0.4820111395453861,0.845100105374078,0.15489989462592202
1230,65,57,8,49,16,0.8769230769230769,0.12307692307692308,0.7538461538461538,0.24615384615384617,55,1,41,13,50,5,0.01818181818181818,0.7454545454545455,0.23636363636363636,0.9090909090909091,0.09090909090909091
1231,905,744,161,770,135,0.8220994475138121,0.17790055248618786,0.850828729281768,0.14917127071823205,317,47,100,170,300,17,0.14826498422712933,0.31545741324921134,0.5362776025236593,0.9463722397476341,0.05362776025236593
1232,10943,8658,2285,8765,2178,0.7911907155259069,0.20880928447409303,0.8009686557616741,0.19903134423832586,5521,238,455,4828,3123,2398,0.04310813258467669,0.0824126064118819,0.8744792610034414,0.5656583952182576,0.43434160478174244
1233,12591,11083,1508,10213,2378,0.8802319116829481,0.11976808831705187,0.8111349376538798,0.18886506234612024,4191,178,679,3334,2833,1358,0.04247196373180625,0.16201383917919351,0.7955141970890003,0.675972321641613,0.32402767835838703
1234,2458,2097,361,1945,513,0.8531326281529699,0.1468673718470301,0.791293734743694,0.20870626525630595,627,14,85,528,382,245,0.022328548644338118,0.13556618819776714,0.8421052631578947,0.6092503987240829,0.39074960127591707
1235,70,45,25,53,17,0.6428571428571429,0.35714285714285715,0.7571428571428571,0.24285714285714285,52,1,9,42,48,4,0.019230769230769232,0.17307692307692307,0.8076923076923077,0.9230769230769231,0.07692307692307693
1236,8192,6092,2100,6977,1215,0.74365234375,0.25634765625,0.8516845703125,0.1483154296875,7132,581,427,6124,4723,2409,0.08146382501402132,0.05987100392596747,0.8586651710600112,0.6622265844083006,0.3377734155916994
1237,3679,2893,786,3356,323,0.7863549877684153,0.21364501223158466,0.9122044033704811,0.08779559662951888,1539,84,179,1276,933,606,0.05458089668615984,0.11630929174788823,0.8291098115659519,0.6062378167641326,0.3937621832358674
1238,3157,2543,614,2741,416,0.8055115616091226,0.19448843839087743,0.8682293316439658,0.1317706683560342,1733,184,146,1403,1106,627,0.10617426428159261,0.08424697057126371,0.8095787651471437,0.638199653779573,0.361800346220427
1239,8159,7105,1054,6343,1816,0.8708175021448707,0.1291824978551293,0.77742370388528,0.22257629611471993,2646,245,599,1802,1865,781,0.09259259259259259,0.22637944066515495,0.6810279667422524,0.7048374905517762,0.29516250944822375
1240,138,72,66,75,63,0.5217391304347826,0.4782608695652174,0.5434782608695652,0.45652173913043476,152,8,37,107,87,65,0.05263157894736842,0.24342105263157895,0.7039473684210527,0.5723684210526315,0.4276315789473684
1241,1085,747,338,898,187,0.688479262672811,0.31152073732718893,0.8276497695852535,0.17235023041474654,895,50,130,715,628,267,0.055865921787709494,0.1452513966480447,0.7988826815642458,0.7016759776536313,0.29832402234636873
1242,9447,7437,2010,7201,2246,0.7872340425531915,0.2127659574468085,0.7622525669524717,0.23774743304752832,4219,160,342,3717,2392,1827,0.03792367859682389,0.08106186300071107,0.8810144584024651,0.5669589950225172,0.4330410049774828
1243,3367,2581,786,2491,876,0.7665577665577665,0.23344223344223344,0.7398277398277399,0.2601722601722602,2540,26,195,2319,1428,1112,0.010236220472440945,0.07677165354330709,0.912992125984252,0.5622047244094488,0.4377952755905512
1244,9668,8122,1546,7769,1899,0.8400910219280099,0.15990897807199006,0.8035788167149359,0.19642118328506414,4714,257,712,3745,2770,1944,0.054518455663979636,0.15103945693678406,0.7944420873992363,0.587611370386084,0.412388629613916
1245,10849,8760,2089,8819,2030,0.8074476910314314,0.19255230896856854,0.8128859802746797,0.1871140197253203,3392,224,425,2743,2064,1328,0.0660377358490566,0.1252948113207547,0.8086674528301887,0.6084905660377359,0.3915094339622642
1246,1334,1224,110,841,493,0.9175412293853074,0.08245877061469266,0.6304347826086957,0.3695652173913043,221,4,94,123,180,41,0.01809954751131222,0.4253393665158371,0.5565610859728507,0.8144796380090498,0.18552036199095023
1247,21280,19998,1282,19160,2120,0.9397556390977444,0.06024436090225564,0.900375939849624,0.09962406015037593,5589,52,231,5306,1969,3620,0.009303989980318483,0.041331186258722494,0.949364823760959,0.3522991590624441,0.6477008409375559
1248,5426,4609,817,4520,906,0.8494286767416145,0.15057132325838554,0.8330261702911905,0.16697382970880945,1074,129,312,633,878,196,0.12011173184357542,0.2905027932960894,0.5893854748603352,0.8175046554934823,0.1824953445065177
1249,12424,10775,1649,10193,2231,0.8672730199613651,0.1327269800386349,0.8204282034771411,0.17957179652285898,4192,169,676,3347,2834,1358,0.04031488549618321,0.16125954198473283,0.798425572519084,0.6760496183206107,0.32395038167938933
1250,1050,958,92,654,396,0.9123809523809524,0.08761904761904762,0.6228571428571429,0.37714285714285717,216,8,98,110,175,41,0.037037037037037035,0.4537037037037037,0.5092592592592593,0.8101851851851852,0.18981481481481483
1251,405,335,70,310,95,0.8271604938271605,0.1728395061728395,0.7654320987654321,0.2345679012345679,108,3,27,78,97,11,0.027777777777777776,0.25,0.7222222222222222,0.8981481481481481,0.10185185185185185
1252,2058,1530,528,1405,653,0.7434402332361516,0.2565597667638484,0.6827016520894071,0.3172983479105928,3577,106,221,3250,2052,1525,0.029633771316745876,0.061783617556611686,0.9085826111266424,0.5736650824713447,0.4263349175286553
1253,499,414,85,381,118,0.8296593186372746,0.17034068136272545,0.7635270541082164,0.23647294589178355,186,11,47,128,157,29,0.05913978494623656,0.25268817204301075,0.6881720430107527,0.8440860215053764,0.15591397849462366
1254,1722,1383,339,1481,241,0.8031358885017421,0.19686411149825783,0.8600464576074333,0.13995354239256677,614,58,159,397,491,123,0.09446254071661238,0.25895765472312704,0.6465798045602605,0.7996742671009772,0.2003257328990228
1255,8066,6155,1911,5917,2149,0.7630795933548227,0.2369204066451773,0.7335730225638483,0.26642697743615174,1166,140,249,777,726,440,0.12006861063464837,0.21355060034305318,0.6663807890222985,0.6226415094339622,0.37735849056603776
1256,3094,2465,629,2912,182,0.7967032967032966,0.2032967032967033,0.9411764705882353,0.058823529411764705,4036,35,229,3772,2638,1398,0.00867195242814668,0.056739345887016845,0.9345887016848364,0.653617443012884,0.34638255698711595
1257,34322,27181,7141,26866,7456,0.7919410290775596,0.2080589709224404,0.782763242235301,0.21723675776469903,8059,220,856,6983,3743,4316,0.027298672291847625,0.10621665219009803,0.8664846755180543,0.46444968358357114,0.5355503164164288
1258,34321,27181,7140,26866,7455,0.7919641036100347,0.20803589638996534,0.7827860493575362,0.2172139506424638,8058,218,855,6985,3743,4315,0.02705385951849094,0.10610573343261355,0.8668404070488955,0.4645073219161082,0.5354926780838918
1259,7167,5831,1336,5557,1610,0.8135900655783452,0.1864099344216548,0.7753592856146225,0.22464071438537742,8457,84,295,8078,5659,2798,0.009932600212841433,0.03488234598557408,0.9551850538015845,0.669149816719877,0.330850183280123
1260,1070,976,94,656,414,0.9121495327102803,0.08785046728971962,0.6130841121495327,0.38691588785046727,199,4,91,104,160,39,0.020100502512562814,0.457286432160804,0.5226130653266332,0.8040201005025126,0.19597989949748743
1261,1865,1318,547,1303,562,0.7067024128686327,0.2932975871313673,0.6986595174262734,0.30134048257372653,811,63,147,601,417,394,0.07768187422934648,0.1812577065351418,0.7410604192355117,0.5141800246609125,0.48581997533908755
1262,981,888,93,611,370,0.9051987767584098,0.09480122324159021,0.6228338430173292,0.37716615698267075,188,4,87,97,149,39,0.02127659574468085,0.4627659574468085,0.5159574468085106,0.7925531914893617,0.2074468085106383
1263,2464,2041,423,2049,415,0.828327922077922,0.17167207792207792,0.8315746753246753,0.16842532467532467,897,89,162,646,777,120,0.09921962095875139,0.1806020066889632,0.7201783723522854,0.8662207357859532,0.13377926421404682
1264,5260,4405,855,4318,942,0.8374524714828897,0.16254752851711027,0.8209125475285171,0.1790874524714829,1826,127,217,1482,1082,744,0.06955093099671412,0.11883899233296824,0.8116100766703176,0.592552026286966,0.40744797371303393
1265,3013,2493,520,2533,480,0.827414537006306,0.17258546299369398,0.8406903418519748,0.15930965814802522,847,96,195,556,721,126,0.11334120425029516,0.23022432113341204,0.6564344746162928,0.8512396694214877,0.1487603305785124
1266,26589,21361,5228,21122,5467,0.8033773364925345,0.1966226635074655,0.7943886569634059,0.2056113430365941,20291,175,613,19503,9826,10465,0.008624513331033463,0.030210438125277215,0.9611650485436893,0.4842541028041989,0.5157458971958011
1267,12334,10919,1415,10570,1764,0.8852764715420788,0.11472352845792119,0.8569807037457434,0.14301929625425652,1906,160,373,1373,1319,587,0.08394543546694648,0.195697796432319,0.7203567681007346,0.6920251836306401,0.3079748163693599
1268,6102,5432,670,5016,1086,0.890199934447722,0.10980006555227795,0.8220255653883972,0.17797443461160276,1737,11,123,1603,780,957,0.0063327576280944155,0.07081174438687392,0.9228554979850316,0.44905008635578586,0.5509499136442142
1269,2934,1943,991,2530,404,0.6622358554873893,0.3377641445126108,0.8623040218132243,0.13769597818677573,2747,17,148,2582,1374,1373,0.006188569348380051,0.05387695668001456,0.9399344739716053,0.5001820167455406,0.4998179832544594
1270,35,16,19,14,21,0.45714285714285713,0.5428571428571428,0.4,0.6,65,3,23,39,41,24,0.046153846153846156,0.35384615384615387,0.6,0.6307692307692307,0.36923076923076925
1271,26257,21575,4682,20902,5355,0.8216856457325665,0.17831435426743344,0.7960543854972008,0.20394561450279924,9143,23,948,8172,4407,4736,0.0025155856939735317,0.10368587990812643,0.8937985343979,0.48200809362353714,0.5179919063764629
1272,15691,12867,2824,12651,3040,0.8200242177044166,0.17997578229558345,0.8062583646676439,0.19374163533235614,13451,331,724,12396,5738,7713,0.024607835848635788,0.05382499442420638,0.9215671697271578,0.42658538398632073,0.5734146160136793
1273,8363,7054,1309,6890,1473,0.8434772210929092,0.15652277890709076,0.823867033361234,0.176132966638766,2172,126,322,1724,1417,755,0.058011049723756904,0.14825046040515655,0.7937384898710865,0.6523941068139963,0.34760589318600366
1274,13107,11009,2098,9784,3323,0.8399328603036545,0.16006713969634545,0.746471351186389,0.25352864881361103,8178,159,873,7146,4600,3578,0.019442406456346296,0.10674981658107116,0.8738077769625825,0.5624847150892639,0.4375152849107361
1275,4185,3017,1168,3518,667,0.7209080047789725,0.27909199522102746,0.8406212664277181,0.15937873357228197,2330,84,272,1974,1589,741,0.036051502145922745,0.1167381974248927,0.8472103004291845,0.6819742489270386,0.3180257510729614
1276,625,506,119,537,88,0.8096,0.1904,0.8592,0.1408,255,39,81,135,238,17,0.15294117647058825,0.3176470588235294,0.5294117647058824,0.9333333333333333,0.06666666666666667
1277,4025,3215,810,3250,775,0.7987577639751553,0.20124223602484473,0.8074534161490683,0.19254658385093168,2128,112,291,1725,1450,678,0.05263157894736842,0.13674812030075187,0.8106203007518797,0.681390977443609,0.31860902255639095
1278,3643,3118,525,3029,614,0.8558880043919846,0.14411199560801538,0.8314575898984353,0.16854241010156465,1246,92,338,816,1002,244,0.0738362760834671,0.2712680577849117,0.6548956661316212,0.8041733547351525,0.1958266452648475
1279,29153,24222,4931,23813,5340,0.8308578876959489,0.16914211230405105,0.8168284567625973,0.18317154323740267,19319,680,1481,17158,10563,8756,0.035198509239608676,0.0766602826233242,0.8881412081370671,0.5467674310264506,0.45323256897354935
1280,6139,4889,1250,4929,1210,0.7963837758592605,0.20361622414073954,0.8028994950317642,0.19710050496823586,3190,278,357,2555,1930,1260,0.0871473354231975,0.11191222570532916,0.8009404388714734,0.6050156739811913,0.3949843260188088
1281,17940,15530,2410,15854,2086,0.8656633221850614,0.1343366778149387,0.8837235228539576,0.11627647714604236,7825,578,1609,5638,6520,1305,0.07386581469648562,0.2056230031948882,0.7205111821086262,0.8332268370607029,0.16677316293929711
1282,4864,3925,939,3010,1854,0.8069490131578947,0.19305098684210525,0.6188322368421053,0.38116776315789475,2454,355,685,1414,1717,737,0.14466177669111654,0.2791361043194784,0.5762021189894051,0.6996740016299918,0.3003259983700082
1283,126,58,68,88,38,0.4603174603174603,0.5396825396825397,0.6984126984126984,0.30158730158730157,163,11,37,115,56,107,0.06748466257668712,0.22699386503067484,0.7055214723926381,0.34355828220858897,0.656441717791411
1284,1666,1275,391,1217,449,0.7653061224489796,0.23469387755102042,0.7304921968787516,0.2695078031212485,863,69,153,641,394,469,0.07995365005793743,0.1772885283893395,0.7427578215527231,0.45654692931633833,0.5434530706836617
1285,941,751,190,811,130,0.798087141339001,0.20191285866099895,0.8618490967056323,0.1381509032943677,355,43,123,189,334,21,0.12112676056338029,0.3464788732394366,0.532394366197183,0.9408450704225352,0.059154929577464786
1286,1479,1179,300,1207,272,0.7971602434077079,0.2028397565922921,0.8160919540229885,0.1839080459770115,548,85,136,327,433,115,0.1551094890510949,0.24817518248175183,0.5967153284671532,0.7901459854014599,0.20985401459854014
1287,8708,7088,1620,7096,1612,0.8139641708773542,0.18603582912264585,0.8148828663298117,0.18511713367018834,2819,137,472,2210,888,1931,0.048598793898545586,0.1674352607307556,0.7839659453706989,0.3150053210358283,0.6849946789641717
1288,6139,4889,1250,4929,1210,0.7963837758592605,0.20361622414073954,0.8028994950317642,0.19710050496823586,3190,278,357,2555,1930,1260,0.0871473354231975,0.11191222570532916,0.8009404388714734,0.6050156739811913,0.3949843260188088
1289,5461,3893,1568,3875,1586,0.712873100164805,0.287126899835195,0.7095770005493499,0.2904229994506501,4283,32,651,3600,2006,2277,0.007471398552416531,0.1519962643007238,0.8405323371468597,0.46836329675461125,0.5316367032453887
1290,1654,1127,527,1636,18,0.6813784764207981,0.3186215235792019,0.9891172914147521,0.010882708585247884,3746,5,226,3515,2930,816,0.0013347570742124934,0.0603310197544047,0.9383342231713828,0.7821676454885211,0.21783235451147892
1291,7461,5942,1519,5734,1727,0.7964079882053344,0.2035920117946656,0.7685296877094223,0.23147031229057768,9021,80,300,8641,5677,3344,0.008868196430550937,0.03325573661456601,0.957876066954883,0.6293093892029709,0.37069061079702914
1292,1502,1248,254,1260,242,0.8308921438082557,0.16910785619174434,0.8388814913448736,0.1611185086551265,1341,120,465,756,976,365,0.0894854586129754,0.34675615212527966,0.5637583892617449,0.7278150633855331,0.2721849366144668
1293,3122,2368,754,2198,924,0.7584881486226778,0.24151185137732223,0.7040358744394619,0.29596412556053814,1283,27,175,1081,805,478,0.021044427123928292,0.1363990646921278,0.8425565081839439,0.627435697583788,0.372564302416212
1294,3405,2738,667,2627,778,0.8041116005873715,0.19588839941262848,0.7715124816446403,0.22848751835535977,1249,46,352,851,960,289,0.03682946357085669,0.28182546036829464,0.6813450760608487,0.7686148919135308,0.23138510808646917
1295,30564,24147,6417,26717,3847,0.7900471142520612,0.20995288574793874,0.8741329668891507,0.12586703311084937,16527,262,1029,15236,8894,7633,0.0158528468566588,0.062261753494282084,0.9218853996490591,0.5381496944394022,0.4618503055605978
1296,944,856,88,591,353,0.9067796610169492,0.09322033898305085,0.6260593220338984,0.3739406779661017,176,4,80,92,136,40,0.022727272727272728,0.45454545454545453,0.5227272727272727,0.7727272727272727,0.22727272727272727
1297,2392,1840,552,2012,380,0.7692307692307693,0.23076923076923078,0.8411371237458194,0.1588628762541806,1953,59,163,1731,1047,906,0.030209933435739886,0.08346134152585766,0.8863287250384024,0.5360983102918587,0.46390168970814133
1298,1062,746,316,685,377,0.7024482109227872,0.2975517890772128,0.6450094161958568,0.3549905838041431,770,16,148,606,356,414,0.02077922077922078,0.19220779220779222,0.787012987012987,0.4623376623376623,0.5376623376623376
1299,1926,1623,303,1672,254,0.8426791277258567,0.1573208722741433,0.8681204569055037,0.13187954309449637,868,45,128,695,608,260,0.05184331797235023,0.14746543778801843,0.8006912442396313,0.7004608294930875,0.2995391705069124
1300,3165,2535,630,2533,632,0.8009478672985783,0.1990521327014218,0.8003159557661927,0.19968404423380726,1192,51,180,961,816,376,0.04278523489932886,0.15100671140939598,0.8062080536912751,0.6845637583892618,0.31543624161073824
1301,13411,10151,3260,10132,3279,0.7569159645067481,0.2430840354932518,0.7554992170606218,0.24450078293937813,3744,263,547,2934,2170,1574,0.0702457264957265,0.14610042735042736,0.7836538461538461,0.5795940170940171,0.4204059829059829
1302,5040,3951,1089,4175,865,0.7839285714285714,0.21607142857142858,0.8283730158730159,0.17162698412698413,2751,161,326,2264,1849,902,0.058524173027989825,0.11850236277717194,0.8229734641948382,0.6721192293711378,0.32788077062886223
1303,6307,4737,1570,5389,918,0.7510702394165213,0.24892976058347868,0.8544474393530997,0.14555256064690028,3888,90,236,3562,2307,1581,0.023148148148148147,0.060699588477366256,0.9161522633744856,0.5933641975308642,0.4066358024691358
1304,3579,2835,744,3002,577,0.7921207041072925,0.20787929589270746,0.8387817826208438,0.16121821737915618,1079,12,293,774,751,328,0.011121408711770158,0.2715477293790547,0.7173308619091752,0.696014828544949,0.303985171455051
1305,825,703,122,693,132,0.8521212121212122,0.1478787878787879,0.84,0.16,347,14,171,162,322,25,0.040345821325648415,0.49279538904899134,0.4668587896253602,0.9279538904899135,0.07204610951008646
1306,6128,5158,970,5026,1102,0.841710182767624,0.15828981723237598,0.8201697127937336,0.17983028720626631,4386,115,356,3915,3084,1302,0.026219790241678066,0.08116735066119471,0.8926128590971272,0.7031463748290013,0.2968536251709986
1307,5741,4552,1189,4604,1137,0.7928932241769726,0.20710677582302733,0.8019508796376937,0.1980491203623062,2880,86,293,2501,2437,443,0.029861111111111113,0.10173611111111111,0.8684027777777777,0.8461805555555556,0.15381944444444445
1308,6610,4741,1869,5305,1305,0.7172465960665658,0.2827534039334342,0.802571860816944,0.197428139183056,5437,2616,371,2450,4480,957,0.48114769174176936,0.06823615964686408,0.45061614861136656,0.8239838146036417,0.1760161853963583
1309,4771,3752,1019,3845,926,0.7864179417312932,0.21358205826870677,0.8059107105428631,0.19408928945713688,2060,82,269,1709,1186,874,0.039805825242718446,0.13058252427184466,0.829611650485437,0.5757281553398058,0.4242718446601942
1310,20932,18421,2511,17970,2962,0.8800401299445825,0.11995987005541754,0.8584941716032868,0.14150582839671316,5124,143,529,4452,2842,2282,0.027907884465261514,0.10323965651834505,0.8688524590163934,0.5546448087431693,0.4453551912568306
1311,2629,2024,605,2005,624,0.7698744769874477,0.2301255230125523,0.7626473944465576,0.23735260555344237,721,12,94,615,389,332,0.016643550624133148,0.130374479889043,0.8529819694868238,0.5395284327323162,0.4604715672676838
1312,393,290,103,346,47,0.7379134860050891,0.26208651399491095,0.8804071246819338,0.11959287531806616,496,19,153,324,374,122,0.038306451612903226,0.3084677419354839,0.6532258064516129,0.7540322580645161,0.24596774193548387
1313,53,39,14,34,19,0.7358490566037735,0.2641509433962264,0.6415094339622641,0.3584905660377358,59,2,26,31,57,2,0.03389830508474576,0.4406779661016949,0.5254237288135594,0.9661016949152542,0.03389830508474576
1314,22946,19080,3866,18448,4498,0.8315174758127778,0.16848252418722218,0.8039745489409919,0.1960254510590081,6193,588,484,5121,3042,3151,0.09494590666881964,0.07815275310834814,0.8269013402228322,0.4911997416437914,0.5088002583562086
1315,5139,4169,970,4099,1040,0.8112473243821755,0.18875267561782447,0.7976259972757346,0.20237400272426542,1864,121,267,1476,1240,624,0.06491416309012875,0.1432403433476395,0.7918454935622318,0.6652360515021459,0.33476394849785407
1316,256,204,52,218,38,0.796875,0.203125,0.8515625,0.1484375,118,7,28,83,92,26,0.059322033898305086,0.23728813559322035,0.7033898305084746,0.7796610169491526,0.22033898305084745
1317,6082,4950,1132,4972,1110,0.8138770141400855,0.1861229858599145,0.8174942453140415,0.18250575468595856,1986,205,359,1422,1386,600,0.10322255790533737,0.18076535750251763,0.716012084592145,0.6978851963746223,0.3021148036253776
1318,258,205,53,181,77,0.7945736434108527,0.2054263565891473,0.7015503875968992,0.29844961240310075,457,32,38,387,111,346,0.0700218818380744,0.08315098468271334,0.8468271334792122,0.24288840262582057,0.7571115973741794
1319,7272,5913,1359,5984,1288,0.8131188118811881,0.18688118811881188,0.8228822882288229,0.1771177117711771,2834,214,351,2269,1761,1073,0.07551164431898377,0.12385321100917432,0.8006351446718419,0.6213832039520113,0.3786167960479887
1320,1972,1593,379,1582,390,0.8078093306288032,0.19219066937119675,0.8022312373225152,0.19776876267748478,783,56,217,510,609,174,0.07151979565772669,0.2771392081736909,0.6513409961685823,0.7777777777777778,0.2222222222222222
1321,4316,3344,972,3562,754,0.7747914735866543,0.22520852641334568,0.8253012048192772,0.1746987951807229,2304,87,203,2014,1095,1209,0.037760416666666664,0.0881076388888889,0.8741319444444444,0.4752604166666667,0.5247395833333334
1322,5472,4540,932,4568,904,0.8296783625730995,0.1703216374269006,0.8347953216374269,0.1652046783625731,5151,286,297,4568,3062,2089,0.055523199378761406,0.05765870704717531,0.8868180935740633,0.5944476800621239,0.40555231993787616
1323,1024,842,182,870,154,0.822265625,0.177734375,0.849609375,0.150390625,421,44,111,266,338,83,0.10451306413301663,0.26365795724465557,0.6318289786223278,0.8028503562945368,0.19714964370546317
1324,1404,1013,391,1038,366,0.7215099715099715,0.27849002849002846,0.7393162393162394,0.2606837606837607,1128,4,254,870,768,360,0.0035460992907801418,0.225177304964539,0.7712765957446809,0.6808510638297872,0.3191489361702128
1325,1164,1079,85,1004,160,0.9269759450171822,0.07302405498281787,0.8625429553264605,0.13745704467353953,459,30,82,347,418,41,0.06535947712418301,0.1786492374727669,0.7559912854030502,0.9106753812636166,0.08932461873638345
1326,42694,36109,6585,35360,7334,0.8457628706609828,0.1542371293390172,0.8282194219328243,0.17178057806717573,19469,767,1854,16848,11032,8437,0.039395962812676565,0.09522831167497046,0.865375725512353,0.5666444090605578,0.4333555909394422
1327,1130,628,502,958,172,0.5557522123893806,0.44424778761061945,0.8477876106194691,0.15221238938053097,891,11,78,802,666,225,0.012345679012345678,0.08754208754208755,0.9001122334455668,0.7474747474747475,0.25252525252525254
1328,12452,10497,1955,9817,2635,0.8429971088981689,0.15700289110183102,0.7883874076453582,0.21161259235464183,17715,187,913,16615,10658,7057,0.010556025966694891,0.051538244425628,0.9379057296076772,0.6016370307648885,0.3983629692351115
1329,5269,4310,959,4116,1153,0.8179920288479787,0.18200797115202125,0.7811728980831277,0.21882710191687227,1643,79,294,1270,817,826,0.04808277541083384,0.1789409616555082,0.772976262933658,0.4972611077297626,0.5027388922702374
1330,2110,1438,672,1648,462,0.6815165876777252,0.3184834123222749,0.781042654028436,0.218957345971564,1868,868,131,869,1470,398,0.46466809421841543,0.07012847965738758,0.465203426124197,0.7869379014989293,0.21306209850107066
1331,814,561,253,477,337,0.6891891891891891,0.3108108108108108,0.585995085995086,0.414004914004914,374,42,88,244,240,134,0.11229946524064172,0.23529411764705882,0.6524064171122995,0.6417112299465241,0.3582887700534759
1332,889,717,172,656,233,0.8065241844769404,0.19347581552305962,0.7379077615298087,0.26209223847019125,154,1,31,122,100,54,0.006493506493506494,0.2012987012987013,0.7922077922077922,0.6493506493506493,0.35064935064935066
1333,21280,19998,1282,19160,2120,0.9397556390977444,0.06024436090225564,0.900375939849624,0.09962406015037593,5589,52,231,5306,1968,3621,0.009303989980318483,0.041331186258722494,0.949364823760959,0.3521202361782072,0.6478797638217928
1334,926,837,89,574,352,0.9038876889848813,0.09611231101511879,0.6198704103671706,0.3801295896328294,173,4,75,94,132,41,0.023121387283236993,0.43352601156069365,0.5433526011560693,0.7630057803468208,0.23699421965317918
1335,921,746,175,840,81,0.8099891422366993,0.19001085776330076,0.9120521172638436,0.08794788273615635,441,7,47,387,236,205,0.015873015873015872,0.10657596371882086,0.8775510204081632,0.5351473922902494,0.46485260770975056
1336,5266,3782,1484,4231,1035,0.7181921762248386,0.2818078237751614,0.8034561336878085,0.19654386631219142,3677,855,697,2125,2721,956,0.23252651618166983,0.18955670383464782,0.5779167799836824,0.7400054392167528,0.25999456078324723
1337,4867,3928,939,3011,1856,0.8070680090404767,0.19293199095952332,0.6186562564207931,0.3813437435792069,2454,355,686,1413,1717,737,0.14466177669111654,0.2795436022819886,0.5757946210268948,0.6996740016299918,0.3003259983700082
1338,138,97,41,87,51,0.7028985507246377,0.2971014492753623,0.6304347826086957,0.3695652173913043,129,5,35,89,85,44,0.03875968992248062,0.2713178294573643,0.689922480620155,0.6589147286821705,0.34108527131782945
1339,1743,1398,345,1378,365,0.802065404475043,0.19793459552495696,0.7905909351692484,0.20940906483075158,278,21,56,201,197,81,0.07553956834532374,0.2014388489208633,0.7230215827338129,0.7086330935251799,0.29136690647482016
1340,964,871,93,601,363,0.9035269709543569,0.09647302904564316,0.6234439834024896,0.37655601659751037,190,4,91,95,151,39,0.021052631578947368,0.4789473684210526,0.5,0.7947368421052632,0.20526315789473684
1341,10426,8009,2417,7459,2967,0.7681757145597544,0.23182428544024555,0.7154229810090159,0.2845770189909841,5484,184,396,4904,2986,2498,0.03355215171407731,0.07221006564551423,0.8942377826404084,0.5444930707512764,0.45550692924872355
1342,2751,1907,844,2241,510,0.693202471828426,0.30679752817157396,0.8146128680479825,0.18538713195201745,2103,922,165,1016,1687,416,0.43842130290061815,0.07845934379457917,0.48311935330480266,0.802187351402758,0.19781264859724204
1343,15753,12614,3139,13701,2052,0.8007363676759982,0.19926363232400177,0.8697390973147971,0.13026090268520282,5724,169,470,5085,4467,1257,0.02952480782669462,0.08211041229909155,0.8883647798742138,0.7803983228511531,0.21960167714884696
1344,10214,7949,2265,8434,1780,0.7782455453299393,0.2217544546700607,0.825729391031917,0.17427060896808302,4197,102,550,3545,2037,2160,0.024303073624017155,0.1310459852275435,0.8446509411484394,0.4853466761972838,0.5146533238027162
1345,6139,4889,1250,4929,1210,0.7963837758592605,0.20361622414073954,0.8028994950317642,0.19710050496823586,3190,278,357,2555,1930,1260,0.0871473354231975,0.11191222570532916,0.8009404388714734,0.6050156739811913,0.3949843260188088
1346,2644,2117,527,2277,367,0.8006807866868382,0.19931921331316188,0.8611951588502269,0.13880484114977307,874,57,187,630,678,196,0.06521739130434782,0.2139588100686499,0.7208237986270023,0.7757437070938215,0.2242562929061785
1347,1762,1638,124,1083,679,0.9296254256526674,0.07037457434733257,0.6146424517593644,0.3853575482406356,455,31,210,214,314,141,0.06813186813186813,0.46153846153846156,0.4703296703296703,0.6901098901098901,0.3098901098901099
1348,17699,14825,2874,13528,4171,0.8376179445166394,0.16238205548336065,0.7643369681902933,0.23566303180970677,11418,335,508,10575,5676,5742,0.02933963916622876,0.04449115431774391,0.9261692065160273,0.49710982658959535,0.5028901734104047
1349,0,0,0,0,0,0.0,0.0,0.0,0.0,0,0,0,0,0,0,0.0,0.0,0.0,0.0,0.0
1350,542,472,70,461,81,0.8708487084870848,0.12915129151291513,0.8505535055350554,0.14944649446494465,409,28,58,323,347,62,0.06845965770171149,0.14180929095354522,0.7897310513447433,0.8484107579462102,0.15158924205378974
1351,4298,3528,770,3390,908,0.8208469055374593,0.1791530944625407,0.7887389483480689,0.21126105165193113,2256,50,153,2053,1403,853,0.022163120567375887,0.0678191489361702,0.9100177304964538,0.6218971631205674,0.37810283687943264
1352,1058,721,337,951,107,0.6814744801512287,0.31852551984877125,0.8988657844990549,0.10113421550094517,1175,86,307,782,852,323,0.07319148936170213,0.2612765957446809,0.6655319148936171,0.7251063829787234,0.27489361702127657
1353,21110,17958,3152,17103,4007,0.8506868782567504,0.14931312174324965,0.8101847465656087,0.1898152534343913,8524,633,437,7454,3138,5386,0.07426091037071797,0.0512670107930549,0.8744720788362271,0.3681370248709526,0.6318629751290474
1354,580,384,196,367,213,0.6620689655172414,0.33793103448275863,0.6327586206896552,0.36724137931034484,427,5,66,356,216,211,0.0117096018735363,0.15456674473067916,0.8337236533957846,0.5058548009367682,0.49414519906323184
1355,4033,3459,574,3679,354,0.8576741879494173,0.1423258120505827,0.9122241507562608,0.08777584924373916,1621,91,268,1262,1202,419,0.056138186304750155,0.16533004318322023,0.7785317705120296,0.7415175817396669,0.25848241826033314
1356,104,66,38,89,15,0.6346153846153846,0.36538461538461536,0.8557692307692307,0.14423076923076922,132,27,33,72,116,16,0.20454545454545456,0.25,0.5454545454545454,0.8787878787878788,0.12121212121212122
1357,4347,4075,272,2676,1671,0.9374281113411548,0.06257188865884518,0.6155969634230504,0.38440303657694963,3279,4,329,2946,3160,119,0.001219884111009454,0.1003354681305276,0.898444647758463,0.9637084476974688,0.03629155230253126
1358,250,193,57,193,57,0.772,0.228,0.772,0.228,262,28,105,129,227,35,0.10687022900763359,0.40076335877862596,0.49236641221374045,0.8664122137404581,0.13358778625954199
1359,4071,2882,1189,3396,675,0.7079341685089658,0.29206583149103416,0.8341930729550479,0.1658069270449521,3547,1373,381,1793,2902,645,0.38708767972934877,0.10741471666196786,0.5054976036086833,0.8181561883281646,0.18184381167183536
1360,4608,3568,1040,3704,904,0.7743055555555556,0.22569444444444445,0.8038194444444444,0.19618055555555555,2218,35,218,1965,1119,1099,0.015779981965734897,0.09828674481514878,0.8859332732191163,0.5045085662759242,0.4954914337240757
1361,2751,1907,844,2241,510,0.693202471828426,0.30679752817157396,0.8146128680479825,0.18538713195201745,2103,922,165,1016,1687,416,0.43842130290061815,0.07845934379457917,0.48311935330480266,0.802187351402758,0.19781264859724204
1362,2327,1888,439,1871,456,0.811345079501504,0.18865492049849591,0.8040395358831113,0.1959604641168887,1341,17,105,1219,813,528,0.01267710663683818,0.07829977628635347,0.9090231170768084,0.6062639821029083,0.39373601789709173
1363,1489,963,526,1243,246,0.6467427803895232,0.35325721961047685,0.8347884486232371,0.16521155137676294,961,70,172,719,822,139,0.07284079084287201,0.17898022892819979,0.7481789802289281,0.8553590010405827,0.14464099895941726
1364,3580,2791,789,2833,747,0.779608938547486,0.22039106145251397,0.791340782122905,0.20865921787709496,1298,75,253,970,904,394,0.05778120184899846,0.19491525423728814,0.7473035439137135,0.6964560862865947,0.3035439137134052
1365,1695,1347,348,1377,318,0.7946902654867256,0.20530973451327433,0.8123893805309734,0.18761061946902655,684,84,168,432,500,184,0.12280701754385964,0.24561403508771928,0.631578947368421,0.7309941520467836,0.26900584795321636
1366,996,908,88,618,378,0.9116465863453815,0.08835341365461848,0.6204819277108434,0.3795180722891566,183,4,83,96,144,39,0.02185792349726776,0.453551912568306,0.5245901639344263,0.7868852459016393,0.21311475409836064
1367,1455,1217,238,976,479,0.836426116838488,0.16357388316151203,0.6707903780068728,0.32920962199312714,362,27,74,261,263,99,0.07458563535911603,0.20441988950276244,0.7209944751381215,0.7265193370165746,0.27348066298342544
1368,427,286,141,346,81,0.6697892271662763,0.33021077283372363,0.810304449648712,0.18969555035128804,534,38,88,408,339,195,0.07116104868913857,0.1647940074906367,0.7640449438202247,0.6348314606741573,0.3651685393258427
1369,225,143,82,190,35,0.6355555555555555,0.36444444444444446,0.8444444444444444,0.15555555555555556,260,36,79,145,235,25,0.13846153846153847,0.3038461538461538,0.5576923076923077,0.9038461538461539,0.09615384615384616
1370,19906,15928,3978,14942,4964,0.8001607555510901,0.19983924444890988,0.7506279513714458,0.2493720486285542,9496,411,1789,7296,7691,1805,0.04328138163437237,0.18839511373209772,0.7683235046335299,0.8099199663016007,0.19008003369839932
1371,824,690,134,674,150,0.837378640776699,0.16262135922330098,0.8179611650485437,0.1820388349514563,640,33,69,538,357,283,0.0515625,0.1078125,0.840625,0.5578125,0.4421875
1372,4003,3224,779,3528,475,0.8053959530352236,0.19460404696477643,0.8813389957531851,0.11866100424681489,3040,178,221,2641,1851,1189,0.05855263157894737,0.07269736842105264,0.86875,0.6088815789473684,0.39111842105263156
1373,2519,1945,574,2170,349,0.7721317983326716,0.2278682016673283,0.8614529575228265,0.13854704247717348,1676,21,153,1502,994,682,0.012529832935560859,0.09128878281622911,0.89618138424821,0.5930787589498807,0.40692124105011934
1374,5163,4321,842,3104,2059,0.8369165214022855,0.16308347859771452,0.6012008522177029,0.39879914778229714,1188,82,268,838,957,231,0.06902356902356903,0.2255892255892256,0.7053872053872053,0.8055555555555556,0.19444444444444445
1375,5073,4133,940,3633,1440,0.8147053025822985,0.18529469741770155,0.7161442933175636,0.2838557066824364,1817,21,277,1519,842,975,0.011557512383048982,0.15244909190974132,0.8359933957072097,0.4634012107870116,0.5365987892129884
1376,1654,1127,527,1636,18,0.6813784764207981,0.3186215235792019,0.9891172914147521,0.010882708585247884,3746,5,226,3515,2930,816,0.0013347570742124934,0.0603310197544047,0.9383342231713828,0.7821676454885211,0.21783235451147892
1377,951,866,85,591,360,0.9106203995793901,0.08937960042060988,0.6214511041009464,0.3785488958990536,174,4,78,92,135,39,0.022988505747126436,0.4482758620689655,0.5287356321839081,0.7758620689655172,0.22413793103448276
1378,12656,11151,1505,10162,2494,0.8810840707964602,0.11891592920353983,0.8029393173198482,0.1970606826801517,4184,173,687,3324,2816,1368,0.041347992351816444,0.16419694072657745,0.7944550669216062,0.6730401529636711,0.32695984703632885
1379,1168,961,207,981,187,0.8227739726027398,0.17722602739726026,0.8398972602739726,0.1601027397260274,506,46,149,311,396,110,0.09090909090909091,0.29446640316205536,0.6146245059288538,0.782608695652174,0.21739130434782608
1380,2166,1564,602,1451,715,0.7220683287165282,0.27793167128347185,0.669898430286242,0.3301015697137581,2895,70,101,2724,1693,1202,0.024179620034542316,0.034887737478411056,0.9409326424870467,0.5848013816925735,0.4151986183074266
1381,2812,2235,577,2456,356,0.7948079658605974,0.20519203413940257,0.8733997155049786,0.12660028449502134,1269,106,176,987,910,359,0.08353033884948778,0.13869188337273444,0.7777777777777778,0.7171000788022065,0.28289992119779356
1382,9512,6979,2533,7793,1719,0.7337047939444912,0.2662952060555088,0.8192809083263246,0.18071909167367536,6649,42,416,6191,3356,3293,0.006316739359302151,0.06256579936832607,0.9311174612723718,0.5047375545194767,0.4952624454805234
1383,8934,7444,1490,7021,1913,0.8332214013879561,0.1667785986120439,0.785874188493396,0.21412581150660398,1536,48,201,1287,922,614,0.03125,0.130859375,0.837890625,0.6002604166666666,0.3997395833333333
1384,3739,2903,836,3346,393,0.7764108050280824,0.22358919497191762,0.8948916822679861,0.1051083177320139,3097,10,410,2677,1614,1483,0.0032289312237649337,0.1323861801743623,0.8643848886018728,0.5211494995156604,0.4788505004843397
1385,1593,1135,458,1065,528,0.7124921531701193,0.28750784682988073,0.6685499058380414,0.3314500941619586,461,35,109,317,280,181,0.07592190889370933,0.23644251626898047,0.6876355748373102,0.6073752711496746,0.3926247288503254
1386,236,165,71,154,82,0.6991525423728814,0.3008474576271186,0.652542372881356,0.3474576271186441,223,31,37,155,128,95,0.13901345291479822,0.16591928251121077,0.695067264573991,0.5739910313901345,0.4260089686098655
1387,4001,2667,1334,2681,1320,0.6665833541614596,0.33341664583854036,0.670082479380155,0.32991752061984503,905,39,144,722,590,315,0.0430939226519337,0.1591160220994475,0.7977900552486188,0.6519337016574586,0.34806629834254144
1388,74,35,39,60,14,0.47297297297297297,0.527027027027027,0.8108108108108109,0.1891891891891892,165,4,82,79,147,18,0.024242424242424242,0.49696969696969695,0.47878787878787876,0.8909090909090909,0.10909090909090909
1389,5535,4500,1035,4814,721,0.8130081300813008,0.18699186991869918,0.8697380307136404,0.13026196928635952,3876,79,337,3460,3155,721,0.02038183694530444,0.0869453044375645,0.8926728586171311,0.813983488132095,0.18601651186790505
1390,4275,3506,769,3604,671,0.8201169590643275,0.1798830409356725,0.8430409356725146,0.15695906432748538,1541,89,378,1074,1141,400,0.057754704737183644,0.24529526281635303,0.6969500324464634,0.7404282933160286,0.25957170668397145
1391,778,579,199,663,115,0.7442159383033419,0.25578406169665807,0.8521850899742931,0.14781491002570693,341,46,94,201,312,29,0.1348973607038123,0.2756598240469208,0.5894428152492669,0.9149560117302052,0.08504398826979472
1392,1018,930,88,639,379,0.9135559921414538,0.08644400785854617,0.6277013752455796,0.37229862475442044,207,4,86,117,163,44,0.01932367149758454,0.41545893719806765,0.5652173913043478,0.7874396135265701,0.21256038647342995
1393,659,518,141,568,91,0.7860394537177542,0.21396054628224584,0.8619119878603946,0.13808801213960548,302,37,92,173,274,28,0.12251655629139073,0.304635761589404,0.5728476821192053,0.9072847682119205,0.09271523178807947
1394,13463,11008,2455,9268,4195,0.8176483696055857,0.18235163039441432,0.6884052588576097,0.3115947411423903,6447,389,566,5492,4322,2125,0.060338141771366524,0.08779277183185978,0.8518690863967737,0.6703893283697844,0.3296106716302156
1395,7165,5830,1335,5555,1610,0.8136775994417307,0.18632240055826937,0.7752965806001396,0.22470341939986044,8457,84,295,8078,5659,2798,0.009932600212841433,0.03488234598557408,0.9551850538015845,0.669149816719877,0.330850183280123
1396,4636,3632,1004,3337,1299,0.7834339948231234,0.21656600517687663,0.7198015530629853,0.2801984469370147,2169,153,776,1240,1197,972,0.07053941908713693,0.3577685569386814,0.5716920239741816,0.5518672199170125,0.44813278008298757
1397,99,62,37,83,16,0.6262626262626263,0.37373737373737376,0.8383838383838383,0.16161616161616163,133,28,31,74,114,19,0.21052631578947367,0.23308270676691728,0.556390977443609,0.8571428571428571,0.14285714285714285
1398,3594,2657,937,2882,712,0.7392877017250974,0.2607122982749026,0.80189204229271,0.19810795770728992,5658,45,275,5338,2578,3080,0.007953340402969246,0.04860374690703429,0.9434429126899965,0.455638034641216,0.544361965358784
1399,599,409,190,471,128,0.6828046744574291,0.31719532554257096,0.7863105175292153,0.21368948247078465,518,43,92,383,337,181,0.08301158301158301,0.1776061776061776,0.7393822393822393,0.6505791505791506,0.34942084942084944
1400,10919,8617,2302,8136,2783,0.789174832860152,0.21082516713984797,0.745123179778368,0.254876820221632,3224,180,434,2610,1638,1586,0.05583126550868486,0.1346153846153846,0.8095533498759305,0.5080645161290323,0.49193548387096775
1401,1923,1792,131,1221,702,0.9318772750910036,0.06812272490899636,0.6349453978159126,0.36505460218408736,447,4,142,301,343,104,0.008948545861297539,0.31767337807606266,0.6733780760626398,0.767337807606264,0.232662192393736
1402,5369,4429,940,4517,852,0.8249208418699944,0.17507915813000557,0.8413112311417397,0.1586887688582604,3598,428,467,2703,1970,1628,0.11895497498610338,0.12979433018343525,0.7512506948304614,0.547526403557532,0.45247359644246804
1403,2415,2311,104,1655,760,0.9569358178053831,0.043064182194616975,0.6853002070393375,0.3146997929606625,200,4,84,112,157,43,0.02,0.42,0.56,0.785,0.215
1404,1822,1310,512,1531,291,0.7189901207464325,0.2810098792535675,0.8402854006586169,0.1597145993413831,1388,41,150,1197,833,555,0.029538904899135448,0.10806916426512968,0.8623919308357348,0.6001440922190202,0.39985590778097985
1405,140,63,77,67,73,0.45,0.55,0.4785714285714286,0.5214285714285715,159,4,52,103,97,62,0.025157232704402517,0.3270440251572327,0.6477987421383647,0.610062893081761,0.389937106918239
1406,5875,4538,1337,4066,1809,0.7724255319148936,0.2275744680851064,0.6920851063829787,0.3079148936170213,4211,47,265,3899,1033,3178,0.011161244360009499,0.06293042032771314,0.9259083353122773,0.24530990263595345,0.7546900973640466
1407,1795,1598,197,1438,357,0.89025069637883,0.10974930362116991,0.8011142061281337,0.1988857938718663,658,24,254,380,514,144,0.0364741641337386,0.3860182370820669,0.5775075987841946,0.7811550151975684,0.2188449848024316
1408,12132,9771,2361,9617,2515,0.8053907022749752,0.19460929772502472,0.7926969996702934,0.20730300032970655,5135,241,435,4459,2989,2146,0.04693281402142162,0.08471275559883155,0.8683544303797468,0.5820837390457644,0.4179162609542356
1409,1563,1234,329,1349,214,0.7895073576455535,0.2104926423544466,0.8630838131797824,0.13691618682021753,724,68,155,501,549,175,0.09392265193370165,0.21408839779005526,0.6919889502762431,0.7582872928176796,0.24171270718232044
1410,1196,1007,189,1030,166,0.8419732441471572,0.15802675585284282,0.8612040133779264,0.13879598662207357,343,52,115,176,315,28,0.15160349854227406,0.33527696793002915,0.5131195335276968,0.9183673469387755,0.08163265306122448
1411,2304,1824,480,1543,761,0.7916666666666666,0.20833333333333334,0.6697048611111112,0.3302951388888889,765,54,166,545,395,370,0.07058823529411765,0.2169934640522876,0.7124183006535948,0.5163398692810458,0.48366013071895425
1412,2832,2353,479,1876,956,0.830861581920904,0.16913841807909605,0.6624293785310734,0.3375706214689266,519,44,160,315,399,120,0.08477842003853564,0.30828516377649323,0.6069364161849711,0.7687861271676301,0.23121387283236994
1413,2524,1837,687,1750,774,0.7278129952456418,0.27218700475435814,0.6933438985736925,0.30665610142630745,806,16,111,679,493,313,0.019851116625310174,0.13771712158808933,0.8424317617866005,0.6116625310173698,0.3883374689826303
1414,9397,8263,1134,7677,1720,0.8793231882515696,0.12067681174843035,0.8169628604873896,0.18303713951261041,3521,165,562,2794,2207,1314,0.04686168702073275,0.15961374609485943,0.7935245668844079,0.6268105651803465,0.3731894348196535
1415,23,11,12,8,15,0.4782608695652174,0.5217391304347826,0.34782608695652173,0.6521739130434783,27,0,5,22,20,7,0.0,0.18518518518518517,0.8148148148148148,0.7407407407407407,0.25925925925925924
1416,1596,1078,518,1203,393,0.6754385964912281,0.32456140350877194,0.7537593984962406,0.2462406015037594,1410,45,169,1196,823,587,0.031914893617021274,0.1198581560283688,0.8482269503546099,0.5836879432624114,0.41631205673758864
1417,140,73,67,76,64,0.5214285714285715,0.4785714285714286,0.5428571428571428,0.45714285714285713,178,27,35,116,111,67,0.15168539325842698,0.19662921348314608,0.651685393258427,0.6235955056179775,0.37640449438202245
1418,4937,3668,1269,4316,621,0.7429613125379785,0.25703868746202146,0.8742151103909257,0.12578488960907433,1950,138,384,1428,1491,459,0.07076923076923076,0.19692307692307692,0.7323076923076923,0.7646153846153846,0.2353846153846154
1419,1177,1089,88,747,430,0.9252336448598131,0.07476635514018691,0.6346644010195412,0.3653355989804588,230,4,101,125,189,41,0.017391304347826087,0.4391304347826087,0.5434782608695652,0.8217391304347826,0.1782608695652174
1420,6267,4806,1461,5164,1103,0.7668741024413595,0.2331258975586405,0.8239987234721557,0.17600127652784425,3123,106,323,2694,1771,1352,0.03394172270252962,0.10342619276336855,0.8626320845341018,0.5670829330771694,0.4329170669228306
1421,2303,1938,365,1901,402,0.8415110725141121,0.15848892748588797,0.8254450716456796,0.17455492835432046,817,99,166,552,561,256,0.1211750305997552,0.20318237454100369,0.6756425948592412,0.6866585067319462,0.31334149326805383
1422,4846,4387,459,4292,554,0.9052827073875361,0.0947172926124639,0.8856789104416013,0.11432108955839868,2622,41,405,2176,1266,1356,0.015636918382913808,0.15446224256292906,0.8299008390541571,0.482837528604119,0.517162471395881
1423,816,594,222,549,267,0.7279411764705882,0.27205882352941174,0.6727941176470589,0.3272058823529412,459,39,107,313,209,250,0.08496732026143791,0.23311546840958605,0.681917211328976,0.4553376906318083,0.5446623093681917
1424,21842,18155,3687,17044,4798,0.8311967768519366,0.16880322314806337,0.780331471476971,0.21966852852302904,8093,924,303,6866,4941,3152,0.11417274187569504,0.03743976275793896,0.848387495366366,0.6105276164586679,0.389472383541332
1425,3984,3506,478,3244,740,0.8800200803212851,0.11997991967871485,0.8142570281124498,0.1857429718875502,781,94,246,441,594,187,0.1203585147247119,0.31498079385403327,0.5646606914212549,0.7605633802816901,0.23943661971830985
1426,2426,1664,762,2158,268,0.6859027205276175,0.31409727947238253,0.8895300906842539,0.11046990931574609,1439,42,154,1243,947,492,0.029186935371785964,0.10701876302988186,0.8637943015983321,0.6580958999305073,0.3419041000694927
1427,77,50,27,70,7,0.6493506493506493,0.35064935064935066,0.9090909090909091,0.09090909090909091,112,4,18,90,111,1,0.03571428571428571,0.16071428571428573,0.8035714285714286,0.9910714285714286,0.008928571428571428
1428,4148,3920,228,2469,1679,0.9450337512054002,0.054966248794599805,0.5952266152362584,0.4047733847637416,1015,12,205,798,741,274,0.011822660098522168,0.2019704433497537,0.7862068965517242,0.7300492610837438,0.26995073891625615
1429,814,592,222,547,267,0.7272727272727273,0.2727272727272727,0.671990171990172,0.32800982800982803,459,39,107,313,209,250,0.08496732026143791,0.23311546840958605,0.681917211328976,0.4553376906318083,0.5446623093681917
1430,2597,2189,408,1966,631,0.842895648825568,0.15710435117443203,0.7570273392375818,0.24297266076241816,551,44,127,380,348,203,0.07985480943738657,0.23049001814882034,0.6896551724137931,0.631578947368421,0.3684210526315789
1431,6102,5432,670,5016,1086,0.890199934447722,0.10980006555227795,0.8220255653883972,0.17797443461160276,1737,11,123,1603,780,957,0.0063327576280944155,0.07081174438687392,0.9228554979850316,0.44905008635578586,0.5509499136442142
1432,131,68,63,113,18,0.5190839694656488,0.48091603053435117,0.8625954198473282,0.13740458015267176,176,4,46,126,108,68,0.022727272727272728,0.26136363636363635,0.7159090909090909,0.6136363636363636,0.38636363636363635
1433,1420,1132,288,1171,249,0.7971830985915493,0.2028169014084507,0.8246478873239437,0.17535211267605633,565,72,140,353,430,135,0.12743362831858407,0.24778761061946902,0.6247787610619469,0.7610619469026548,0.23893805309734514
1434,719,512,207,628,91,0.7121001390820584,0.28789986091794156,0.8734353268428373,0.12656467315716272,287,35,95,157,224,63,0.12195121951219512,0.3310104529616725,0.5470383275261324,0.7804878048780488,0.21951219512195122
1435,7206,5736,1470,5994,1212,0.7960033305578684,0.20399666944213155,0.8318068276436303,0.16819317235636969,2264,57,303,1904,1557,707,0.02517667844522968,0.1338339222614841,0.8409893992932862,0.6877208480565371,0.3122791519434629
1436,22945,19079,3866,18448,4497,0.8315101329265635,0.16848986707343647,0.8040095881455654,0.19599041185443453,6193,588,484,5121,3042,3151,0.09494590666881964,0.07815275310834814,0.8269013402228322,0.4911997416437914,0.5088002583562086
1437,2012,1610,402,1279,733,0.8001988071570576,0.19980119284294234,0.635685884691849,0.3643141153081511,1343,6,134,1203,1158,185,0.004467609828741623,0.09977661950856292,0.8957557706626954,0.8622486969471332,0.1377513030528667
1438,19368,15720,3648,16904,2464,0.8116480793060719,0.18835192069392812,0.8727798430400661,0.1272201569599339,12437,229,522,11686,6598,5839,0.018412800514593552,0.04197153654418268,0.9396156629412238,0.5305137894990753,0.46948621050092465
1439,389,324,65,351,38,0.8329048843187661,0.16709511568123395,0.9023136246786633,0.09768637532133675,170,25,43,102,145,25,0.14705882352941177,0.2529411764705882,0.6,0.8529411764705882,0.14705882352941177
1440,2524,1837,687,1750,774,0.7278129952456418,0.27218700475435814,0.6933438985736925,0.30665610142630745,806,16,111,679,493,313,0.019851116625310174,0.13771712158808933,0.8424317617866005,0.6116625310173698,0.3883374689826303
1441,12464,11188,1276,10312,2152,0.8976251604621309,0.10237483953786906,0.8273427471116817,0.17265725288831835,2322,54,310,1958,1196,1126,0.023255813953488372,0.1335055986218777,0.843238587424634,0.5150732127476314,0.48492678725236865
1442,163,110,53,134,29,0.6748466257668712,0.32515337423312884,0.8220858895705522,0.17791411042944785,249,29,63,157,199,50,0.11646586345381527,0.25301204819277107,0.6305220883534136,0.7991967871485943,0.20080321285140562
1443,7012,5581,1431,5779,1233,0.7959212778094695,0.20407872219053053,0.8241585852823731,0.17584141471762693,2230,144,320,1766,1347,883,0.06457399103139014,0.14349775784753363,0.7919282511210762,0.6040358744394618,0.3959641255605381
1444,992,903,89,631,361,0.9102822580645161,0.08971774193548387,0.6360887096774194,0.3639112903225806,171,4,78,89,132,39,0.023391812865497075,0.45614035087719296,0.52046783625731,0.7719298245614035,0.22807017543859648
1445,6419,5240,1179,4988,1431,0.8163265306122449,0.1836734693877551,0.7770680791400529,0.22293192085994704,1577,111,232,1234,1057,520,0.07038681039949271,0.1471147748890298,0.7824984147114775,0.6702599873176919,0.3297400126823082
1446,374,202,172,313,61,0.5401069518716578,0.45989304812834225,0.8368983957219251,0.16310160427807488,492,4,167,321,365,127,0.008130081300813009,0.3394308943089431,0.6524390243902439,0.741869918699187,0.258130081300813
1447,4452,3720,732,3686,766,0.8355795148247979,0.16442048517520216,0.8279424977538186,0.1720575022461815,1397,100,327,970,1142,255,0.07158196134574088,0.23407301360057264,0.6943450250536864,0.8174659985683608,0.18253400143163923
1448,729,610,119,523,206,0.8367626886145405,0.16323731138545952,0.7174211248285323,0.2825788751714678,222,9,41,172,123,99,0.04054054054054054,0.18468468468468469,0.7747747747747747,0.5540540540540541,0.44594594594594594
1449,1468,1364,104,962,506,0.9291553133514986,0.07084468664850137,0.6553133514986376,0.3446866485013624,208,4,87,117,161,47,0.019230769230769232,0.4182692307692308,0.5625,0.7740384615384616,0.22596153846153846
1450,1608,1142,466,1321,287,0.7101990049751243,0.2898009950248756,0.8215174129353234,0.17848258706467662,1260,24,135,1101,816,444,0.01904761904761905,0.10714285714285714,0.8738095238095238,0.6476190476190476,0.3523809523809524
1451,253,156,97,135,118,0.616600790513834,0.383399209486166,0.5335968379446641,0.466403162055336,178,22,43,113,142,36,0.12359550561797752,0.24157303370786518,0.6348314606741573,0.797752808988764,0.20224719101123595
1452,1411,1158,253,1091,320,0.820694542877392,0.1793054571226081,0.7732104890148831,0.22678951098511693,454,56,154,244,345,109,0.12334801762114538,0.3392070484581498,0.5374449339207048,0.7599118942731278,0.24008810572687225
1453,1043,951,92,659,384,0.9117929050814957,0.08820709491850431,0.6318312559923298,0.3681687440076702,213,4,91,118,169,44,0.018779342723004695,0.4272300469483568,0.5539906103286385,0.7934272300469484,0.20657276995305165
1454,363,198,165,216,147,0.5454545454545454,0.45454545454545453,0.5950413223140496,0.4049586776859504,245,31,84,130,164,81,0.12653061224489795,0.34285714285714286,0.5306122448979592,0.6693877551020408,0.3306122448979592
1455,2355,1906,449,2049,306,0.8093418259023355,0.19065817409766456,0.870063694267516,0.12993630573248408,954,49,165,740,675,279,0.051362683438155136,0.17295597484276728,0.7756813417190775,0.7075471698113207,0.29245283018867924
1456,1095,1003,92,707,388,0.9159817351598174,0.08401826484018265,0.645662100456621,0.354337899543379,179,4,81,94,139,40,0.0223463687150838,0.45251396648044695,0.5251396648044693,0.776536312849162,0.22346368715083798
1457,995,903,92,622,373,0.907537688442211,0.09246231155778895,0.6251256281407035,0.3748743718592965,197,4,87,106,156,41,0.02030456852791878,0.4416243654822335,0.5380710659898477,0.7918781725888325,0.20812182741116753
1458,13505,11048,2457,9289,4216,0.8180673824509441,0.1819326175490559,0.6878193261754906,0.3121806738245094,6453,389,514,5550,4260,2193,0.06028203936153727,0.07965287463195413,0.8600650860065086,0.6601580660158066,0.3398419339841934
1459,9176,7245,1931,7809,1367,0.7895597210113339,0.21044027898866607,0.8510244115082825,0.14897558849171752,3209,120,329,2760,2810,399,0.0373948270489249,0.10252415082580243,0.8600810221252727,0.8756622000623248,0.12433779993767528
1460,16556,14179,2377,13571,2985,0.8564266731094468,0.14357332689055327,0.8197028267697511,0.18029717323024885,2882,130,640,2112,1289,1593,0.04510756419153366,0.2220680083275503,0.732824427480916,0.4472588480222068,0.5527411519777932
1461,3736,3116,620,3144,592,0.8340471092077087,0.16595289079229122,0.841541755888651,0.15845824411134904,827,110,206,511,609,218,0.13301088270858524,0.24909310761789602,0.6178960096735188,0.7363966142684402,0.26360338573155984
1462,15926,13395,2531,12721,3205,0.8410774833605426,0.1589225166394575,0.7987567499686048,0.2012432500313952,3688,189,441,3058,2597,1091,0.051247288503253795,0.11957700650759219,0.829175704989154,0.704175704989154,0.295824295010846
1463,2080,1721,359,1832,248,0.8274038461538461,0.17259615384615384,0.8807692307692307,0.11923076923076924,502,54,151,297,450,52,0.10756972111553785,0.300796812749004,0.5916334661354582,0.896414342629482,0.10358565737051793
1464,1710,1234,476,1286,424,0.7216374269005847,0.2783625730994152,0.752046783625731,0.247953216374269,981,27,123,831,602,379,0.027522935779816515,0.12538226299694188,0.8470948012232415,0.6136595310907238,0.38634046890927626
1465,575,398,177,396,179,0.6921739130434783,0.30782608695652175,0.688695652173913,0.31130434782608696,433,7,49,377,268,165,0.016166281755196306,0.11316397228637413,0.8706697459584296,0.6189376443418014,0.3810623556581986
1466,1618,1182,436,1375,243,0.73053152039555,0.2694684796044499,0.8498145859085291,0.15018541409147096,1301,30,115,1156,774,527,0.023059185242121444,0.0883935434281322,0.8885472713297463,0.5949269792467333,0.40507302075326673
1467,1704,1289,415,1499,205,0.7564553990610329,0.24354460093896713,0.8796948356807511,0.12030516431924883,1605,51,123,1431,1053,552,0.03177570093457944,0.07663551401869159,0.891588785046729,0.6560747663551402,0.34392523364485983
1468,3881,2682,1199,3187,694,0.6910590054109765,0.30894099458902347,0.821180108219531,0.17881989178046895,2731,1319,184,1228,2219,512,0.4829732698645185,0.06737458806298059,0.4496521420725009,0.8125228853899671,0.18747711461003294
1469,1170,906,264,931,239,0.7743589743589744,0.22564102564102564,0.7957264957264957,0.20427350427350427,1205,10,72,1123,729,476,0.008298755186721992,0.05975103734439834,0.9319502074688797,0.6049792531120332,0.3950207468879668
1470,868,646,222,699,169,0.7442396313364056,0.2557603686635945,0.8052995391705069,0.19470046082949308,712,44,128,540,439,273,0.06179775280898876,0.1797752808988764,0.7584269662921348,0.6165730337078652,0.38342696629213485
1471,979,884,95,616,363,0.9029622063329928,0.09703779366700716,0.6292134831460674,0.3707865168539326,190,4,91,95,151,39,0.021052631578947368,0.4789473684210526,0.5,0.7947368421052632,0.20526315789473684
1472,189,126,63,122,67,0.6666666666666666,0.3333333333333333,0.6455026455026455,0.3544973544973545,225,30,29,166,133,92,0.13333333333333333,0.1288888888888889,0.7377777777777778,0.5911111111111111,0.4088888888888889
1473,1395,1023,372,937,458,0.7333333333333333,0.26666666666666666,0.6716845878136201,0.32831541218637994,443,15,72,356,292,151,0.033860045146726865,0.16252821670428894,0.8036117381489842,0.6591422121896162,0.34085778781038373
1474,7545,6198,1347,6178,1367,0.8214711729622266,0.17852882703777337,0.8188204108681246,0.1811795891318754,2306,213,354,1739,1584,722,0.09236773633998266,0.15351257588898526,0.7541196877710321,0.6869037294015612,0.31309627059843886
1475,2132,1695,437,1815,317,0.7950281425891182,0.2049718574108818,0.8513133208255159,0.14868667917448405,698,46,168,484,544,154,0.0659025787965616,0.24068767908309455,0.6934097421203438,0.7793696275071633,0.22063037249283668
1476,20424,18017,2407,16763,3661,0.8821484528006267,0.11785154719937328,0.820750097924011,0.17924990207598904,9946,765,1854,7327,7351,2595,0.07691534285139755,0.18640659561632816,0.7366780615322743,0.7390910918962397,0.26090890810376033
1477,325,272,53,267,58,0.8369230769230769,0.16307692307692306,0.8215384615384616,0.17846153846153845,290,5,28,257,250,40,0.017241379310344827,0.09655172413793103,0.8862068965517241,0.8620689655172413,0.13793103448275862
1478,12337,10506,1831,11154,1183,0.8515846640188052,0.14841533598119477,0.9041095890410958,0.0958904109589041,4751,103,1069,3579,2889,1862,0.021679646390233634,0.22500526205009472,0.7533150915596717,0.6080825089454852,0.39191749105451484
1479,1098,1007,91,694,404,0.9171220400728597,0.08287795992714025,0.6320582877959927,0.3679417122040073,206,4,88,114,165,41,0.019417475728155338,0.42718446601941745,0.5533980582524272,0.8009708737864077,0.19902912621359223
1480,1101,922,179,939,162,0.8374205267938238,0.16257947320617622,0.8528610354223434,0.14713896457765668,496,24,114,358,337,159,0.04838709677419355,0.22983870967741934,0.7217741935483871,0.6794354838709677,0.32056451612903225
1481,3165,2535,630,2533,632,0.8009478672985783,0.1990521327014218,0.8003159557661927,0.19968404423380726,1192,51,180,961,816,376,0.04278523489932886,0.15100671140939598,0.8062080536912751,0.6845637583892618,0.31543624161073824
1482,1062,746,316,685,377,0.7024482109227872,0.2975517890772128,0.6450094161958568,0.3549905838041431,770,16,148,606,356,414,0.02077922077922078,0.19220779220779222,0.787012987012987,0.4623376623376623,0.5376623376623376
1483,2687,1663,1024,1572,1115,0.6189058429475252,0.3810941570524749,0.5850390770375884,0.4149609229624116,3300,39,949,2312,1497,1803,0.011818181818181818,0.2875757575757576,0.7006060606060606,0.4536363636363636,0.5463636363636364
1484,211,100,111,90,121,0.47393364928909953,0.5260663507109005,0.4265402843601896,0.5734597156398105,199,2,54,143,101,98,0.010050251256281407,0.271356783919598,0.7185929648241206,0.507537688442211,0.49246231155778897
1485,138,72,66,75,63,0.5217391304347826,0.4782608695652174,0.5434782608695652,0.45652173913043476,152,8,37,107,87,65,0.05263157894736842,0.24342105263157895,0.7039473684210527,0.5723684210526315,0.4276315789473684
1486,1021,842,179,867,154,0.8246816846229187,0.17531831537708129,0.8491674828599413,0.15083251714005877,449,44,119,286,359,90,0.09799554565701558,0.2650334075723831,0.6369710467706013,0.799554565701559,0.20044543429844097
1487,15538,13810,1728,12695,2843,0.8887887759042348,0.11121122409576523,0.817029218689664,0.18297078131033595,5892,183,347,5362,3059,2833,0.031059063136456212,0.05889341479972845,0.9100475220638153,0.5191785471826205,0.4808214528173795
1488,5895,4793,1102,4695,1200,0.8130619168787108,0.18693808312128923,0.7964376590330788,0.2035623409669211,1424,118,253,1053,944,480,0.08286516853932584,0.1776685393258427,0.7394662921348315,0.6629213483146067,0.33707865168539325
1489,2526,2128,398,2106,420,0.8424386381631037,0.15756136183689629,0.833729216152019,0.166270783847981,913,97,226,590,628,285,0.10624315443592552,0.2475355969331873,0.6462212486308871,0.687842278203724,0.312157721796276
1490,1426,998,428,1100,326,0.699859747545582,0.30014025245441794,0.7713884992987378,0.22861150070126227,1413,16,283,1114,841,572,0.01132342533616419,0.2002830856334041,0.7883934890304317,0.5951875442321303,0.4048124557678698
1491,11550,10310,1240,8014,3536,0.8926406926406927,0.10735930735930736,0.6938528138528138,0.30614718614718617,1214,53,318,843,733,481,0.04365733113673806,0.26194398682042835,0.6943986820428336,0.6037891268533773,0.39621087314662273
1492,21842,18155,3687,17044,4798,0.8311967768519366,0.16880322314806337,0.780331471476971,0.21966852852302904,8093,924,303,6866,4941,3152,0.11417274187569504,0.03743976275793896,0.848387495366366,0.6105276164586679,0.389472383541332
1493,6931,5790,1141,5757,1174,0.8353772904342808,0.16462270956571923,0.8306160727167797,0.16938392728322033,1028,141,315,572,976,52,0.13715953307392997,0.30642023346303504,0.556420233463035,0.9494163424124513,0.05058365758754864
1494,9537,8440,1097,8123,1414,0.8849743105798469,0.1150256894201531,0.8517353465450351,0.14826465345496487,1627,73,408,1146,1130,497,0.04486785494775661,0.2507682851874616,0.7043638598647818,0.6945298094652735,0.3054701905347265
1495,1481,1181,300,1211,270,0.7974341661039838,0.2025658338960162,0.8176907494935854,0.18230925050641458,552,83,137,332,427,125,0.1503623188405797,0.24818840579710144,0.6014492753623188,0.7735507246376812,0.22644927536231885
1496,17324,13377,3947,13008,4316,0.7721657815746941,0.22783421842530593,0.7508658508427615,0.2491341491572385,10084,409,1782,7893,8358,1726,0.04055930186433955,0.1767155890519635,0.782725109083697,0.8288377627925426,0.17116223720745735
1497,4001,2667,1334,2681,1320,0.6665833541614596,0.33341664583854036,0.670082479380155,0.32991752061984503,905,39,144,722,590,315,0.0430939226519337,0.1591160220994475,0.7977900552486188,0.6519337016574586,0.34806629834254144
1498,6871,5653,1218,5311,1560,0.8227332266045699,0.17726677339543007,0.7729588123999418,0.2270411876000582,2458,25,206,2227,1120,1338,0.01017087062652563,0.0838079739625712,0.9060211554109032,0.45565500406834825,0.5443449959316518
1499,1301,949,352,1148,153,0.7294388931591084,0.27056110684089163,0.8823981552651806,0.11760184473481937,768,92,219,457,694,74,0.11979166666666667,0.28515625,0.5950520833333334,0.9036458333333334,0.09635416666666667
1500,976,884,92,614,362,0.9057377049180327,0.0942622950819672,0.6290983606557377,0.3709016393442623,191,4,85,102,149,42,0.020942408376963352,0.44502617801047123,0.5340314136125655,0.7801047120418848,0.2198952879581152
1501,976,885,91,609,367,0.9067622950819673,0.0932377049180328,0.6239754098360656,0.3760245901639344,194,4,81,109,142,52,0.020618556701030927,0.4175257731958763,0.5618556701030928,0.7319587628865979,0.26804123711340205
1502,5719,4379,1340,4694,1025,0.7656933030250044,0.23430669697499562,0.8207728623885294,0.17922713761147055,2138,94,332,1712,1423,715,0.04396632366697849,0.15528531337698784,0.8007483629560337,0.6655753040224509,0.3344246959775491
1503,148,106,42,98,50,0.7162162162162162,0.28378378378378377,0.6621621621621622,0.33783783783783783,105,5,15,85,70,35,0.047619047619047616,0.14285714285714285,0.8095238095238095,0.6666666666666666,0.3333333333333333
1504,1004,813,191,875,129,0.8097609561752988,0.1902390438247012,0.8715139442231076,0.12848605577689243,323,49,105,169,296,27,0.15170278637770898,0.32507739938080493,0.5232198142414861,0.9164086687306502,0.08359133126934984
1505,8213,7146,1067,6454,1759,0.8700840131498844,0.12991598685011568,0.7858273468890783,0.2141726531109217,2804,49,309,2446,1677,1127,0.01747503566333809,0.11019971469329529,0.8723252496433667,0.598074179743224,0.40192582025677603
1506,19691,15262,4429,15961,3730,0.775074907318064,0.22492509268193592,0.8105733583870804,0.1894266416129196,12514,388,1686,10440,8997,3517,0.031005274093015824,0.1347291034041873,0.8342656225027969,0.7189547706568643,0.2810452293431357
1507,2318,1846,472,1660,658,0.7963761863675582,0.20362381363244175,0.7161345987920621,0.28386540120793785,773,55,160,558,412,361,0.07115135834411385,0.2069857697283312,0.7218628719275549,0.5329883570504528,0.4670116429495472
1508,4033,3459,574,3679,354,0.8576741879494173,0.1423258120505827,0.9122241507562608,0.08777584924373916,1621,91,268,1262,1202,419,0.056138186304750155,0.16533004318322023,0.7785317705120296,0.7415175817396669,0.25848241826033314
1509,1021,842,179,867,154,0.8246816846229187,0.17531831537708129,0.8491674828599413,0.15083251714005877,403,44,109,250,322,81,0.10918114143920596,0.2704714640198511,0.6203473945409429,0.7990074441687345,0.20099255583126552
1510,1932,1505,427,1614,318,0.7789855072463768,0.2210144927536232,0.8354037267080745,0.16459627329192547,1141,7,146,988,884,257,0.006134969325153374,0.12795793163891322,0.8659070990359334,0.7747589833479404,0.2252410166520596
1511,4135,2996,1139,3510,625,0.7245465538089481,0.275453446191052,0.848851269649335,0.15114873035066506,4256,2329,162,1765,3629,627,0.5472274436090225,0.03806390977443609,0.41470864661654133,0.8526785714285714,0.14732142857142858
1512,1102,1008,94,680,422,0.9147005444646098,0.0852994555353902,0.617059891107078,0.38294010889292196,212,4,90,118,166,46,0.018867924528301886,0.42452830188679247,0.5566037735849056,0.7830188679245284,0.2169811320754717
1513,2092,1657,435,1824,268,0.7920650095602294,0.20793499043977057,0.8718929254302104,0.12810707456978968,625,60,171,394,527,98,0.096,0.2736,0.6304,0.8432,0.1568
1514,15051,12633,2418,13767,1284,0.8393462228423361,0.16065377715766394,0.9146900538170222,0.08530994618297788,9723,197,1330,8196,8721,1002,0.020261236243957627,0.13678905687544995,0.8429497068805925,0.8969453872261648,0.10305461277383524
1515,140,63,77,67,73,0.45,0.55,0.4785714285714286,0.5214285714285715,159,4,52,103,97,62,0.025157232704402517,0.3270440251572327,0.6477987421383647,0.610062893081761,0.389937106918239
1516,106,67,39,93,13,0.6320754716981132,0.36792452830188677,0.8773584905660378,0.12264150943396226,119,30,36,53,112,7,0.25210084033613445,0.3025210084033613,0.44537815126050423,0.9411764705882353,0.058823529411764705
1517,13505,11048,2457,9289,4216,0.8180673824509441,0.1819326175490559,0.6878193261754906,0.3121806738245094,6453,389,514,5550,4260,2193,0.06028203936153727,0.07965287463195413,0.8600650860065086,0.6601580660158066,0.3398419339841934
1518,9785,8321,1464,7511,2274,0.8503832396525294,0.14961676034747062,0.767603474706183,0.23239652529381707,3009,54,276,2679,1726,1283,0.01794616151545364,0.09172482552342971,0.8903290129611167,0.573612495845796,0.42638750415420407
1519,13182,10244,2938,9840,3342,0.777120315581854,0.22287968441814596,0.7464724624487938,0.2535275375512062,4680,190,626,3864,3223,1457,0.0405982905982906,0.13376068376068376,0.8256410256410256,0.6886752136752137,0.31132478632478633
1520,950,858,92,594,356,0.9031578947368422,0.0968421052631579,0.6252631578947369,0.37473684210526315,175,4,80,91,135,40,0.022857142857142857,0.45714285714285713,0.52,0.7714285714285715,0.22857142857142856
1521,988,896,92,617,371,0.9068825910931174,0.0931174089068826,0.6244939271255061,0.37550607287449395,239,5,86,148,190,49,0.02092050209205021,0.3598326359832636,0.6192468619246861,0.7949790794979079,0.20502092050209206
1522,1564,863,701,1221,343,0.5517902813299232,0.44820971867007675,0.780690537084399,0.21930946291560102,2254,36,328,1890,1378,876,0.015971606033717833,0.14551907719609583,0.8385093167701864,0.611357586512866,0.38864241348713396
1523,17007,15638,1369,12316,4691,0.9195037337566884,0.08049626624331158,0.7241723996001647,0.27582760039983534,5406,439,1258,3709,3841,1565,0.08120606733259342,0.23270440251572327,0.6860895301516833,0.7105068442471328,0.28949315575286716
1524,2307,1750,557,1682,625,0.7585609016038145,0.24143909839618552,0.729085392284352,0.270914607715648,1134,54,155,925,640,494,0.047619047619047616,0.13668430335097,0.8156966490299824,0.564373897707231,0.43562610229276894
1525,13610,11213,2397,10891,2719,0.8238795003673769,0.17612049963262308,0.8002204261572373,0.19977957384276268,3635,108,421,3106,2877,758,0.0297111416781293,0.11581843191196699,0.8544704264099037,0.7914718019257222,0.20852819807427786
1526,3223,2425,798,2234,989,0.7524045919950357,0.24759540800496432,0.6931430344399627,0.3068569655600372,3328,86,177,3065,547,2781,0.025841346153846152,0.05318509615384615,0.9209735576923077,0.16436298076923078,0.8356370192307693
1527,1666,1275,391,1217,449,0.7653061224489796,0.23469387755102042,0.7304921968787516,0.2695078031212485,863,69,153,641,394,469,0.07995365005793743,0.1772885283893395,0.7427578215527231,0.45654692931633833,0.5434530706836617
1528,74,35,39,60,14,0.47297297297297297,0.527027027027027,0.8108108108108109,0.1891891891891892,165,4,82,79,147,18,0.024242424242424242,0.49696969696969695,0.47878787878787876,0.8909090909090909,0.10909090909090909
1529,1312,1071,241,1022,290,0.8163109756097561,0.1836890243902439,0.7789634146341463,0.22103658536585366,747,14,91,642,340,407,0.018741633199464525,0.12182061579651941,0.8594377510040161,0.45515394912985274,0.5448460508701473
1530,4582,3766,816,3687,895,0.8219118288956787,0.17808817110432126,0.804670449585334,0.1953295504146661,974,79,208,687,730,244,0.0811088295687885,0.2135523613963039,0.7053388090349076,0.7494866529774127,0.25051334702258726
1531,3321,2547,774,2259,1062,0.7669376693766937,0.23306233062330622,0.6802168021680217,0.31978319783197834,2101,121,482,1498,1703,398,0.05759162303664921,0.22941456449309852,0.7129938124702523,0.8105663969538315,0.1894336030461685
1532,2025,1902,123,1268,757,0.9392592592592592,0.06074074074074074,0.6261728395061729,0.37382716049382714,427,4,103,320,300,127,0.00936768149882904,0.24121779859484777,0.7494145199063232,0.702576112412178,0.297423887587822
1533,11669,9072,2597,10259,1410,0.7774445110977805,0.22255548890221954,0.8791670237381095,0.12083297626189048,3048,125,591,2332,2080,968,0.04101049868766404,0.19389763779527558,0.7650918635170604,0.6824146981627297,0.31758530183727035
1534,2533,1726,807,1990,543,0.6814054480852744,0.31859455191472563,0.7856296881168575,0.2143703118831425,1948,773,144,1031,1519,429,0.3968172484599589,0.07392197125256673,0.5292607802874744,0.7797741273100616,0.2202258726899384
1535,1079,987,92,674,405,0.9147358665430955,0.08526413345690455,0.6246524559777572,0.3753475440222428,211,4,89,118,154,57,0.018957345971563982,0.4218009478672986,0.5592417061611374,0.7298578199052133,0.27014218009478674
1536,1348,1191,157,826,522,0.8835311572700296,0.11646884272997032,0.612759643916914,0.38724035608308605,284,4,116,164,242,42,0.014084507042253521,0.4084507042253521,0.5774647887323944,0.852112676056338,0.14788732394366197
1537,12656,11151,1505,10162,2494,0.8810840707964602,0.11891592920353983,0.8029393173198482,0.1970606826801517,4186,173,689,3324,2816,1370,0.041328236980410896,0.16459627329192547,0.7940754897276636,0.672718585762064,0.327281414237936
1538,2259,1894,365,1853,406,0.8384240814519699,0.1615759185480301,0.8202744577246569,0.17972554227534307,684,106,175,403,545,139,0.15497076023391812,0.25584795321637427,0.5891812865497076,0.7967836257309941,0.20321637426900585
1539,7939,7312,627,6253,1686,0.9210227988411639,0.07897720115883612,0.787630683965235,0.21236931603476508,1862,49,978,835,1554,308,0.02631578947368421,0.5252416756176155,0.44844253490870034,0.8345864661654135,0.16541353383458646
1540,431,282,149,363,68,0.654292343387471,0.345707656612529,0.8422273781902552,0.15777262180974477,146,8,30,108,122,24,0.0547945205479452,0.2054794520547945,0.7397260273972602,0.8356164383561644,0.1643835616438356
1541,486,288,198,386,100,0.5925925925925926,0.4074074074074074,0.7942386831275721,0.205761316872428,1183,287,243,653,1027,156,0.24260355029585798,0.20540997464074387,0.5519864750633982,0.8681318681318682,0.13186813186813187
1542,311,191,120,266,45,0.6141479099678456,0.3858520900321543,0.8553054662379421,0.14469453376205788,768,151,195,422,708,60,0.19661458333333334,0.25390625,0.5494791666666666,0.921875,0.078125
1543,1286,998,288,1077,209,0.776049766718507,0.223950233281493,0.8374805598755832,0.1625194401244168,1166,102,228,836,888,278,0.08747855917667238,0.1955403087478559,0.7169811320754716,0.7615780445969125,0.23842195540308747
1544,467,285,182,384,83,0.6102783725910065,0.3897216274089936,0.8222698072805139,0.1777301927194861,828,106,223,499,755,73,0.1280193236714976,0.2693236714975845,0.6026570048309179,0.9118357487922706,0.08816425120772947
1545,698,496,202,564,134,0.7106017191977078,0.28939828080229224,0.8080229226361032,0.19197707736389685,830,116,320,394,762,68,0.13975903614457832,0.3855421686746988,0.4746987951807229,0.9180722891566265,0.0819277108433735
1546,705,516,189,588,117,0.7319148936170212,0.2680851063829787,0.8340425531914893,0.16595744680851063,1164,222,358,584,943,221,0.19072164948453607,0.3075601374570447,0.5017182130584192,0.8101374570446735,0.18986254295532645
1547,805,559,246,657,148,0.6944099378881987,0.30559006211180123,0.8161490683229814,0.18385093167701863,1080,99,214,767,853,227,0.09166666666666666,0.19814814814814816,0.7101851851851851,0.7898148148148149,0.2101851851851852
1548,396,212,184,318,78,0.5353535353535354,0.46464646464646464,0.803030303030303,0.19696969696969696,653,117,166,370,585,68,0.17917304747320062,0.2542113323124043,0.5666156202143952,0.8958652373660031,0.10413476263399694
1549,549,375,174,459,90,0.6830601092896175,0.31693989071038253,0.8360655737704918,0.16393442622950818,1066,222,304,540,935,131,0.20825515947467166,0.2851782363977486,0.5065666041275797,0.8771106941838649,0.12288930581613508
1550,1237,968,269,1024,213,0.7825383993532741,0.21746160064672596,0.8278092158447857,0.17219078415521422,1349,273,429,647,1126,223,0.20237212750185324,0.31801334321719793,0.47961452928094883,0.8346923647146034,0.1653076352853966
1551,139,84,55,62,77,0.60431654676259,0.39568345323741005,0.4460431654676259,0.5539568345323741,83,0,53,30,81,2,0.0,0.6385542168674698,0.3614457831325301,0.9759036144578314,0.024096385542168676
1552,613,365,248,482,131,0.5954323001631321,0.40456769983686786,0.7862969004893964,0.2137030995106036,834,116,271,447,759,75,0.13908872901678657,0.3249400479616307,0.5359712230215827,0.9100719424460432,0.08992805755395683
1553,1258,1037,221,1100,158,0.8243243243243243,0.17567567567567569,0.8744038155802861,0.12559618441971382,1064,149,282,633,843,221,0.1400375939849624,0.2650375939849624,0.5949248120300752,0.7922932330827067,0.20770676691729323
1554,4571,3998,573,3730,841,0.8746444979216802,0.12535550207831983,0.816014001312623,0.18398599868737694,2081,286,584,1211,1632,449,0.13743392599711676,0.280634310427679,0.5819317635752043,0.7842383469485824,0.2157616530514176
1555,328,211,117,286,42,0.6432926829268293,0.3567073170731707,0.8719512195121951,0.12804878048780488,711,157,239,315,594,117,0.22081575246132207,0.3361462728551336,0.4430379746835443,0.8354430379746836,0.16455696202531644
1556,412,228,184,335,77,0.5533980582524272,0.44660194174757284,0.8131067961165048,0.18689320388349515,633,102,162,369,567,66,0.16113744075829384,0.2559241706161137,0.5829383886255924,0.8957345971563981,0.10426540284360189
1557,1376,1084,292,1151,225,0.7877906976744186,0.21220930232558138,0.8364825581395349,0.16351744186046513,1227,247,429,551,1092,135,0.2013039934800326,0.34963325183374083,0.4490627546862266,0.8899755501222494,0.1100244498777506
1558,1287,998,289,1078,209,0.7754467754467754,0.22455322455322455,0.8376068376068376,0.1623931623931624,1175,102,233,840,897,278,0.08680851063829788,0.19829787234042554,0.7148936170212766,0.7634042553191489,0.23659574468085107
1559,346,218,128,302,44,0.630057803468208,0.3699421965317919,0.8728323699421965,0.12716763005780346,1069,158,227,684,932,137,0.14780168381665107,0.21234798877455566,0.6398503274087932,0.8718428437792329,0.12815715622076707
1560,579,361,218,454,125,0.6234887737478411,0.3765112262521589,0.7841105354058722,0.2158894645941278,754,111,229,414,680,74,0.14721485411140584,0.3037135278514589,0.5490716180371353,0.9018567639257294,0.09814323607427056
1561,1253,1030,223,1097,156,0.8220271348762969,0.1779728651237031,0.8754988028731046,0.12450119712689545,1078,155,287,636,857,221,0.1437847866419295,0.2662337662337662,0.5899814471243042,0.7949907235621522,0.20500927643784786
1562,385,207,178,289,96,0.5376623376623376,0.4623376623376623,0.7506493506493507,0.24935064935064935,587,102,151,334,520,67,0.1737649063032368,0.2572402044293015,0.5689948892674617,0.8858603066439523,0.1141396933560477
1563,383,207,176,294,89,0.5404699738903395,0.4595300261096606,0.7676240208877284,0.23237597911227154,571,91,144,336,504,67,0.159369527145359,0.2521891418563923,0.5884413309982487,0.882661996497373,0.11733800350262696
1564,462,290,172,382,80,0.6277056277056277,0.3722943722943723,0.8268398268398268,0.17316017316017315,800,117,207,476,726,74,0.14625,0.25875,0.595,0.9075,0.0925
1565,1586,1240,346,1315,271,0.7818411097099621,0.21815889029003782,0.8291298865069356,0.1708701134930643,1251,221,422,608,1072,179,0.17665867306155075,0.33733013589128696,0.4860111910471623,0.8569144684252598,0.14308553157474022
1566,386,201,185,297,89,0.5207253886010362,0.4792746113989637,0.7694300518134715,0.23056994818652848,581,94,149,338,514,67,0.16179001721170397,0.25645438898450945,0.5817555938037866,0.8846815834767642,0.1153184165232358
1567,1288,998,290,1079,209,0.7748447204968945,0.2251552795031056,0.8377329192546584,0.1622670807453416,1177,102,234,841,899,278,0.08666100254885302,0.1988105352591334,0.7145284621920136,0.7638062871707731,0.23619371282922685
1568,571,403,168,480,91,0.7057793345008757,0.29422066549912435,0.840630472854641,0.159369527145359,1266,233,303,730,1038,228,0.18404423380726698,0.23933649289099526,0.5766192733017378,0.8199052132701422,0.18009478672985782
1569,1167,879,288,909,258,0.7532133676092545,0.2467866323907455,0.7789203084832905,0.2210796915167095,1160,102,231,827,882,278,0.08793103448275862,0.19913793103448277,0.7129310344827586,0.7603448275862069,0.2396551724137931
1570,392,259,133,341,51,0.6607142857142857,0.3392857142857143,0.8698979591836735,0.13010204081632654,605,146,200,259,552,53,0.2413223140495868,0.3305785123966942,0.428099173553719,0.912396694214876,0.08760330578512397
1571,1259,1053,206,1100,159,0.8363780778395552,0.1636219221604448,0.8737092930897538,0.12629070691024621,1056,155,258,643,835,221,0.14678030303030304,0.24431818181818182,0.6089015151515151,0.790719696969697,0.20928030303030304
1572,326,189,137,279,47,0.5797546012269938,0.42024539877300615,0.8558282208588958,0.1441717791411043,641,141,196,304,587,54,0.21996879875195008,0.30577223088923555,0.47425897035881437,0.9157566302652106,0.0842433697347894
1573,633,431,202,503,130,0.6808846761453397,0.31911532385466035,0.7946287519747235,0.20537124802527645,1357,296,304,757,1130,227,0.21812822402358142,0.22402358142962417,0.5578481945467944,0.8327192336035372,0.16728076639646278
1574,336,224,112,284,52,0.6666666666666666,0.3333333333333333,0.8452380952380952,0.15476190476190477,487,151,179,157,479,8,0.31006160164271046,0.3675564681724846,0.32238193018480493,0.9835728952772074,0.01642710472279261
1575,305,185,120,264,41,0.6065573770491803,0.39344262295081966,0.8655737704918033,0.13442622950819672,538,115,177,246,486,52,0.2137546468401487,0.32899628252788105,0.45724907063197023,0.9033457249070632,0.09665427509293681
1576,491,294,197,396,95,0.5987780040733197,0.40122199592668023,0.8065173116089613,0.1934826883910387,798,104,210,484,728,70,0.13032581453634084,0.2631578947368421,0.606516290726817,0.9122807017543859,0.08771929824561403
1577,386,210,176,297,89,0.5440414507772021,0.45595854922279794,0.7694300518134715,0.23056994818652848,583,104,150,329,516,67,0.1783876500857633,0.25728987993138935,0.5643224699828473,0.8850771869639794,0.11492281303602059
1578,161,46,115,151,10,0.2857142857142857,0.7142857142857143,0.937888198757764,0.062111801242236024,558,123,157,278,506,52,0.22043010752688172,0.28136200716845877,0.4982078853046595,0.9068100358422939,0.0931899641577061
1579,741,528,213,598,143,0.7125506072874493,0.2874493927125506,0.8070175438596491,0.19298245614035087,824,112,305,407,756,68,0.13592233009708737,0.37014563106796117,0.49393203883495146,0.9174757281553398,0.0825242718446602
1580,823,574,249,660,163,0.6974483596597812,0.3025516403402187,0.8019441069258809,0.19805589307411908,1068,103,203,762,841,227,0.09644194756554307,0.1900749063670412,0.7134831460674157,0.7874531835205992,0.21254681647940074
1581,1247,1031,216,1090,157,0.8267842822774659,0.17321571772253408,0.8740978348035284,0.12590216519647154,1055,149,274,632,834,221,0.14123222748815165,0.25971563981042656,0.5990521327014218,0.790521327014218,0.209478672985782
1582,345,210,135,302,43,0.6086956521739131,0.391304347826087,0.8753623188405797,0.1246376811594203,748,139,265,344,631,117,0.1858288770053476,0.35427807486631013,0.45989304812834225,0.8435828877005348,0.15641711229946523
1583,1162,880,282,904,258,0.7573149741824441,0.24268502581755594,0.7779690189328744,0.22203098106712565,1156,102,230,824,878,278,0.08823529411764706,0.19896193771626297,0.71280276816609,0.759515570934256,0.24048442906574394
1584,1161,879,282,903,258,0.7571059431524548,0.24289405684754523,0.7777777777777778,0.2222222222222222,1156,102,230,824,878,278,0.08823529411764706,0.19896193771626297,0.71280276816609,0.759515570934256,0.24048442906574394
1585,607,375,232,479,128,0.6177924217462932,0.38220757825370677,0.7891268533772653,0.21087314662273476,814,115,272,427,741,73,0.14127764127764128,0.33415233415233414,0.5245700245700246,0.9103194103194103,0.08968058968058969
1586,604,425,179,502,102,0.7036423841059603,0.29635761589403975,0.8311258278145696,0.16887417218543047,998,221,240,537,921,77,0.22144288577154309,0.24048096192384769,0.5380761523046093,0.9228456913827655,0.07715430861723446
1587,373,191,182,290,83,0.5120643431635389,0.4879356568364611,0.7774798927613941,0.2225201072386059,638,113,167,358,571,67,0.17711598746081506,0.2617554858934169,0.5611285266457681,0.8949843260188087,0.10501567398119123
1588,572,395,177,468,104,0.6905594405594405,0.3094405594405594,0.8181818181818182,0.18181818181818182,1071,224,282,565,942,129,0.20915032679738563,0.26330532212885155,0.5275443510737629,0.8795518207282913,0.12044817927170869
1589,2802,2378,424,2316,486,0.8486795146324054,0.15132048536759457,0.8265524625267666,0.1734475374732334,39,1,1,37,37,2,0.02564102564102564,0.02564102564102564,0.9487179487179487,0.9487179487179487,0.05128205128205128
1590,343,216,127,300,43,0.6297376093294461,0.37026239067055394,0.8746355685131195,0.12536443148688048,848,128,231,489,725,123,0.1509433962264151,0.27240566037735847,0.5766509433962265,0.8549528301886793,0.14504716981132076
1591,549,356,193,427,122,0.6484517304189436,0.35154826958105645,0.7777777777777778,0.2222222222222222,712,115,194,403,645,67,0.16151685393258428,0.27247191011235955,0.5660112359550562,0.9058988764044944,0.09410112359550561
1592,1252,1031,221,1096,156,0.8234824281150159,0.17651757188498401,0.8753993610223643,0.12460063897763578,1065,155,283,627,844,221,0.14553990610328638,0.26572769953051645,0.5887323943661972,0.7924882629107981,0.20751173708920187
1593,1501,1255,246,1285,216,0.8361092604930047,0.16389073950699534,0.8560959360426382,0.14390406395736177,1162,169,317,676,937,225,0.14543889845094665,0.2728055077452668,0.5817555938037866,0.806368330464716,0.193631669535284
1594,578,357,221,451,127,0.6176470588235294,0.38235294117647056,0.7802768166089965,0.21972318339100347,728,100,230,398,657,71,0.13736263736263737,0.3159340659340659,0.5467032967032966,0.9024725274725275,0.09752747252747253
1595,1295,998,297,1086,209,0.7706563706563706,0.22934362934362934,0.8386100386100386,0.1613899613899614,1171,102,229,840,893,278,0.08710503842869342,0.19555935098206662,0.71733561058924,0.762596071733561,0.23740392826643894
1596,4875,4278,597,4176,699,0.8775384615384615,0.12246153846153846,0.8566153846153847,0.1433846153846154,2084,294,600,1190,1653,431,0.14107485604606526,0.28790786948176583,0.5710172744721689,0.7931861804222649,0.20681381957773512
1597,1245,1031,214,1089,156,0.8281124497991967,0.1718875502008032,0.8746987951807229,0.12530120481927712,1073,155,291,627,852,221,0.14445479962721341,0.2712022367194781,0.5843429636533085,0.7940354147250699,0.2059645852749301
1598,406,222,184,331,75,0.5467980295566502,0.45320197044334976,0.8152709359605911,0.18472906403940886,679,129,169,381,611,68,0.18998527245949925,0.24889543446244478,0.561119293078056,0.8998527245949927,0.10014727540500737
1599,1162,880,282,904,258,0.7573149741824441,0.24268502581755594,0.7779690189328744,0.22203098106712565,1156,102,230,824,878,278,0.08823529411764706,0.19896193771626297,0.71280276816609,0.759515570934256,0.24048442906574394
1600,595,407,188,489,106,0.6840336134453782,0.31596638655462184,0.8218487394957983,0.1781512605042017,1277,259,313,705,1048,229,0.2028191072826938,0.245105716523101,0.5520751761942052,0.8206734534064213,0.1793265465935787
1601,304,184,120,264,40,0.6052631578947368,0.39473684210526316,0.868421052631579,0.13157894736842105,746,122,186,438,686,60,0.16353887399463807,0.24932975871313673,0.5871313672922251,0.9195710455764075,0.08042895442359249
1602,1284,1000,284,1078,206,0.778816199376947,0.22118380062305296,0.839563862928349,0.16043613707165108,1291,278,450,563,1145,146,0.21533694810224632,0.34856700232378,0.4360960495739737,0.8869093725793958,0.11309062742060419
1603,350,233,117,307,43,0.6657142857142857,0.3342857142857143,0.8771428571428571,0.12285714285714286,757,182,253,322,640,117,0.2404227212681638,0.3342140026420079,0.42536327608982827,0.845442536327609,0.154557463672391
1604,1285,998,287,1076,209,0.7766536964980545,0.22334630350194554,0.8373540856031129,0.16264591439688716,1172,102,233,837,894,278,0.08703071672354949,0.19880546075085323,0.7141638225255973,0.7627986348122867,0.23720136518771331
1605,1292,998,294,1083,209,0.7724458204334366,0.22755417956656346,0.8382352941176471,0.16176470588235295,1177,102,234,841,899,278,0.08666100254885302,0.1988105352591334,0.7145284621920136,0.7638062871707731,0.23619371282922685
1606,577,413,164,484,93,0.7157712305025996,0.28422876949740034,0.8388214904679376,0.1611785095320624,1109,244,287,578,974,135,0.2200180342651037,0.2587917042380523,0.521190261496844,0.8782687105500451,0.12173128944995491
1607,562,344,218,445,117,0.6120996441281139,0.3879003558718861,0.791814946619217,0.20818505338078291,815,115,248,452,741,74,0.1411042944785276,0.3042944785276074,0.554601226993865,0.90920245398773,0.09079754601226994
1608,818,579,239,661,157,0.7078239608801956,0.2921760391198044,0.8080684596577017,0.19193154034229828,1099,101,209,789,872,227,0.09190172884440401,0.19017288444040037,0.7179253867151957,0.7934485896269335,0.20655141037306643
1609,1511,1263,248,1295,216,0.8358702845797485,0.16412971542025148,0.85704831237591,0.14295168762409,1198,181,326,691,972,226,0.15108514190317196,0.27212020033388984,0.5767946577629383,0.8113522537562604,0.18864774624373956
1610,3098,2670,428,2479,619,0.8618463524854745,0.1381536475145255,0.8001936733376371,0.1998063266623628,1692,207,508,977,1323,369,0.12234042553191489,0.30023640661938533,0.5774231678486997,0.7819148936170213,0.21808510638297873
1611,323,198,125,283,40,0.6130030959752322,0.38699690402476783,0.8761609907120743,0.1238390092879257,725,120,188,417,667,58,0.16551724137931034,0.2593103448275862,0.5751724137931035,0.92,0.08
1612,1170,880,290,912,258,0.7521367521367521,0.24786324786324787,0.7794871794871795,0.2205128205128205,1161,102,231,828,883,278,0.08785529715762273,0.19896640826873385,0.7131782945736435,0.7605512489233419,0.23944875107665806
1613,1509,1260,249,1293,216,0.8349900596421471,0.16500994035785288,0.856858846918489,0.14314115308151093,1203,181,333,689,977,226,0.15045719035743974,0.27680798004987534,0.572734829592685,0.8121363258520365,0.18786367414796343
1614,380,191,189,157,223,0.5026315789473684,0.49736842105263157,0.4131578947368421,0.5868421052631579,506,224,242,40,506,0,0.4426877470355731,0.4782608695652174,0.07905138339920949,1.0,0.0
1615,1543,1291,252,1322,221,0.8366817887232664,0.16331821127673363,0.8567725210628645,0.14322747893713544,1167,166,326,675,941,226,0.14224507283633248,0.27934875749785776,0.5784061696658098,0.8063410454155956,0.19365895458440446
1616,837,575,262,674,163,0.6869772998805257,0.3130227001194743,0.8052568697729988,0.19474313022700118,1077,103,205,769,850,227,0.09563602599814298,0.1903435468895079,0.7140204271123491,0.7892293407613742,0.2107706592386258
1617,1172,879,293,914,258,0.75,0.25,0.7798634812286689,0.22013651877133106,1160,102,228,830,882,278,0.08793103448275862,0.19655172413793104,0.7155172413793104,0.7603448275862069,0.2396551724137931
1618,1162,880,282,904,258,0.7573149741824441,0.24268502581755594,0.7779690189328744,0.22203098106712565,1156,102,230,824,878,278,0.08823529411764706,0.19896193771626297,0.71280276816609,0.759515570934256,0.24048442906574394
1619,1293,998,295,1084,209,0.7718484145398299,0.22815158546017014,0.8383604021655066,0.16163959783449341,1175,102,231,842,897,278,0.08680851063829788,0.19659574468085106,0.7165957446808511,0.7634042553191489,0.23659574468085107
1620,1296,998,298,1087,209,0.7700617283950617,0.22993827160493827,0.8387345679012346,0.16126543209876543,1178,102,232,844,900,278,0.0865874363327674,0.1969439728353141,0.7164685908319185,0.7640067911714771,0.23599320882852293
1621,455,286,169,373,82,0.6285714285714286,0.37142857142857144,0.8197802197802198,0.18021978021978022,792,104,196,492,719,73,0.13131313131313133,0.2474747474747475,0.6212121212121212,0.9078282828282829,0.09217171717171717
1622,316,193,123,277,39,0.6107594936708861,0.38924050632911394,0.8765822784810127,0.12341772151898735,598,147,199,252,546,52,0.24581939799331104,0.33277591973244147,0.4214046822742475,0.9130434782608695,0.08695652173913043
1623,177,119,58,87,90,0.672316384180791,0.327683615819209,0.4915254237288136,0.5084745762711864,95,0,70,25,94,1,0.0,0.7368421052631579,0.2631578947368421,0.9894736842105263,0.010526315789473684
1624,1293,1001,292,1082,211,0.774168600154679,0.22583139984532097,0.8368136117556071,0.16318638824439288,1176,102,233,841,898,278,0.08673469387755102,0.19812925170068027,0.7151360544217688,0.7636054421768708,0.23639455782312926
1625,405,250,155,315,90,0.6172839506172839,0.38271604938271603,0.7777777777777778,0.2222222222222222,528,177,191,160,520,8,0.3352272727272727,0.36174242424242425,0.30303030303030304,0.9848484848484849,0.015151515151515152
1626,1166,878,288,911,255,0.7530017152658662,0.2469982847341338,0.7813036020583191,0.21869639794168097,1158,102,229,827,880,278,0.08808290155440414,0.19775474956822106,0.7141623488773747,0.7599309153713298,0.24006908462867013
1627,377,239,138,323,54,0.6339522546419099,0.3660477453580902,0.8567639257294429,0.14323607427055704,645,139,192,314,591,54,0.21550387596899226,0.29767441860465116,0.4868217054263566,0.9162790697674419,0.08372093023255814
1628,555,333,222,434,121,0.6,0.4,0.781981981981982,0.218018018018018,757,104,238,415,683,74,0.13738441215323646,0.3143989431968296,0.5482166446499339,0.9022457067371202,0.0977542932628798
1629,1254,1031,223,1097,157,0.8221690590111643,0.17783094098883573,0.8748006379585327,0.1251993620414673,1054,149,276,629,833,221,0.1413662239089184,0.2618595825426945,0.5967741935483871,0.7903225806451613,0.20967741935483872
1630,836,624,212,747,89,0.7464114832535885,0.2535885167464115,0.8935406698564593,0.10645933014354067,956,143,233,580,756,200,0.14958158995815898,0.24372384937238495,0.606694560669456,0.7907949790794979,0.20920502092050208
1631,1579,1314,265,1355,224,0.8321722609246358,0.16782773907536416,0.8581380620645979,0.14186193793540217,1181,169,328,684,955,226,0.14309906858594412,0.2777307366638442,0.5791701947502117,0.8086367485182049,0.1913632514817951
1632,391,53,338,233,158,0.13554987212276215,0.8644501278772379,0.5959079283887468,0.4040920716112532,159,3,62,94,158,1,0.018867924528301886,0.389937106918239,0.5911949685534591,0.9937106918238994,0.006289308176100629
1633,388,204,184,311,77,0.5257731958762887,0.4742268041237113,0.8015463917525774,0.19845360824742267,632,101,162,369,566,66,0.15981012658227847,0.2563291139240506,0.5838607594936709,0.8955696202531646,0.10443037974683544
1634,345,205,140,296,49,0.5942028985507246,0.4057971014492754,0.8579710144927536,0.14202898550724638,658,157,215,286,605,53,0.23860182370820668,0.32674772036474165,0.43465045592705165,0.9194528875379939,0.08054711246200608
1635,2061,1693,368,1760,301,0.8214459000485201,0.17855409995147986,0.853954391072295,0.146045608927705,1512,244,442,826,1194,318,0.16137566137566137,0.2923280423280423,0.5462962962962963,0.7896825396825397,0.21031746031746032
1636,1289,998,291,1080,209,0.7742435996896819,0.22575640031031807,0.8378588052754073,0.1621411947245927,1176,102,233,841,898,278,0.08673469387755102,0.19812925170068027,0.7151360544217688,0.7636054421768708,0.23639455782312926
1637,642,436,206,516,126,0.6791277258566978,0.32087227414330216,0.8037383177570093,0.19626168224299065,1283,308,355,620,1153,130,0.24006235385814498,0.2766952455183164,0.48324240062353857,0.8986749805144193,0.10132501948558068
1638,1254,1033,221,1098,156,0.8237639553429027,0.1762360446570973,0.8755980861244019,0.12440191387559808,1074,155,280,639,852,222,0.14432029795158285,0.260707635009311,0.5949720670391061,0.7932960893854749,0.20670391061452514
1639,324,205,119,282,42,0.6327160493827161,0.36728395061728397,0.8703703703703703,0.12962962962962962,692,137,233,322,575,117,0.19797687861271676,0.33670520231213874,0.4653179190751445,0.8309248554913294,0.16907514450867053
1640,636,459,177,538,98,0.7216981132075472,0.2783018867924528,0.8459119496855346,0.1540880503144654,1196,245,280,671,1032,164,0.2048494983277592,0.23411371237458195,0.5610367892976589,0.862876254180602,0.13712374581939799
1641,839,574,265,676,163,0.6841477949940405,0.31585220500595945,0.8057210965435042,0.19427890345649582,1089,103,212,774,862,227,0.0945821854912764,0.19467401285583102,0.7107438016528925,0.7915518824609734,0.20844811753902662
1642,1282,998,284,1073,209,0.7784711388455539,0.22152886115444617,0.8369734789391575,0.16302652106084242,1166,102,230,834,888,278,0.08747855917667238,0.19725557461406518,0.7152658662092625,0.7615780445969125,0.23842195540308747
1643,1259,1043,216,1101,158,0.8284352660841938,0.1715647339158062,0.8745035742652899,0.1254964257347101,1066,149,282,635,844,222,0.1397748592870544,0.26454033771106944,0.5956848030018762,0.7917448405253283,0.20825515947467166
1644,340,214,126,296,44,0.6294117647058823,0.37058823529411766,0.8705882352941177,0.12941176470588237,652,176,212,264,599,53,0.26993865030674846,0.32515337423312884,0.4049079754601227,0.9187116564417178,0.08128834355828221
1645,836,607,229,673,163,0.7260765550239234,0.27392344497607657,0.8050239234449761,0.19497607655502391,854,128,324,402,786,68,0.14988290398126464,0.3793911007025761,0.4707259953161593,0.9203747072599532,0.07962529274004684
1646,982,657,325,745,237,0.6690427698574338,0.33095723014256617,0.7586558044806517,0.24134419551934827,1025,129,332,564,878,147,0.12585365853658537,0.32390243902439025,0.5502439024390244,0.8565853658536585,0.14341463414634145
1647,591,370,221,460,131,0.626057529610829,0.3739424703891709,0.7783417935702199,0.22165820642978004,753,113,229,411,681,72,0.150066401062417,0.3041168658698539,0.545816733067729,0.9043824701195219,0.09561752988047809
1648,443,279,164,360,83,0.6297968397291196,0.37020316027088035,0.8126410835214447,0.1873589164785553,783,107,183,493,708,75,0.13665389527458494,0.23371647509578544,0.6296296296296297,0.9042145593869731,0.09578544061302682
1649,1243,1033,210,1087,156,0.831053901850362,0.16894609814963799,0.8744971842316975,0.1255028157683025,1078,155,280,643,854,224,0.1437847866419295,0.2597402597402597,0.5964749536178108,0.7922077922077922,0.2077922077922078
1650,1283,998,285,1074,209,0.7778643803585347,0.2221356196414653,0.8371005455962588,0.16289945440374123,1165,102,229,834,887,278,0.08755364806866953,0.1965665236051502,0.7158798283261802,0.76137339055794,0.23862660944206007
1651,343,225,118,288,55,0.6559766763848397,0.34402332361516036,0.8396501457725948,0.16034985422740525,621,186,188,247,613,8,0.2995169082125604,0.3027375201288245,0.3977455716586151,0.9871175523349437,0.01288244766505636
1652,1518,1271,247,1300,218,0.8372859025032938,0.1627140974967062,0.8563899868247694,0.14361001317523056,1185,175,323,687,961,224,0.14767932489451477,0.27257383966244725,0.579746835443038,0.810970464135021,0.1890295358649789
1653,1242,1031,211,1085,157,0.8301127214170693,0.16988727858293076,0.8735909822866345,0.12640901771336555,1040,149,259,632,819,221,0.14326923076923076,0.24903846153846154,0.6076923076923076,0.7875,0.2125
1654,1503,1258,245,1290,213,0.8369926813040586,0.16300731869594146,0.8582834331337326,0.14171656686626746,1198,181,327,690,972,226,0.15108514190317196,0.27295492487479134,0.5759599332220368,0.8113522537562604,0.18864774624373956
1655,1533,1280,253,1312,221,0.8349641226353555,0.16503587736464448,0.8558382257012394,0.1441617742987606,1205,181,326,698,979,226,0.15020746887966804,0.2705394190871369,0.5792531120331951,0.812448132780083,0.187551867219917
1656,575,399,176,473,102,0.6939130434782609,0.3060869565217391,0.8226086956521739,0.17739130434782607,1351,296,327,728,1126,225,0.21909696521095484,0.24204293116210215,0.538860103626943,0.8334566987416728,0.16654330125832717
1657,1503,1255,248,1287,216,0.8349966733200266,0.1650033266799734,0.8562874251497006,0.1437125748502994,1187,178,322,687,962,225,0.14995787700084245,0.2712721145745577,0.5787700084245998,0.81044650379107,0.18955349620893008
1658,316,193,123,275,41,0.6107594936708861,0.38924050632911394,0.870253164556962,0.12974683544303797,579,131,195,253,527,52,0.22625215889464595,0.33678756476683935,0.4369602763385147,0.9101899827288429,0.08981001727115717
1659,507,335,172,434,73,0.6607495069033531,0.33925049309664695,0.8560157790927022,0.14398422090729784,460,34,115,311,453,7,0.07391304347826087,0.25,0.6760869565217391,0.9847826086956522,0.015217391304347827
1660,149,85,64,59,90,0.5704697986577181,0.42953020134228187,0.3959731543624161,0.6040268456375839,291,129,119,43,291,0,0.44329896907216493,0.40893470790378006,0.14776632302405499,1.0,0.0
1661,446,344,102,405,41,0.7713004484304933,0.22869955156950672,0.9080717488789237,0.09192825112107623,644,57,144,443,528,116,0.08850931677018634,0.2236024844720497,0.687888198757764,0.8198757763975155,0.18012422360248448
1662,1167,878,289,912,255,0.7523564695801199,0.24764353041988005,0.781491002570694,0.2185089974293059,1166,102,234,830,888,278,0.08747855917667238,0.2006861063464837,0.7118353344768439,0.7615780445969125,0.23842195540308747
1663,650,455,195,517,133,0.7,0.3,0.7953846153846154,0.20461538461538462,795,106,310,379,727,68,0.13333333333333333,0.389937106918239,0.4767295597484277,0.9144654088050315,0.08553459119496855
1664,343,217,126,301,42,0.6326530612244898,0.3673469387755102,0.8775510204081632,0.12244897959183673,550,113,180,257,497,53,0.20545454545454545,0.32727272727272727,0.4672727272727273,0.9036363636363637,0.09636363636363636
1665,321,197,124,274,47,0.6137071651090342,0.3862928348909657,0.8535825545171339,0.14641744548286603,771,130,202,439,714,57,0.16861219195849547,0.2619974059662776,0.569390402075227,0.9260700389105059,0.07392996108949416
1666,1451,1235,216,1269,182,0.8511371467953136,0.14886285320468642,0.8745692625775328,0.12543073742246727,1069,149,286,634,847,222,0.13938260056127222,0.2675397567820393,0.5930776426566885,0.7923292797006548,0.2076707202993452
1667,369,237,132,322,47,0.6422764227642277,0.35772357723577236,0.8726287262872628,0.12737127371273713,824,125,222,477,702,122,0.15169902912621358,0.26941747572815533,0.5788834951456311,0.8519417475728155,0.14805825242718446
1668,894,648,246,732,162,0.7248322147651006,0.2751677852348993,0.8187919463087249,0.18120805369127516,1149,179,336,634,928,221,0.15578764142732812,0.2924281984334204,0.5517841601392516,0.8076588337684943,0.19234116623150566
1669,320,193,127,279,41,0.603125,0.396875,0.871875,0.128125,574,126,184,264,521,53,0.21951219512195122,0.3205574912891986,0.45993031358885017,0.9076655052264808,0.09233449477351917
1670,314,182,132,275,39,0.5796178343949044,0.42038216560509556,0.8757961783439491,0.12420382165605096,792,126,209,457,731,61,0.1590909090909091,0.2638888888888889,0.577020202020202,0.922979797979798,0.07702020202020202
1671,476,282,194,393,83,0.592436974789916,0.40756302521008403,0.8256302521008403,0.17436974789915966,798,95,232,471,726,72,0.11904761904761904,0.2907268170426065,0.5902255639097744,0.9097744360902256,0.09022556390977443
1672,1168,878,290,913,255,0.7517123287671232,0.2482876712328767,0.7816780821917808,0.2183219178082192,1153,102,225,826,875,278,0.08846487424111014,0.19514310494362533,0.7163920208152645,0.7588898525585429,0.24111014744145706
1673,1504,1256,248,1288,216,0.8351063829787234,0.16489361702127658,0.8563829787234043,0.14361702127659576,1198,181,324,693,972,226,0.15108514190317196,0.2704507512520868,0.5784641068447413,0.8113522537562604,0.18864774624373956
1674,1077,856,221,881,196,0.7948003714020427,0.2051996285979573,0.8180129990714949,0.18198700092850512,1232,230,429,573,1066,166,0.18668831168831168,0.3482142857142857,0.4650974025974026,0.8652597402597403,0.13474025974025974
1675,406,270,136,358,48,0.6650246305418719,0.33497536945812806,0.8817733990147784,0.11822660098522167,922,115,245,562,789,133,0.12472885032537961,0.26572668112798264,0.6095444685466378,0.8557483731019523,0.1442516268980477
1676,222,95,127,193,29,0.42792792792792794,0.5720720720720721,0.8693693693693694,0.13063063063063063,593,76,129,388,408,185,0.1281618887015177,0.2175379426644182,0.654300168634064,0.688026981450253,0.31197301854974707
1677,1253,1031,222,1097,156,0.8228252194732641,0.17717478052673583,0.8754988028731046,0.12450119712689545,1069,155,284,630,848,221,0.1449953227315248,0.2656688493919551,0.5893358278765201,0.7932647333956969,0.20673526660430308
1678,1097,857,240,883,214,0.7812215132178669,0.2187784867821331,0.804922515952598,0.195077484047402,1194,201,390,603,1014,180,0.16834170854271358,0.32663316582914576,0.5050251256281407,0.8492462311557789,0.1507537688442211
1679,452,297,155,384,68,0.6570796460176991,0.34292035398230086,0.8495575221238938,0.1504424778761062,643,160,226,257,590,53,0.24883359253499224,0.3514774494556765,0.39968895800933124,0.9175738724727839,0.08242612752721618
1680,835,575,260,672,163,0.688622754491018,0.31137724550898205,0.8047904191616766,0.19520958083832335,1067,103,199,765,840,227,0.09653233364573571,0.18650421743205248,0.7169634489222118,0.7872539831302718,0.21274601686972822
1681,670,469,201,539,131,0.7,0.3,0.8044776119402985,0.19552238805970149,792,105,300,387,724,68,0.13257575757575757,0.3787878787878788,0.48863636363636365,0.9141414141414141,0.08585858585858586
1682,799,558,241,655,144,0.6983729662077597,0.3016270337922403,0.8197747183979975,0.1802252816020025,1070,98,210,762,843,227,0.09158878504672897,0.19626168224299065,0.7121495327102804,0.7878504672897196,0.21214953271028036
1683,900,657,243,751,149,0.73,0.27,0.8344444444444444,0.16555555555555557,946,97,207,642,768,178,0.10253699788583509,0.21881606765327696,0.678646934460888,0.8118393234672304,0.18816067653276955
1684,837,574,263,674,163,0.6857825567502986,0.3142174432497013,0.8052568697729988,0.19474313022700118,1081,103,206,772,854,227,0.09528214616096208,0.19056429232192415,0.7141535615171137,0.790009250693802,0.20999074930619796
1685,839,575,264,676,163,0.6853396901072706,0.3146603098927294,0.8057210965435042,0.19427890345649582,1084,103,209,772,857,227,0.09501845018450185,0.19280442804428044,0.7121771217712177,0.790590405904059,0.20940959409594095
1686,513,301,212,404,109,0.5867446393762183,0.41325536062378165,0.7875243664717348,0.2124756335282651,804,121,262,421,731,73,0.15049751243781095,0.32587064676616917,0.5236318407960199,0.9092039800995025,0.09079601990049752
1687,310,198,112,269,41,0.6387096774193548,0.36129032258064514,0.867741935483871,0.13225806451612904,740,172,197,371,684,56,0.23243243243243245,0.2662162162162162,0.5013513513513513,0.9243243243243243,0.07567567567567568
1688,324,198,126,273,51,0.6111111111111112,0.3888888888888889,0.8425925925925926,0.1574074074074074,787,139,206,442,728,59,0.17662007623888182,0.2617534942820839,0.5616264294790343,0.9250317662007624,0.07496823379923762
1689,691,493,198,557,134,0.7134587554269175,0.2865412445730825,0.8060781476121563,0.1939218523878437,882,139,349,394,813,69,0.15759637188208617,0.3956916099773243,0.4467120181405896,0.9217687074829932,0.0782312925170068
1690,375,103,272,286,89,0.27466666666666667,0.7253333333333334,0.7626666666666667,0.23733333333333334,492,0,268,224,488,4,0.0,0.5447154471544715,0.45528455284552843,0.991869918699187,0.008130081300813009
1691,376,230,146,330,46,0.6117021276595744,0.3882978723404255,0.8776595744680851,0.12234042553191489,757,125,258,374,639,118,0.16512549537648613,0.34081902245706736,0.4940554821664465,0.8441215323645971,0.15587846763540292
1692,309,186,123,268,41,0.6019417475728155,0.39805825242718446,0.8673139158576052,0.13268608414239483,750,124,185,441,693,57,0.16533333333333333,0.24666666666666667,0.588,0.924,0.076
1693,5788,5101,687,4916,872,0.8813061506565307,0.11869384934346924,0.8493434692467173,0.15065653075328264,2284,200,573,1511,1791,493,0.08756567425569177,0.2508756567425569,0.6615586690017513,0.7841506129597198,0.2158493870402802
1694,836,575,261,673,163,0.687799043062201,0.31220095693779903,0.8050239234449761,0.19497607655502391,1071,103,200,768,844,227,0.096171802054155,0.18674136321195145,0.7170868347338936,0.7880485527544351,0.2119514472455649
1695,0,0,0,0,0,0.0,0.0,0.0,0.0,473,269,164,40,473,0,0.5687103594080338,0.346723044397463,0.08456659619450317,1.0,0.0
1696,384,201,183,294,90,0.5234375,0.4765625,0.765625,0.234375,648,111,178,359,580,68,0.1712962962962963,0.27469135802469136,0.5540123456790124,0.8950617283950617,0.10493827160493827
1697,569,387,182,468,101,0.680140597539543,0.31985940246045697,0.8224956063268892,0.17750439367311072,1083,279,293,511,1015,68,0.25761772853185594,0.270544783010157,0.47183748845798706,0.9372114496768237,0.06278855032317636
1698,1167,878,289,912,255,0.7523564695801199,0.24764353041988005,0.781491002570694,0.2185089974293059,1166,102,234,830,888,278,0.08747855917667238,0.2006861063464837,0.7118353344768439,0.7615780445969125,0.23842195540308747
1699,773,539,234,607,166,0.6972833117723156,0.3027166882276843,0.7852522639068564,0.2147477360931436,1056,136,318,602,824,232,0.12878787878787878,0.30113636363636365,0.5700757575757576,0.7803030303030303,0.2196969696969697
1700,1287,1003,284,1006,281,0.7793317793317793,0.22066822066822067,0.7816627816627817,0.21833721833721834,1156,102,230,824,878,278,0.08823529411764706,0.19896193771626297,0.71280276816609,0.759515570934256,0.24048442906574394
1701,1261,978,283,1045,216,0.7755749405233942,0.22442505947660588,0.8287073750991277,0.17129262490087233,1214,228,410,576,1066,148,0.18780889621087316,0.33772652388797364,0.4744645799011532,0.8780889621087314,0.12191103789126853
1702,350,231,119,295,55,0.66,0.34,0.8428571428571429,0.15714285714285714,537,128,151,258,528,9,0.2383612662942272,0.2811918063314711,0.48044692737430167,0.9832402234636871,0.01675977653631285
1703,1502,1253,249,1284,218,0.8342210386151797,0.16577896138482023,0.8548601864181092,0.14513981358189082,1204,175,337,692,979,225,0.14534883720930233,0.2799003322259136,0.574750830564784,0.8131229235880398,0.18687707641196014
1704,468,294,174,387,81,0.6282051282051282,0.3717948717948718,0.8269230769230769,0.17307692307692307,836,105,207,524,764,72,0.1255980861244019,0.24760765550239233,0.6267942583732058,0.9138755980861244,0.0861244019138756
1705,729,531,198,602,127,0.7283950617283951,0.2716049382716049,0.8257887517146777,0.17421124828532236,1146,228,370,548,970,176,0.19895287958115182,0.3228621291448517,0.4781849912739965,0.8464223385689355,0.15357766143106458
1706,2723,2323,400,2255,468,0.8531031950055087,0.14689680499449137,0.8281307381564451,0.17186926184355492,1597,267,454,876,1382,215,0.16718847839699436,0.28428303068252975,0.5485284909204758,0.8653725735754539,0.13462742642454603
1707,1166,878,288,911,255,0.7530017152658662,0.2469982847341338,0.7813036020583191,0.21869639794168097,1158,102,229,827,880,278,0.08808290155440414,0.19775474956822106,0.7141623488773747,0.7599309153713298,0.24006908462867013
1708,871,599,272,681,190,0.687715269804822,0.31228473019517794,0.7818599311136625,0.21814006888633755,1106,136,341,629,883,223,0.12296564195298372,0.30831826401446655,0.5687160940325497,0.798372513562387,0.20162748643761302
1709,356,150,206,271,85,0.42134831460674155,0.5786516853932584,0.7612359550561798,0.23876404494382023,686,98,195,393,617,69,0.14285714285714285,0.28425655976676384,0.5728862973760933,0.8994169096209913,0.10058309037900874
1710,313,191,122,272,41,0.610223642172524,0.38977635782747605,0.8690095846645367,0.13099041533546327,612,121,188,303,557,55,0.1977124183006536,0.30718954248366015,0.4950980392156863,0.9101307189542484,0.08986928104575163
1711,824,625,199,735,89,0.758495145631068,0.24150485436893204,0.8919902912621359,0.10800970873786407,959,142,229,588,758,201,0.1480709071949948,0.23879040667361837,0.6131386861313869,0.7904066736183525,0.20959332638164754
1712,578,393,185,462,116,0.6799307958477508,0.32006920415224915,0.7993079584775087,0.20069204152249134,1032,270,250,512,965,67,0.2616279069767442,0.24224806201550386,0.49612403100775193,0.935077519379845,0.06492248062015504
1713,467,230,237,365,102,0.4925053533190578,0.5074946466809421,0.7815845824411135,0.21841541755888652,1307,99,192,1016,868,439,0.0757459831675593,0.14690130068859986,0.7773527161438408,0.6641162968630452,0.33588370313695487
1714,338,207,131,296,42,0.6124260355029586,0.3875739644970414,0.8757396449704142,0.1242603550295858,658,153,213,292,605,53,0.23252279635258358,0.32370820668693007,0.44376899696048633,0.9194528875379939,0.08054711246200608
1715,1168,877,291,913,255,0.7508561643835616,0.24914383561643835,0.7816780821917808,0.2183219178082192,1166,102,232,832,888,278,0.08747855917667238,0.19897084048027444,0.7135506003430532,0.7615780445969125,0.23842195540308747
1716,1303,974,329,1044,259,0.7475057559478128,0.25249424405218723,0.8012279355333844,0.1987720644666155,1229,262,427,540,1101,128,0.21318144833197722,0.34743694060211555,0.43938161106590723,0.8958502847843776,0.10414971521562245
1717,539,339,200,420,119,0.6289424860853432,0.37105751391465674,0.7792207792207793,0.22077922077922077,649,94,189,366,580,69,0.1448382126348228,0.29121725731895226,0.5639445300462249,0.8936825885978429,0.10631741140215717
1718,1292,998,294,1083,209,0.7724458204334366,0.22755417956656346,0.8382352941176471,0.16176470588235295,1179,102,234,843,901,278,0.08651399491094147,0.1984732824427481,0.7150127226463104,0.7642069550466497,0.2357930449533503
1719,1513,1265,248,1296,217,0.8360872438863186,0.16391275611368142,0.8565763384005287,0.14342366159947126,1143,157,313,673,918,225,0.1373578302712161,0.27384076990376205,0.5888013998250219,0.8031496062992126,0.1968503937007874
1720,557,386,171,452,105,0.6929982046678635,0.30700179533213645,0.8114901256732495,0.18850987432675045,985,247,255,483,921,64,0.25076142131979695,0.25888324873096447,0.4903553299492386,0.9350253807106599,0.0649746192893401
1721,389,208,181,296,93,0.5347043701799485,0.4652956298200514,0.7609254498714653,0.2390745501285347,563,87,146,330,497,66,0.15452930728241562,0.25932504440497334,0.5861456483126111,0.8827708703374778,0.1172291296625222
1722,1297,1001,296,1086,211,0.7717810331534309,0.228218966846569,0.8373168851195065,0.16268311488049345,1176,102,233,841,898,278,0.08673469387755102,0.19812925170068027,0.7151360544217688,0.7636054421768708,0.23639455782312926
1723,460,290,170,377,83,0.6304347826086957,0.3695652173913043,0.8195652173913044,0.18043478260869567,763,103,192,468,691,72,0.1349934469200524,0.2516382699868938,0.6133682830930537,0.9056356487549148,0.09436435124508519
1724,688,499,189,557,131,0.7252906976744186,0.2747093023255814,0.809593023255814,0.19040697674418605,825,119,332,374,756,69,0.14424242424242426,0.4024242424242424,0.4533333333333333,0.9163636363636364,0.08363636363636363
1725,1517,1270,247,1302,215,0.8371786420566908,0.16282135794330915,0.8582729070533949,0.14172709294660515,1201,181,327,693,975,226,0.15070774354704414,0.2722731057452123,0.5770191507077436,0.8118234804329725,0.18817651956702747
1726,1290,1001,289,1079,211,0.775968992248062,0.224031007751938,0.8364341085271317,0.1635658914728682,1168,102,230,836,890,278,0.08732876712328767,0.1969178082191781,0.7157534246575342,0.761986301369863,0.238013698630137
1727,599,414,185,497,102,0.6911519198664441,0.3088480801335559,0.8297161936560935,0.17028380634390652,1396,330,371,695,1169,227,0.23638968481375358,0.26575931232091693,0.4978510028653295,0.8373925501432665,0.16260744985673353
1728,639,400,239,474,165,0.6259780907668232,0.37402190923317685,0.7417840375586855,0.25821596244131456,914,150,238,526,785,129,0.16411378555798686,0.2603938730853392,0.5754923413566739,0.8588621444201313,0.14113785557986872
1729,903,680,223,806,97,0.7530454042081949,0.2469545957918051,0.8925802879291251,0.10741971207087486,997,137,263,597,795,202,0.1374122367101304,0.2637913741223671,0.5987963891675026,0.7973921765295887,0.20260782347041123
1730,3006,2559,447,2477,529,0.8512974051896207,0.14870259481037923,0.824018629407851,0.17598137059214902,1404,248,462,694,1204,200,0.17663817663817663,0.32905982905982906,0.4943019943019943,0.8575498575498576,0.14245014245014245
1731,368,240,128,300,68,0.6521739130434783,0.34782608695652173,0.8152173913043478,0.18478260869565216,591,150,160,281,581,10,0.25380710659898476,0.2707275803722504,0.4754653130287648,0.9830795262267343,0.01692047377326565
1732,1290,998,292,1081,209,0.7736434108527132,0.22635658914728682,0.837984496124031,0.162015503875969,1176,102,234,840,898,278,0.08673469387755102,0.1989795918367347,0.7142857142857143,0.7636054421768708,0.23639455782312926
1733,355,236,119,297,58,0.6647887323943662,0.3352112676056338,0.8366197183098592,0.16338028169014085,655,180,197,278,644,11,0.2748091603053435,0.300763358778626,0.42442748091603055,0.983206106870229,0.016793893129770993
1734,551,369,182,452,99,0.6696914700544465,0.33030852994555354,0.8203266787658802,0.17967332123411978,968,210,250,508,904,64,0.21694214876033058,0.25826446280991733,0.5247933884297521,0.9338842975206612,0.06611570247933884
1735,446,282,164,363,83,0.6322869955156951,0.36771300448430494,0.8139013452914798,0.1860986547085202,754,104,190,460,682,72,0.13793103448275862,0.2519893899204244,0.610079575596817,0.9045092838196287,0.09549071618037135
1736,1288,998,290,1079,209,0.7748447204968945,0.2251552795031056,0.8377329192546584,0.1622670807453416,1163,102,226,835,885,278,0.08770421324161651,0.1943250214961307,0.7179707652622528,0.7609630266552021,0.23903697334479793
1737,490,305,185,408,82,0.6224489795918368,0.37755102040816324,0.8326530612244898,0.1673469387755102,822,104,211,507,749,73,0.12652068126520682,0.25669099756691,0.6167883211678832,0.9111922141119222,0.08880778588807786
1738,1167,878,289,912,255,0.7523564695801199,0.24764353041988005,0.781491002570694,0.2185089974293059,1163,102,232,829,885,278,0.08770421324161651,0.1994840928632846,0.7128116938950989,0.7609630266552021,0.23903697334479793
1739,636,423,213,507,129,0.6650943396226415,0.33490566037735847,0.7971698113207547,0.2028301886792453,930,185,235,510,865,65,0.1989247311827957,0.25268817204301075,0.5483870967741935,0.9301075268817204,0.06989247311827956
1740,1499,1247,252,1283,216,0.8318879252835224,0.16811207471647766,0.8559039359573049,0.14409606404269512,1199,181,331,687,974,225,0.15095913261050875,0.27606338615512926,0.572977481234362,0.8123436196830692,0.18765638031693077
1741,404,188,216,315,89,0.46534653465346537,0.5346534653465347,0.7797029702970297,0.2202970297029703,699,92,214,393,626,73,0.13161659513590845,0.3061516452074392,0.5622317596566524,0.8955650929899857,0.1044349070100143
1742,339,213,126,294,45,0.6283185840707964,0.37168141592920356,0.8672566371681416,0.13274336283185842,734,141,239,354,616,118,0.19209809264305178,0.32561307901907355,0.4822888283378747,0.8392370572207084,0.16076294277929154
1743,458,300,158,389,69,0.6550218340611353,0.34497816593886466,0.8493449781659389,0.15065502183406113,751,144,203,404,692,59,0.19174434087882822,0.27030625832223704,0.5379494007989347,0.9214380825565912,0.07856191744340879
1744,475,289,186,376,99,0.608421052631579,0.391578947368421,0.791578947368421,0.20842105263157895,802,102,199,501,728,74,0.12718204488778054,0.24812967581047382,0.6246882793017456,0.9077306733167082,0.09226932668329177
1745,315,185,130,275,40,0.5873015873015873,0.4126984126984127,0.873015873015873,0.12698412698412698,629,151,212,266,577,52,0.24006359300476948,0.3370429252782194,0.42289348171701113,0.9173290937996821,0.08267090620031796
1746,322,195,127,282,40,0.6055900621118012,0.3944099378881988,0.8757763975155279,0.12422360248447205,636,158,211,267,584,52,0.24842767295597484,0.33176100628930816,0.419811320754717,0.9182389937106918,0.08176100628930817
1747,453,279,174,372,81,0.6158940397350994,0.3841059602649007,0.8211920529801324,0.17880794701986755,783,106,203,474,712,71,0.13537675606641125,0.25925925925925924,0.6053639846743295,0.909323116219668,0.09067688378033206
1748,805,559,246,657,148,0.6944099378881987,0.30559006211180123,0.8161490683229814,0.18385093167701863,1080,99,214,767,853,227,0.09166666666666666,0.19814814814814816,0.7101851851851851,0.7898148148148149,0.2101851851851852
1749,1289,998,291,1080,209,0.7742435996896819,0.22575640031031807,0.8378588052754073,0.1621411947245927,1174,102,233,839,896,278,0.0868824531516184,0.19846678023850084,0.7146507666098807,0.7632027257240205,0.23679727427597955
1750,359,228,131,309,50,0.6350974930362117,0.3649025069637883,0.8607242339832869,0.1392757660167131,763,157,239,367,646,117,0.20576671035386632,0.3132372214941022,0.48099606815203144,0.8466579292267365,0.15334207077326342
1751,466,294,172,385,81,0.630901287553648,0.36909871244635195,0.8261802575107297,0.17381974248927037,914,104,192,618,744,170,0.1137855579868709,0.2100656455142232,0.6761487964989059,0.8140043763676149,0.18599562363238512
1752,1290,998,292,1081,209,0.7736434108527132,0.22635658914728682,0.837984496124031,0.162015503875969,1176,102,234,840,898,278,0.08673469387755102,0.1989795918367347,0.7142857142857143,0.7636054421768708,0.23639455782312926
1753,1284,998,286,1075,209,0.7772585669781932,0.22274143302180685,0.8372274143302181,0.16277258566978192,1167,102,230,835,889,278,0.08740359897172237,0.19708654670094258,0.715509854327335,0.7617823479005998,0.23821765209940018
1754,563,385,178,460,103,0.6838365896980462,0.31616341030195383,0.8170515097690941,0.18294849023090587,1057,186,267,604,924,133,0.1759697256385998,0.25260170293282874,0.5714285714285714,0.8741721854304636,0.12582781456953643
1755,393,210,183,298,95,0.5343511450381679,0.46564885496183206,0.7582697201017812,0.24173027989821882,590,94,161,335,524,66,0.15932203389830507,0.27288135593220336,0.5677966101694916,0.888135593220339,0.11186440677966102
1756,1541,1288,253,1319,222,0.835820895522388,0.16417910447761194,0.8559377027903958,0.14406229720960415,1205,181,326,698,979,226,0.15020746887966804,0.2705394190871369,0.5792531120331951,0.812448132780083,0.187551867219917
1757,696,493,203,563,133,0.7083333333333334,0.2916666666666667,0.8089080459770115,0.1910919540229885,871,122,343,406,803,68,0.14006888633754305,0.39380022962112515,0.4661308840413318,0.9219288174512055,0.07807118254879448
1758,1171,880,291,913,258,0.7514944491887275,0.24850555081127243,0.7796754910333049,0.22032450896669514,1160,102,230,828,882,278,0.08793103448275862,0.19827586206896552,0.7137931034482758,0.7603448275862069,0.2396551724137931
1759,518,325,193,428,90,0.6274131274131274,0.37258687258687256,0.8262548262548263,0.17374517374517376,854,106,227,521,781,73,0.12412177985948478,0.265807962529274,0.6100702576112412,0.914519906323185,0.08548009367681499
1760,832,575,257,669,163,0.6911057692307693,0.3088942307692308,0.8040865384615384,0.19591346153846154,1073,103,204,766,846,227,0.09599254426840634,0.19012115563839702,0.7138863000931966,0.7884436160298229,0.21155638397017706
1761,801,556,245,674,127,0.6941323345817728,0.30586766541822724,0.8414481897627965,0.1585518102372035,1049,102,208,739,824,225,0.09723546234509056,0.1982840800762631,0.7044804575786463,0.7855100095328885,0.21448999046711154
1762,352,173,179,263,89,0.4914772727272727,0.5085227272727273,0.7471590909090909,0.2528409090909091,589,98,151,340,521,68,0.166383701188455,0.2563667232597623,0.5772495755517827,0.8845500848896435,0.11544991511035653
1763,605,411,194,490,115,0.6793388429752066,0.32066115702479336,0.8099173553719008,0.19008264462809918,1184,230,284,670,960,224,0.19425675675675674,0.23986486486486486,0.5658783783783784,0.8108108108108109,0.1891891891891892
1764,1251,1034,217,1092,159,0.8265387689848122,0.17346123101518784,0.8729016786570744,0.12709832134292565,1064,155,281,628,842,222,0.14567669172932332,0.2640977443609023,0.5902255639097744,0.7913533834586466,0.20864661654135339
1765,594,403,191,489,105,0.6784511784511784,0.32154882154882153,0.8232323232323232,0.17676767676767677,1081,229,303,549,954,127,0.211840888066605,0.2802960222016651,0.5078630897317299,0.8825161887141536,0.11748381128584644
1766,1651,1382,269,1406,245,0.837068443367656,0.16293155663234404,0.8516050878255602,0.14839491217443973,1268,234,415,619,1053,215,0.18454258675078863,0.3272870662460568,0.4881703470031546,0.830441640378549,0.1695583596214511
1767,353,226,127,304,49,0.6402266288951841,0.3597733711048159,0.8611898016997167,0.1388101983002833,736,143,191,402,677,59,0.19429347826086957,0.2595108695652174,0.5461956521739131,0.9198369565217391,0.08016304347826086
1768,327,207,120,285,42,0.6330275229357798,0.3669724770642202,0.8715596330275229,0.12844036697247707,647,116,216,315,530,117,0.17928902627511592,0.33384853168469864,0.4868624420401855,0.8191653786707882,0.18083462132921174
1769,340,211,129,293,47,0.6205882352941177,0.37941176470588234,0.861764705882353,0.13823529411764707,774,135,198,441,715,59,0.1744186046511628,0.2558139534883721,0.5697674418604651,0.9237726098191215,0.07622739018087855
1770,1285,998,287,1076,209,0.7766536964980545,0.22334630350194554,0.8373540856031129,0.16264591439688716,1175,102,233,840,897,278,0.08680851063829788,0.19829787234042554,0.7148936170212766,0.7634042553191489,0.23659574468085107
1771,1335,1095,240,1167,168,0.8202247191011236,0.1797752808988764,0.8741573033707866,0.1258426966292135,1100,155,301,644,878,222,0.1409090909090909,0.2736363636363636,0.5854545454545454,0.7981818181818182,0.2018181818181818
1772,426,285,141,367,59,0.6690140845070423,0.33098591549295775,0.8615023474178404,0.13849765258215962,812,121,231,460,689,123,0.14901477832512317,0.28448275862068967,0.5665024630541872,0.8485221674876847,0.15147783251231528
1773,318,197,121,278,40,0.6194968553459119,0.3805031446540881,0.8742138364779874,0.12578616352201258,611,156,195,260,558,53,0.2553191489361702,0.3191489361702128,0.425531914893617,0.9132569558101473,0.0867430441898527
1774,2412,2052,360,1968,444,0.8507462686567164,0.14925373134328357,0.8159203980099502,0.18407960199004975,1265,201,404,660,1075,190,0.15889328063241107,0.3193675889328063,0.5217391304347826,0.849802371541502,0.15019762845849802
1775,339,212,127,296,43,0.6253687315634219,0.3746312684365782,0.8731563421828908,0.12684365781710916,761,139,199,423,703,58,0.18265440210249673,0.2614980289093298,0.5558475689881734,0.923784494086728,0.07621550591327202
1776,461,285,176,378,83,0.6182212581344902,0.38177874186550975,0.8199566160520607,0.18004338394793926,784,104,207,473,712,72,0.1326530612244898,0.26403061224489793,0.6033163265306123,0.9081632653061225,0.09183673469387756
1777,317,188,129,270,47,0.5930599369085173,0.4069400630914827,0.8517350157728707,0.14826498422712933,606,145,203,258,553,53,0.23927392739273928,0.334983498349835,0.42574257425742573,0.9125412541254125,0.08745874587458746
1778,1274,1054,220,1115,159,0.8273155416012559,0.1726844583987441,0.8751962323390895,0.12480376766091052,1087,155,299,633,865,222,0.14259429622815087,0.2750689972401104,0.5823367065317387,0.795768169273229,0.20423183072677092
1779,684,479,205,549,135,0.7002923976608187,0.2997076023391813,0.8026315789473685,0.19736842105263158,827,118,309,400,760,67,0.14268440145102781,0.373639661426844,0.4836759371221282,0.9189842805320435,0.08101571946795647
1780,801,570,231,653,148,0.7116104868913857,0.2883895131086142,0.815230961298377,0.18476903870162298,1137,200,376,561,996,141,0.1759014951627089,0.3306948109058927,0.49340369393139843,0.8759894459102903,0.12401055408970976
1781,152,44,108,144,8,0.2894736842105263,0.7105263157894737,0.9473684210526315,0.05263157894736842,608,101,133,374,555,53,0.16611842105263158,0.21875,0.6151315789473685,0.912828947368421,0.08717105263157894
1782,552,364,188,449,103,0.6594202898550725,0.34057971014492755,0.8134057971014492,0.18659420289855072,983,251,268,464,920,63,0.25534079348931843,0.2726347914547304,0.47202441505595116,0.9359104781281791,0.06408952187182096
1783,618,435,183,514,104,0.7038834951456311,0.2961165048543689,0.8317152103559871,0.16828478964401294,1111,216,287,608,977,134,0.19441944194419442,0.2583258325832583,0.5472547254725473,0.8793879387938794,0.12061206120612061
1784,1263,1040,223,1103,160,0.8234362628661916,0.17656373713380838,0.8733174980205859,0.12668250197941408,1079,149,295,635,858,221,0.1380908248378128,0.27340129749768305,0.5885078776645042,0.7951807228915663,0.20481927710843373
1785,1259,1039,220,1103,156,0.8252581413820492,0.17474185861795075,0.8760921366163622,0.12390786338363781,1076,156,284,636,855,221,0.1449814126394052,0.26394052044609667,0.5910780669144982,0.7946096654275093,0.2053903345724907
1786,798,554,244,650,148,0.6942355889724311,0.3057644110275689,0.8145363408521303,0.18546365914786966,1076,99,211,766,849,227,0.09200743494423792,0.19609665427509293,0.7118959107806692,0.7890334572490706,0.21096654275092938
1787,188,59,129,179,9,0.31382978723404253,0.6861702127659575,0.9521276595744681,0.047872340425531915,593,142,180,271,543,50,0.23946037099494097,0.30354131534569984,0.45699831365935917,0.9156829679595279,0.08431703204047218
1788,396,207,189,299,97,0.5227272727272727,0.4772727272727273,0.7550505050505051,0.24494949494949494,586,93,155,338,520,66,0.15870307167235495,0.2645051194539249,0.5767918088737202,0.8873720136518771,0.11262798634812286
1789,594,360,234,471,123,0.6060606060606061,0.3939393939393939,0.7929292929292929,0.20707070707070707,794,113,250,431,721,73,0.14231738035264482,0.3148614609571788,0.5428211586901763,0.9080604534005038,0.09193954659949623
1790,1417,1174,243,1211,206,0.8285109386026818,0.1714890613973183,0.8546224417784051,0.14537755822159493,1140,157,310,673,915,225,0.13771929824561405,0.2719298245614035,0.5903508771929824,0.8026315789473685,0.19736842105263158
1791,351,221,130,302,49,0.6296296296296297,0.37037037037037035,0.8603988603988604,0.1396011396011396,857,148,249,460,737,120,0.17269544924154026,0.29054842473745623,0.5367561260210035,0.8599766627771295,0.14002333722287047
1792,538,366,172,450,88,0.6802973977695167,0.31970260223048325,0.8364312267657993,0.16356877323420074,927,201,226,500,860,67,0.2168284789644013,0.24379719525350593,0.5393743257820928,0.9277238403451996,0.07227615965480043
1793,1504,1253,251,1287,217,0.8331117021276596,0.1668882978723404,0.855718085106383,0.14428191489361702,1181,175,326,680,957,224,0.14817950889077053,0.2760372565622354,0.5757832345469941,0.8103302286198137,0.1896697713801863
1794,502,316,186,421,81,0.6294820717131474,0.3705179282868526,0.8386454183266933,0.16135458167330677,824,111,212,501,750,74,0.13470873786407767,0.25728155339805825,0.6080097087378641,0.9101941747572816,0.08980582524271845
1795,459,278,181,379,80,0.6056644880174292,0.39433551198257083,0.8257080610021786,0.17429193899782136,740,95,206,439,671,69,0.12837837837837837,0.27837837837837837,0.5932432432432433,0.9067567567567567,0.09324324324324325
1796,335,209,126,292,43,0.6238805970149254,0.3761194029850746,0.8716417910447761,0.12835820895522387,732,159,245,328,615,117,0.21721311475409835,0.33469945355191255,0.44808743169398907,0.8401639344262295,0.1598360655737705
1797,1259,1033,226,1103,156,0.8204924543288324,0.17950754567116758,0.8760921366163622,0.12390786338363781,1091,156,299,636,869,222,0.14298808432630614,0.27406049495875345,0.5829514207149404,0.7965169569202566,0.20348304307974335
1798,238,114,124,209,29,0.4789915966386555,0.5210084033613446,0.8781512605042017,0.12184873949579832,626,77,124,425,427,199,0.12300319488817892,0.19808306709265175,0.6789137380191693,0.6821086261980831,0.31789137380191695
1799,321,189,132,280,41,0.5887850467289719,0.411214953271028,0.8722741433021807,0.1277258566978193,786,127,205,454,726,60,0.16157760814249364,0.2608142493638677,0.5776081424936387,0.9236641221374046,0.07633587786259542
1800,552,338,214,431,121,0.6123188405797102,0.38768115942028986,0.7807971014492754,0.21920289855072464,733,111,212,410,661,72,0.15143246930422918,0.2892223738062756,0.5593451568894953,0.9017735334242838,0.09822646657571624
1801,571,417,154,500,71,0.7302977232924693,0.26970227670753066,0.8756567425569177,0.1243432574430823,827,137,239,451,708,119,0.1656590084643289,0.2889963724304716,0.5453446191051995,0.8561064087061668,0.14389359129383314
1802,1502,1255,247,1286,216,0.8355525965379494,0.1644474034620506,0.8561917443408789,0.14380825565912117,1155,166,318,671,930,225,0.14372294372294372,0.2753246753246753,0.580952380952381,0.8051948051948052,0.19480519480519481
1803,454,282,172,372,82,0.6211453744493393,0.3788546255506608,0.8193832599118943,0.18061674008810572,924,115,201,608,755,169,0.12445887445887446,0.21753246753246752,0.658008658008658,0.8170995670995671,0.1829004329004329
1804,1518,1262,256,1299,219,0.8313570487483531,0.1686429512516469,0.8557312252964426,0.1442687747035573,1157,166,318,673,932,225,0.14347450302506481,0.2748487467588591,0.581676750216076,0.8055315471045809,0.1944684528954192
1805,432,288,144,371,61,0.6666666666666666,0.3333333333333333,0.8587962962962963,0.1412037037037037,900,145,236,519,779,121,0.16111111111111112,0.26222222222222225,0.5766666666666667,0.8655555555555555,0.13444444444444445
1806,1168,880,288,910,258,0.7534246575342466,0.2465753424657534,0.7791095890410958,0.2208904109589041,1168,102,235,831,890,278,0.08732876712328767,0.2011986301369863,0.711472602739726,0.761986301369863,0.238013698630137
1807,780,554,226,617,163,0.7102564102564103,0.28974358974358977,0.791025641025641,0.20897435897435898,882,136,325,421,812,70,0.15419501133786848,0.36848072562358275,0.47732426303854875,0.9206349206349206,0.07936507936507936
1808,302,180,122,262,40,0.5960264900662252,0.40397350993377484,0.8675496688741722,0.13245033112582782,699,125,175,399,643,56,0.17882689556509299,0.2503576537911302,0.5708154506437768,0.9198855507868383,0.08011444921316166
1809,389,212,177,301,88,0.5449871465295629,0.455012853470437,0.7737789203084833,0.2262210796915167,626,112,162,352,559,67,0.17891373801916932,0.25878594249201275,0.5623003194888179,0.8929712460063898,0.10702875399361023
1810,582,359,223,459,123,0.6168384879725086,0.38316151202749144,0.788659793814433,0.211340206185567,821,130,270,421,751,70,0.15834348355663824,0.32886723507917176,0.51278928136419,0.9147381242387332,0.08526187576126674
1811,1289,998,291,1080,209,0.7742435996896819,0.22575640031031807,0.8378588052754073,0.1621411947245927,1165,102,227,836,887,278,0.08755364806866953,0.19484978540772532,0.7175965665236052,0.76137339055794,0.23862660944206007
1812,444,263,181,366,78,0.5923423423423423,0.40765765765765766,0.8243243243243243,0.17567567567567569,612,95,157,360,546,66,0.15522875816993464,0.2565359477124183,0.5882352941176471,0.8921568627450981,0.10784313725490197
1813,585,385,200,476,109,0.6581196581196581,0.3418803418803419,0.8136752136752137,0.18632478632478633,1116,267,277,572,1049,67,0.239247311827957,0.2482078853046595,0.5125448028673835,0.9399641577060932,0.06003584229390681
1814,1240,1031,209,1084,156,0.8314516129032258,0.1685483870967742,0.8741935483870967,0.12580645161290321,1047,155,265,627,826,221,0.14804202483285578,0.2531041069723018,0.5988538681948424,0.7889207258834766,0.2110792741165234
1815,386,201,185,293,93,0.5207253886010362,0.4792746113989637,0.7590673575129534,0.24093264248704663,632,105,170,357,564,68,0.1661392405063291,0.2689873417721519,0.564873417721519,0.8924050632911392,0.10759493670886076
1816,426,225,201,336,90,0.528169014084507,0.47183098591549294,0.7887323943661971,0.2112676056338028,760,123,212,425,685,75,0.1618421052631579,0.2789473684210526,0.5592105263157895,0.9013157894736842,0.09868421052631579
1817,342,230,112,288,54,0.672514619883041,0.32748538011695905,0.8421052631578947,0.15789473684210525,615,162,185,268,605,10,0.2634146341463415,0.3008130081300813,0.43577235772357725,0.983739837398374,0.016260162601626018
1818,64,19,45,28,36,0.296875,0.703125,0.4375,0.5625,579,166,121,292,569,10,0.2867012089810017,0.20898100172711573,0.5043177892918825,0.9827288428324698,0.017271157167530225
1819,359,235,124,316,43,0.6545961002785515,0.34540389972144847,0.8802228412256268,0.11977715877437325,870,142,253,475,747,123,0.1632183908045977,0.2908045977011494,0.5459770114942529,0.8586206896551725,0.1413793103448276
1820,621,393,228,475,146,0.6328502415458938,0.3671497584541063,0.7648953301127214,0.23510466988727857,1015,132,246,637,880,135,0.13004926108374384,0.24236453201970443,0.6275862068965518,0.8669950738916257,0.1330049261083744
1821,465,283,182,383,82,0.6086021505376344,0.3913978494623656,0.8236559139784946,0.17634408602150536,883,102,220,561,717,166,0.11551528878822197,0.2491506228765572,0.6353340883352209,0.812004530011325,0.18799546998867497
1822,599,360,239,467,132,0.6010016694490818,0.3989983305509182,0.7796327212020033,0.22036727879799667,827,109,254,464,751,76,0.13180169286577992,0.30713422007255137,0.5610640870616687,0.9081015719467956,0.09189842805320435
1823,566,395,171,470,96,0.6978798586572438,0.30212014134275617,0.8303886925795053,0.1696113074204947,1073,237,294,542,943,130,0.22087604846225536,0.2739981360671016,0.5051258154706431,0.8788443616029823,0.1211556383970177
1824,356,220,136,312,44,0.6179775280898876,0.38202247191011235,0.8764044943820225,0.12359550561797752,755,124,240,391,636,119,0.16423841059602648,0.31788079470198677,0.5178807947019868,0.8423841059602649,0.1576158940397351
1825,1138,794,344,907,231,0.6977152899824253,0.3022847100175747,0.79701230228471,0.20298769771529,1163,105,204,854,893,270,0.09028374892519346,0.17540842648323302,0.7343078245915735,0.7678417884780739,0.23215821152192606
1826,1291,998,293,1082,209,0.7730441518202944,0.22695584817970565,0.8381099922540666,0.16189000774593337,1181,102,237,842,903,278,0.0863674851820491,0.20067739204064353,0.7129551227773073,0.7646062658763759,0.23539373412362405
1827,306,182,124,265,41,0.5947712418300654,0.40522875816993464,0.8660130718954249,0.13398692810457516,727,105,181,441,668,59,0.14442916093535077,0.24896836313617607,0.6066024759284732,0.9188445667125172,0.0811554332874828
1828,304,144,160,256,48,0.47368421052631576,0.5263157894736842,0.8421052631578947,0.15789473684210525,699,83,152,464,630,69,0.11874105865522175,0.21745350500715308,0.6638054363376252,0.9012875536480687,0.09871244635193133
1829,462,280,182,381,81,0.6060606060606061,0.3939393939393939,0.8246753246753247,0.17532467532467533,899,105,236,558,824,75,0.1167964404894327,0.2625139043381535,0.6206896551724138,0.9165739710789766,0.08342602892102335
1830,1168,878,290,913,255,0.7517123287671232,0.2482876712328767,0.7816780821917808,0.2183219178082192,1161,102,229,830,883,278,0.08785529715762273,0.19724375538329025,0.7149009474590869,0.7605512489233419,0.23944875107665806
1831,1517,1264,253,1298,219,0.8332234673698088,0.16677653263019115,0.8556361239288068,0.14436387607119314,1182,172,324,686,956,226,0.1455160744500846,0.27411167512690354,0.5803722504230119,0.8087986463620981,0.19120135363790186
1832,951,718,233,775,176,0.7549947423764458,0.24500525762355416,0.814931650893796,0.18506834910620398,834,106,330,398,766,68,0.12709832134292565,0.39568345323741005,0.47721822541966424,0.9184652278177458,0.0815347721822542
1833,343,220,123,297,46,0.641399416909621,0.358600583090379,0.8658892128279884,0.13411078717201166,889,155,252,482,767,122,0.17435320584926883,0.28346456692913385,0.5421822272215973,0.8627671541057368,0.1372328458942632
1834,655,430,225,517,138,0.6564885496183206,0.3435114503816794,0.7893129770992366,0.21068702290076335,637,100,155,382,570,67,0.15698587127158556,0.24332810047095763,0.5996860282574569,0.8948194662480377,0.10518053375196232
1835,788,562,226,646,142,0.7131979695431472,0.2868020304568528,0.8197969543147208,0.1802030456852792,1226,285,388,553,1096,130,0.23246329526916804,0.3164763458401305,0.45106035889070145,0.8939641109298532,0.10603588907014681
1836,3773,3322,451,3151,622,0.880466472303207,0.119533527696793,0.8351444473893453,0.16485555261065465,1631,164,357,1110,1336,295,0.10055180870631514,0.21888412017167383,0.680564071122011,0.8191293684855917,0.18087063151440833
1837,212,86,126,114,98,0.4056603773584906,0.5943396226415094,0.5377358490566038,0.46226415094339623,116,0,60,56,116,0,0.0,0.5172413793103449,0.4827586206896552,1.0,0.0
1838,157,46,111,148,9,0.2929936305732484,0.7070063694267515,0.9426751592356688,0.05732484076433121,684,137,168,379,629,55,0.20029239766081872,0.24561403508771928,0.554093567251462,0.9195906432748538,0.0804093567251462
1839,3133,2658,475,2606,527,0.8483881263964251,0.15161187360357484,0.8317906160229812,0.16820938397701884,1418,156,388,874,1198,220,0.11001410437235543,0.2736248236953456,0.616361071932299,0.844851904090268,0.15514809590973203
1840,318,186,132,277,41,0.5849056603773585,0.41509433962264153,0.8710691823899371,0.1289308176100629,567,107,186,274,515,52,0.18871252204585537,0.328042328042328,0.48324514991181655,0.908289241622575,0.09171075837742504
1841,351,211,140,307,44,0.6011396011396012,0.39886039886039887,0.8746438746438746,0.12535612535612536,618,131,205,282,565,53,0.21197411003236247,0.33171521035598706,0.4563106796116505,0.9142394822006472,0.08576051779935275
1842,335,204,131,295,40,0.608955223880597,0.39104477611940297,0.8805970149253731,0.11940298507462686,841,156,229,456,782,59,0.18549346016646848,0.272294887039239,0.5422116527942925,0.929845422116528,0.07015457788347206
1843,1552,1294,258,1334,218,0.8337628865979382,0.16623711340206185,0.8595360824742269,0.1404639175257732,1188,172,333,683,963,225,0.1447811447811448,0.2803030303030303,0.5749158249158249,0.8106060606060606,0.1893939393939394
1844,1272,1063,209,1111,161,0.835691823899371,0.16430817610062892,0.8734276729559748,0.12657232704402516,1046,155,256,635,824,222,0.14818355640535372,0.2447418738049713,0.607074569789675,0.7877629063097514,0.21223709369024857
1845,333,202,131,292,41,0.6066066066066066,0.3933933933933934,0.8768768768768769,0.12312312312312312,676,140,210,326,621,55,0.20710059171597633,0.3106508875739645,0.4822485207100592,0.9186390532544378,0.08136094674556213
1846,502,318,184,419,83,0.6334661354581673,0.3665338645418327,0.8346613545816733,0.16533864541832669,463,33,94,336,455,8,0.07127429805615551,0.20302375809935205,0.7257019438444925,0.9827213822894169,0.017278617710583154
1847,323,204,119,281,42,0.631578947368421,0.3684210526315789,0.8699690402476781,0.13003095975232198,612,160,200,252,559,53,0.26143790849673204,0.32679738562091504,0.4117647058823529,0.9133986928104575,0.08660130718954248
1848,488,311,177,407,81,0.6372950819672131,0.36270491803278687,0.8340163934426229,0.16598360655737704,798,96,210,492,727,71,0.12030075187969924,0.2631578947368421,0.6165413533834586,0.9110275689223057,0.08897243107769423
1849,1295,998,297,1086,209,0.7706563706563706,0.22934362934362934,0.8386100386100386,0.1613899613899614,1171,102,229,840,893,278,0.08710503842869342,0.19555935098206662,0.71733561058924,0.762596071733561,0.23740392826643894
1850,510,330,180,362,148,0.6470588235294118,0.35294117647058826,0.7098039215686275,0.2901960784313726,346,51,137,158,339,7,0.14739884393063585,0.3959537572254335,0.45664739884393063,0.9797687861271677,0.02023121387283237
1851,1555,1302,253,1333,222,0.8372990353697749,0.16270096463022507,0.8572347266881029,0.14276527331189712,1208,181,330,697,982,226,0.1498344370860927,0.2731788079470199,0.5769867549668874,0.8129139072847682,0.1870860927152318
1852,1162,880,282,904,258,0.7573149741824441,0.24268502581755594,0.7779690189328744,0.22203098106712565,1156,102,230,824,878,278,0.08823529411764706,0.19896193771626297,0.71280276816609,0.759515570934256,0.24048442906574394
1853,348,219,129,301,47,0.6293103448275862,0.3706896551724138,0.8649425287356322,0.13505747126436782,876,132,249,495,753,123,0.1506849315068493,0.2842465753424658,0.565068493150685,0.8595890410958904,0.1404109589041096
1854,1284,998,286,1075,209,0.7772585669781932,0.22274143302180685,0.8372274143302181,0.16277258566978192,1170,102,232,836,892,278,0.08717948717948718,0.19829059829059828,0.7145299145299145,0.7623931623931623,0.2376068376068376
1855,1284,998,286,1075,209,0.7772585669781932,0.22274143302180685,0.8372274143302181,0.16277258566978192,1170,102,232,836,892,278,0.08717948717948718,0.19829059829059828,0.7145299145299145,0.7623931623931623,0.2376068376068376
1856,1286,998,288,1077,209,0.776049766718507,0.223950233281493,0.8374805598755832,0.1625194401244168,1165,102,228,835,887,278,0.08755364806866953,0.19570815450643778,0.7167381974248928,0.76137339055794,0.23862660944206007
1857,871,656,215,775,96,0.7531572904707233,0.2468427095292767,0.8897818599311137,0.11021814006888633,966,142,231,593,764,202,0.14699792960662525,0.2391304347826087,0.6138716356107661,0.7908902691511387,0.20910973084886128
1858,367,228,139,321,46,0.6212534059945504,0.3787465940054496,0.8746594005449592,0.12534059945504086,882,118,240,524,762,120,0.13378684807256236,0.272108843537415,0.5941043083900227,0.8639455782312925,0.1360544217687075
1859,308,182,126,268,40,0.5909090909090909,0.4090909090909091,0.8701298701298701,0.12987012987012986,547,115,176,256,494,53,0.21023765996343693,0.3217550274223035,0.4680073126142596,0.903107861060329,0.09689213893967093
1860,622,420,202,494,128,0.6752411575562701,0.3247588424437299,0.7942122186495176,0.2057877813504823,1021,263,271,487,958,63,0.257590597453477,0.2654260528893242,0.47698334965719885,0.9382957884427032,0.061704211557296766
1861,426,244,182,350,76,0.5727699530516432,0.4272300469483568,0.8215962441314554,0.1784037558685446,628,107,162,359,561,67,0.17038216560509553,0.25796178343949044,0.571656050955414,0.893312101910828,0.10668789808917198
1862,1262,1032,230,1105,157,0.8177496038034865,0.18225039619651348,0.875594294770206,0.12440570522979398,1083,150,295,638,861,222,0.13850415512465375,0.2723915050784857,0.5891043397968606,0.7950138504155124,0.20498614958448755
1863,462,288,174,380,82,0.6233766233766234,0.37662337662337664,0.8225108225108225,0.1774891774891775,808,117,203,488,735,73,0.1448019801980198,0.25123762376237624,0.6039603960396039,0.9096534653465347,0.09034653465346534
1864,698,503,195,579,119,0.7206303724928367,0.2793696275071633,0.829512893982808,0.17048710601719197,1335,294,427,614,1108,227,0.2202247191011236,0.31985018726591763,0.4599250936329588,0.8299625468164794,0.1700374531835206
1865,480,307,173,396,84,0.6395833333333333,0.36041666666666666,0.825,0.175,891,111,232,548,817,74,0.12457912457912458,0.26038159371492703,0.6150392817059483,0.9169472502805837,0.08305274971941638
1866,571,380,191,459,112,0.6654991243432574,0.3345008756567426,0.8038528896672504,0.19614711033274956,1117,289,286,542,1047,70,0.25872873769024174,0.25604297224709044,0.4852282900626679,0.937332139659803,0.06266786034019696
1867,1167,878,289,912,255,0.7523564695801199,0.24764353041988005,0.781491002570694,0.2185089974293059,1157,102,228,827,879,278,0.0881590319792567,0.19706136560069146,0.7147796024200519,0.759723422644771,0.24027657735522903
1868,558,340,218,437,121,0.6093189964157706,0.3906810035842294,0.7831541218637993,0.2168458781362007,781,111,238,432,708,73,0.14212548015364918,0.3047375160051216,0.5531370038412292,0.9065300896286812,0.09346991037131883
1869,342,213,129,299,43,0.6228070175438597,0.37719298245614036,0.8742690058479532,0.12573099415204678,706,135,246,325,589,117,0.19121813031161472,0.34844192634560905,0.4603399433427762,0.8342776203966006,0.16572237960339944
1870,434,255,179,358,76,0.5875576036866359,0.41244239631336405,0.8248847926267281,0.17511520737327188,620,104,158,358,552,68,0.16774193548387098,0.25483870967741934,0.5774193548387097,0.8903225806451613,0.10967741935483871
1871,1288,1011,277,1087,201,0.7849378881987578,0.21506211180124224,0.843944099378882,0.15605590062111802,1269,191,397,681,1002,267,0.15051221434200157,0.3128447596532703,0.5366430260047281,0.789598108747045,0.21040189125295508
1872,1165,878,287,910,255,0.7536480686695279,0.2463519313304721,0.7811158798283262,0.21888412017167383,1162,102,232,828,884,278,0.08777969018932874,0.19965576592082615,0.7125645438898451,0.7607573149741824,0.23924268502581755
1873,561,355,206,432,129,0.6327985739750446,0.3672014260249554,0.7700534759358288,0.22994652406417113,699,108,193,398,627,72,0.15450643776824036,0.2761087267525036,0.5693848354792561,0.8969957081545065,0.10300429184549356
1874,1968,1608,360,1634,334,0.8170731707317073,0.18292682926829268,0.8302845528455285,0.16971544715447154,1581,303,462,816,1400,181,0.19165085388994307,0.2922201138519924,0.5161290322580645,0.8855154965211891,0.11448450347881088
1875,320,195,125,279,41,0.609375,0.390625,0.871875,0.128125,765,152,208,405,707,58,0.19869281045751633,0.2718954248366013,0.5294117647058824,0.9241830065359478,0.07581699346405228
1876,571,401,170,476,95,0.702276707530648,0.29772329246935203,0.8336252189141856,0.16637478108581435,1149,254,305,590,1019,130,0.22106179286335945,0.2654482158398607,0.5134899912967799,0.886858137510879,0.11314186248912098
1877,1417,1174,243,1211,206,0.8285109386026818,0.1714890613973183,0.8546224417784051,0.14537755822159493,1134,154,315,665,909,225,0.13580246913580246,0.2777777777777778,0.5864197530864198,0.8015873015873016,0.1984126984126984
1878,1512,1156,356,1220,292,0.7645502645502645,0.23544973544973544,0.8068783068783069,0.1931216931216931,1227,199,380,648,1002,225,0.1621841890790546,0.30969845150774244,0.5281173594132029,0.8166259168704156,0.18337408312958436
1879,309,183,126,268,41,0.5922330097087378,0.4077669902912621,0.8673139158576052,0.13268608414239483,614,143,207,264,561,53,0.23289902280130292,0.33713355048859933,0.42996742671009774,0.9136807817589576,0.08631921824104234
1880,321,193,128,272,49,0.6012461059190031,0.3987538940809969,0.8473520249221184,0.1526479750778816,636,163,218,255,584,52,0.2562893081761006,0.34276729559748426,0.4009433962264151,0.9182389937106918,0.08176100628930817
1881,787,549,238,649,138,0.6975857687420585,0.30241423125794153,0.8246505717916137,0.17534942820838628,1064,99,209,756,837,227,0.09304511278195489,0.19642857142857142,0.7105263157894737,0.7866541353383458,0.21334586466165414
1882,462,291,171,382,80,0.6298701298701299,0.37012987012987014,0.8268398268398268,0.17316017316017315,850,93,199,558,684,166,0.10941176470588235,0.23411764705882354,0.6564705882352941,0.8047058823529412,0.1952941176470588
1883,368,241,127,321,47,0.654891304347826,0.3451086956521739,0.8722826086956522,0.12771739130434784,875,134,245,496,753,122,0.15314285714285714,0.28,0.5668571428571428,0.8605714285714285,0.13942857142857143
1884,835,574,261,672,163,0.6874251497005988,0.3125748502994012,0.8047904191616766,0.19520958083832335,1077,103,204,770,850,227,0.09563602599814298,0.1894150417827298,0.7149489322191273,0.7892293407613742,0.2107706592386258
1885,397,247,150,308,89,0.6221662468513854,0.3778337531486146,0.7758186397984886,0.22418136020151133,581,155,175,251,572,9,0.2667814113597246,0.30120481927710846,0.43201376936316693,0.9845094664371773,0.01549053356282272
1886,517,337,180,431,86,0.6518375241779497,0.3481624758220503,0.8336557059961315,0.16634429400386846,910,106,205,599,742,168,0.11648351648351649,0.22527472527472528,0.6582417582417582,0.8153846153846154,0.18461538461538463
1887,315,194,121,273,42,0.6158730158730159,0.38412698412698415,0.8666666666666667,0.13333333333333333,635,171,208,256,583,52,0.2692913385826772,0.32755905511811023,0.4031496062992126,0.9181102362204724,0.08188976377952756
1888,577,408,169,487,90,0.707105719237435,0.292894280762565,0.8440207972270364,0.1559792027729636,963,172,226,565,892,71,0.1786085150571132,0.23468328141225336,0.5867082035306335,0.9262720664589823,0.07372793354101766
1889,561,359,202,436,125,0.6399286987522281,0.3600713012477718,0.7771836007130125,0.22281639928698752,670,103,201,366,600,70,0.1537313432835821,0.3,0.5462686567164179,0.8955223880597015,0.1044776119402985
1890,2208,1896,312,1906,302,0.8586956521739131,0.14130434782608695,0.8632246376811594,0.13677536231884058,1324,178,331,815,1066,258,0.13444108761329304,0.25,0.6155589123867069,0.8051359516616314,0.19486404833836857
1891,1256,1032,224,1099,157,0.821656050955414,0.17834394904458598,0.875,0.125,1056,149,273,634,834,222,0.14109848484848486,0.2585227272727273,0.6003787878787878,0.7897727272727273,0.21022727272727273
1892,9834,7901,1933,8514,1320,0.8034370551149075,0.19656294488509254,0.8657718120805369,0.1342281879194631,4856,109,281,4466,2719,2137,0.022446457990115323,0.057866556836902804,0.9196869851729819,0.5599258649093904,0.44007413509060955
1893,534,110,424,366,168,0.20599250936329588,0.7940074906367042,0.6853932584269663,0.3146067415730337,185,3,66,116,185,0,0.016216216216216217,0.3567567567567568,0.6270270270270271,1.0,0.0
1894,1254,1036,218,1096,158,0.8261562998405104,0.17384370015948963,0.8740031897926634,0.12599681020733652,1071,149,286,636,849,222,0.13912231559290383,0.26704014939309056,0.5938375350140056,0.7927170868347339,0.20728291316526612
1895,1294,998,296,1085,209,0.7712519319938176,0.2287480680061824,0.8384853168469861,0.1615146831530139,1171,102,228,841,893,278,0.08710503842869342,0.19470538001707943,0.7181895815542272,0.762596071733561,0.23740392826643894
1896,387,205,182,297,90,0.5297157622739018,0.4702842377260982,0.7674418604651163,0.23255813953488372,587,93,148,346,521,66,0.15843270868824533,0.252129471890971,0.5894378194207837,0.8875638841567292,0.11243611584327087
1897,1254,1031,223,1097,157,0.8221690590111643,0.17783094098883573,0.8748006379585327,0.1251993620414673,1074,150,288,636,853,221,0.13966480446927373,0.2681564245810056,0.5921787709497207,0.7942271880819367,0.20577281191806332
1898,1268,1038,230,1108,160,0.8186119873817035,0.18138801261829654,0.8738170347003155,0.12618296529968454,1078,155,293,630,856,222,0.1437847866419295,0.2717996289424861,0.5844155844155844,0.7940630797773655,0.20593692022263452
1899,475,282,193,393,82,0.5936842105263158,0.4063157894736842,0.8273684210526315,0.1726315789473684,856,106,235,515,784,72,0.12383177570093458,0.27453271028037385,0.6016355140186916,0.9158878504672897,0.08411214953271028
1900,1249,1031,218,1093,156,0.8254603682946358,0.1745396317053643,0.8751000800640513,0.12489991993594876,1086,155,304,627,865,221,0.1427255985267035,0.27992633517495397,0.5773480662983426,0.7965009208103131,0.20349907918968693
1901,386,249,137,339,47,0.6450777202072538,0.3549222797927461,0.8782383419689119,0.12176165803108809,958,160,281,517,835,123,0.16701461377870563,0.29331941544885176,0.5396659707724426,0.8716075156576201,0.12839248434237996
1902,358,227,131,313,45,0.6340782122905028,0.3659217877094972,0.8743016759776536,0.12569832402234637,725,136,251,338,609,116,0.18758620689655173,0.34620689655172415,0.46620689655172415,0.84,0.16
1903,1685,480,1205,864,821,0.28486646884273,0.7151335311572701,0.512759643916914,0.4872403560830861,381,3,138,240,381,0,0.007874015748031496,0.36220472440944884,0.6299212598425197,1.0,0.0
1904,1296,1062,234,1136,160,0.8194444444444444,0.18055555555555555,0.8765432098765432,0.12345679012345678,1129,155,336,638,908,221,0.13728963684676704,0.2976085031000886,0.5651018600531443,0.804251550044287,0.19574844995571303
1905,384,200,184,293,91,0.5208333333333334,0.4791666666666667,0.7630208333333334,0.23697916666666666,578,90,147,341,512,66,0.15570934256055363,0.25432525951557095,0.5899653979238755,0.8858131487889274,0.11418685121107267
1906,1514,1267,247,1297,217,0.8368560105680317,0.16314398943196828,0.8566710700132101,0.14332892998678995,1184,175,323,686,959,225,0.14780405405405406,0.27280405405405406,0.5793918918918919,0.8099662162162162,0.19003378378378377
1907,314,186,128,271,43,0.5923566878980892,0.40764331210191085,0.8630573248407644,0.13694267515923567,623,142,213,268,568,55,0.22792937399678972,0.3418940609951846,0.4301765650080257,0.9117174959871589,0.08828250401284109
1908,274,49,225,173,101,0.17883211678832117,0.8211678832116789,0.6313868613138686,0.3686131386861314,110,3,41,66,110,0,0.02727272727272727,0.37272727272727274,0.6,1.0,0.0
1909,1241,1032,209,1083,158,0.8315874294923449,0.16841257050765512,0.8726833199033038,0.12731668009669622,1068,148,282,638,845,223,0.13857677902621723,0.2640449438202247,0.5973782771535581,0.7911985018726592,0.20880149812734083
1910,832,623,209,742,90,0.7487980769230769,0.2512019230769231,0.8918269230769231,0.10817307692307693,961,136,239,586,760,201,0.14151925078043703,0.24869927159209157,0.6097814776274714,0.7908428720083247,0.20915712799167535
1911,1289,998,291,1080,209,0.7742435996896819,0.22575640031031807,0.8378588052754073,0.1621411947245927,1178,102,235,841,900,278,0.0865874363327674,0.199490662139219,0.7139219015280136,0.7640067911714771,0.23599320882852293
1912,893,646,247,725,168,0.723404255319149,0.2765957446808511,0.8118701007838746,0.1881298992161254,1159,169,362,628,934,225,0.1458153580672994,0.31233822260569455,0.5418464193270061,0.8058671268334772,0.19413287316652286
1913,568,354,214,448,120,0.6232394366197183,0.3767605633802817,0.7887323943661971,0.2112676056338028,757,117,232,408,685,72,0.154557463672391,0.30647291941875826,0.5389696169088507,0.904887714663144,0.095112285336856
1914,602,401,201,486,116,0.6661129568106312,0.3338870431893688,0.8073089700996677,0.19269102990033224,1334,296,325,713,1110,224,0.22188905547226387,0.2436281859070465,0.5344827586206896,0.8320839580209896,0.1679160419790105
1915,322,190,132,282,40,0.5900621118012422,0.40993788819875776,0.8757763975155279,0.12422360248447205,746,110,188,448,685,61,0.14745308310991956,0.2520107238605898,0.6005361930294906,0.9182305630026809,0.08176943699731903
1916,582,347,235,457,125,0.5962199312714777,0.40378006872852235,0.7852233676975945,0.21477663230240548,789,107,251,431,717,72,0.13561470215462612,0.3181242078580482,0.5462610899873257,0.908745247148289,0.09125475285171103
1917,342,231,111,289,53,0.6754385964912281,0.32456140350877194,0.8450292397660819,0.15497076023391812,506,134,153,219,497,9,0.2648221343873518,0.30237154150197626,0.43280632411067194,0.9822134387351779,0.017786561264822136
1918,1411,1103,308,1168,243,0.781715095676825,0.21828490432317504,0.8277817150956768,0.17221828490432317,1164,162,382,620,981,183,0.13917525773195877,0.3281786941580756,0.5326460481099656,0.8427835051546392,0.15721649484536082
1919,625,421,204,501,124,0.6736,0.3264,0.8016,0.1984,1187,263,261,663,1018,169,0.22156697556866048,0.21988205560235888,0.5585509688289806,0.8576242628475147,0.14237573715248525
1920,1166,878,288,911,255,0.7530017152658662,0.2469982847341338,0.7813036020583191,0.21869639794168097,1169,102,235,832,891,278,0.0872540633019675,0.20102651839178784,0.7117194183062446,0.7621899059024807,0.23781009409751924
1921,600,403,197,490,110,0.6716666666666666,0.3283333333333333,0.8166666666666667,0.18333333333333332,990,213,267,510,924,66,0.21515151515151515,0.2696969696969697,0.5151515151515151,0.9333333333333333,0.06666666666666667
1922,308,188,120,267,41,0.6103896103896104,0.38961038961038963,0.8668831168831169,0.1331168831168831,596,147,197,252,544,52,0.24664429530201343,0.33053691275167785,0.4228187919463087,0.912751677852349,0.087248322147651
1923,386,200,186,296,90,0.5181347150259067,0.48186528497409326,0.7668393782383419,0.23316062176165803,648,120,171,357,580,68,0.18518518518518517,0.2638888888888889,0.5509259259259259,0.8950617283950617,0.10493827160493827
1924,323,189,134,282,41,0.5851393188854489,0.4148606811145511,0.8730650154798761,0.12693498452012383,739,139,206,394,684,55,0.1880920162381597,0.2787550744248985,0.5331529093369418,0.925575101488498,0.07442489851150202
1925,366,236,130,297,69,0.644808743169399,0.3551912568306011,0.8114754098360656,0.1885245901639344,600,170,179,251,590,10,0.2833333333333333,0.29833333333333334,0.41833333333333333,0.9833333333333333,0.016666666666666666
1926,550,191,359,376,174,0.3472727272727273,0.6527272727272727,0.6836363636363636,0.31636363636363635,170,3,70,97,170,0,0.01764705882352941,0.4117647058823529,0.5705882352941176,1.0,0.0
1927,1289,998,291,1080,209,0.7742435996896819,0.22575640031031807,0.8378588052754073,0.1621411947245927,1174,102,233,839,896,278,0.0868824531516184,0.19846678023850084,0.7146507666098807,0.7632027257240205,0.23679727427597955
1928,349,154,195,265,84,0.44126074498567336,0.5587392550143266,0.7593123209169055,0.24068767908309455,720,93,166,461,558,162,0.12916666666666668,0.23055555555555557,0.6402777777777777,0.775,0.225
1929,1273,1037,236,1112,161,0.8146111547525531,0.18538884524744698,0.8735271013354281,0.12647289866457187,1067,149,290,628,846,221,0.13964386129334583,0.2717900656044986,0.5885660731021556,0.7928772258669166,0.20712277413308341
1930,1440,1176,264,1198,242,0.8166666666666667,0.18333333333333332,0.8319444444444445,0.16805555555555557,1143,189,380,574,967,176,0.16535433070866143,0.3324584426946632,0.5021872265966754,0.8460192475940508,0.15398075240594924
1931,123,73,50,69,54,0.5934959349593496,0.4065040650406504,0.5609756097560976,0.43902439024390244,144,3,77,64,142,2,0.020833333333333332,0.5347222222222222,0.4444444444444444,0.9861111111111112,0.013888888888888888
1932,1413,1109,304,1193,220,0.7848549186128804,0.2151450813871196,0.8443029016277424,0.15569709837225762,1284,246,453,585,1112,172,0.19158878504672897,0.352803738317757,0.45560747663551404,0.8660436137071651,0.13395638629283488
1933,1502,1254,248,1285,217,0.8348868175765646,0.16511318242343542,0.855525965379494,0.14447403462050598,1184,172,323,689,959,225,0.14527027027027026,0.27280405405405406,0.5819256756756757,0.8099662162162162,0.19003378378378377
1934,613,423,190,507,106,0.6900489396411092,0.3099510603588907,0.8270799347471451,0.1729200652528548,1277,238,312,727,1051,226,0.18637431480031325,0.24432263116679717,0.5693030540328896,0.8230227094753328,0.17697729052466718
1935,768,548,220,628,140,0.7135416666666666,0.2864583333333333,0.8177083333333334,0.18229166666666666,1186,203,357,626,961,225,0.1711635750421585,0.30101180438448566,0.5278246205733558,0.8102866779089376,0.1897133220910624
1936,325,192,133,285,40,0.5907692307692308,0.40923076923076923,0.8769230769230769,0.12307692307692308,652,158,220,274,600,52,0.24233128834355827,0.3374233128834356,0.42024539877300615,0.9202453987730062,0.07975460122699386
1937,2675,2287,388,2234,441,0.8549532710280374,0.1450467289719626,0.8351401869158879,0.16485981308411216,1667,266,437,964,1362,305,0.15956808638272346,0.2621475704859028,0.5782843431313738,0.8170365926814637,0.1829634073185363
1938,426,236,190,330,96,0.5539906103286385,0.4460093896713615,0.7746478873239436,0.22535211267605634,574,90,148,336,507,67,0.156794425087108,0.2578397212543554,0.5853658536585366,0.8832752613240418,0.11672473867595819
1939,346,209,137,302,44,0.6040462427745664,0.3959537572254335,0.8728323699421965,0.12716763005780346,759,150,263,346,642,117,0.1976284584980237,0.3465085638998682,0.45586297760210803,0.8458498023715415,0.1541501976284585
1940,554,351,203,440,114,0.6335740072202166,0.3664259927797834,0.7942238267148014,0.20577617328519857,757,106,215,436,680,77,0.14002642007926025,0.28401585204755614,0.5759577278731837,0.8982826948480845,0.10171730515191546
1941,368,247,121,309,59,0.6711956521739131,0.328804347826087,0.8396739130434783,0.16032608695652173,540,154,204,182,532,8,0.2851851851851852,0.37777777777777777,0.337037037037037,0.9851851851851852,0.014814814814814815
1942,721,510,211,576,145,0.7073509015256588,0.2926490984743412,0.7988904299583911,0.20110957004160887,840,126,316,398,771,69,0.15,0.3761904761904762,0.4738095238095238,0.9178571428571428,0.08214285714285714
1943,810,576,234,663,147,0.7111111111111111,0.28888888888888886,0.8185185185185185,0.1814814814814815,1245,238,386,621,1015,230,0.19116465863453816,0.3100401606425703,0.4987951807228916,0.8152610441767069,0.18473895582329317
1944,329,201,128,277,52,0.6109422492401215,0.3890577507598784,0.8419452887537994,0.1580547112462006,813,150,221,442,755,58,0.18450184501845018,0.27183271832718325,0.5436654366543665,0.9286592865928659,0.07134071340713408
1945,342,209,133,298,44,0.6111111111111112,0.3888888888888889,0.8713450292397661,0.1286549707602339,715,129,247,339,598,117,0.18041958041958042,0.34545454545454546,0.47412587412587415,0.8363636363636363,0.16363636363636364
1946,1057,754,303,843,214,0.7133396404919584,0.28666035950804164,0.7975402081362346,0.20245979186376536,1124,187,357,580,985,139,0.16637010676156583,0.31761565836298933,0.5160142348754448,0.8763345195729537,0.12366548042704627
1947,1517,1268,249,1301,216,0.8358602504943968,0.16413974950560317,0.8576137112722478,0.14238628872775214,1192,181,323,688,967,225,0.1518456375838926,0.2709731543624161,0.5771812080536913,0.8112416107382551,0.18875838926174496
1948,903,666,237,726,177,0.7375415282392026,0.26245847176079734,0.8039867109634552,0.19601328903654486,816,105,323,388,748,68,0.12867647058823528,0.3958333333333333,0.47549019607843135,0.9166666666666666,0.08333333333333333
1949,1289,1001,288,1078,211,0.7765709852598914,0.22342901474010862,0.8363072148952676,0.16369278510473234,1169,102,231,836,891,278,0.0872540633019675,0.19760479041916168,0.7151411462788708,0.7621899059024807,0.23781009409751924
1950,238,114,124,209,29,0.4789915966386555,0.5210084033613446,0.8781512605042017,0.12184873949579832,626,77,124,425,427,199,0.12300319488817892,0.19808306709265175,0.6789137380191693,0.6821086261980831,0.31789137380191695
1951,698,494,204,565,133,0.7077363896848138,0.2922636103151863,0.8094555873925502,0.19054441260744986,860,124,328,408,792,68,0.14418604651162792,0.3813953488372093,0.4744186046511628,0.9209302325581395,0.07906976744186046
1952,528,365,163,440,88,0.6912878787878788,0.3087121212121212,0.8333333333333334,0.16666666666666666,1139,244,254,641,974,165,0.21422300263388938,0.22300263388937663,0.5627743634767339,0.8551360842844601,0.14486391571553994
1953,589,405,184,487,102,0.6876061120543294,0.31239388794567063,0.8268251273344652,0.1731748726655348,1254,306,368,580,1126,128,0.24401913875598086,0.2934609250398724,0.4625199362041467,0.89792663476874,0.10207336523125997
1954,337,211,126,293,44,0.6261127596439169,0.37388724035608306,0.8694362017804155,0.13056379821958458,689,123,220,346,572,117,0.17851959361393324,0.3193033381712627,0.502177068214804,0.8301886792452831,0.16981132075471697
1955,3609,3122,487,3126,483,0.8650595732889997,0.1349404267110003,0.8661679135494597,0.13383208645054032,1924,201,536,1187,1445,479,0.10446985446985448,0.2785862785862786,0.6169438669438669,0.751039501039501,0.24896049896049896
1956,1512,1265,247,1296,216,0.8366402116402116,0.16335978835978837,0.8571428571428571,0.14285714285714285,1212,181,329,702,986,226,0.14933993399339934,0.27145214521452143,0.5792079207920792,0.8135313531353136,0.18646864686468648
1957,570,382,188,468,102,0.6701754385964912,0.3298245614035088,0.8210526315789474,0.17894736842105263,987,214,243,530,918,69,0.21681864235055726,0.24620060790273557,0.5369807497467072,0.9300911854103343,0.06990881458966565
1958,427,254,173,355,72,0.594847775175644,0.405152224824356,0.8313817330210773,0.1686182669789227,1106,245,221,640,941,165,0.22151898734177214,0.19981916817359854,0.5786618444846293,0.8508137432188065,0.1491862567811935
1959,351,218,133,308,43,0.6210826210826211,0.3789173789173789,0.8774928774928775,0.1225071225071225,739,126,192,421,682,57,0.17050067658998647,0.2598105548037889,0.5696887686062246,0.9228687415426252,0.07713125845737483
1960,566,388,178,465,101,0.6855123674911661,0.31448763250883394,0.8215547703180212,0.1784452296819788,1114,230,300,584,984,130,0.20646319569120286,0.26929982046678635,0.5242369838420108,0.8833034111310593,0.11669658886894076
1961,312,181,131,272,40,0.5801282051282052,0.4198717948717949,0.8717948717948718,0.1282051282051282,746,130,207,409,688,58,0.1742627345844504,0.2774798927613941,0.5482573726541555,0.9222520107238605,0.0777479892761394
1962,520,359,161,430,90,0.6903846153846154,0.3096153846153846,0.8269230769230769,0.17307692307692307,1080,292,287,501,1010,70,0.27037037037037037,0.2657407407407407,0.4638888888888889,0.9351851851851852,0.06481481481481481
1963,692,478,214,564,128,0.6907514450867052,0.3092485549132948,0.815028901734104,0.18497109826589594,1143,222,283,638,980,163,0.1942257217847769,0.24759405074365703,0.558180227471566,0.8573928258967629,0.1426071741032371
1964,829,586,243,672,157,0.706875753920386,0.293124246079614,0.8106151990349819,0.18938480096501809,1098,187,370,541,966,132,0.1703096539162113,0.33697632058287796,0.49271402550091076,0.8797814207650273,0.12021857923497267
1965,363,230,133,314,49,0.6336088154269972,0.36639118457300274,0.8650137741046832,0.1349862258953168,623,148,198,277,571,52,0.2375601926163724,0.31781701444622795,0.4446227929373997,0.9165329052969502,0.08346709470304976
1966,1274,959,315,1032,242,0.7527472527472527,0.24725274725274726,0.8100470957613815,0.18995290423861852,1235,248,408,579,1094,141,0.20080971659919028,0.3303643724696356,0.4688259109311741,0.8858299595141701,0.11417004048582996
1967,469,280,189,386,83,0.5970149253731343,0.40298507462686567,0.8230277185501066,0.17697228144989338,871,115,241,515,797,74,0.13203214695752008,0.2766934557979334,0.5912743972445464,0.9150401836969001,0.08495981630309989
1968,309,182,127,268,41,0.5889967637540453,0.4110032362459547,0.8673139158576052,0.13268608414239483,617,149,203,265,565,52,0.24149108589951376,0.32901134521880065,0.42949756888168555,0.9157212317666127,0.08427876823338736
1969,1294,998,296,1085,209,0.7712519319938176,0.2287480680061824,0.8384853168469861,0.1615146831530139,1177,102,232,843,899,278,0.08666100254885302,0.19711129991503823,0.7162276975361087,0.7638062871707731,0.23619371282922685
1970,730,504,226,579,151,0.6904109589041096,0.3095890410958904,0.7931506849315069,0.20684931506849316,899,120,362,417,826,73,0.13348164627363737,0.40266963292547275,0.4638487208008899,0.9187986651835373,0.08120133481646273
1971,779,536,243,654,125,0.6880616174582799,0.3119383825417201,0.8395378690629012,0.16046213093709885,1041,100,210,731,817,224,0.09606147934678194,0.2017291066282421,0.7022094140249759,0.7848222862632085,0.21517771373679154
1972,1501,1253,248,1284,217,0.8347768154563624,0.16522318454363757,0.8554297135243171,0.14457028647568287,1179,175,318,686,955,224,0.1484308736217133,0.2697201017811705,0.5818490245971162,0.8100084817642069,0.18999151823579305
1973,833,626,207,744,89,0.751500600240096,0.24849939975990396,0.8931572629051621,0.10684273709483794,967,142,243,582,766,201,0.1468459152016546,0.2512926577042399,0.6018614270941055,0.7921406411582212,0.2078593588417787
1974,366,221,145,315,51,0.6038251366120219,0.39617486338797814,0.860655737704918,0.13934426229508196,756,134,254,368,639,117,0.17724867724867724,0.335978835978836,0.48677248677248675,0.8452380952380952,0.15476190476190477
1975,321,190,131,280,41,0.5919003115264797,0.40809968847352024,0.8722741433021807,0.1277258566978193,394,16,117,261,342,52,0.04060913705583756,0.2969543147208122,0.6624365482233503,0.868020304568528,0.1319796954314721
1976,554,343,211,437,117,0.6191335740072202,0.38086642599277976,0.7888086642599278,0.2111913357400722,817,132,249,436,744,73,0.16156670746634028,0.3047735618115055,0.5336597307221542,0.9106487148102815,0.08935128518971848
1977,579,357,222,459,120,0.616580310880829,0.38341968911917096,0.7927461139896373,0.20725388601036268,821,134,241,446,748,73,0.16321559074299635,0.2935444579780755,0.5432399512789281,0.9110840438489647,0.08891595615103533
1978,457,280,177,376,81,0.612691466083151,0.387308533916849,0.8227571115973742,0.1772428884026258,742,93,199,450,672,70,0.12533692722371967,0.26819407008086255,0.6064690026954178,0.9056603773584906,0.09433962264150944
1979,466,286,180,383,83,0.6137339055793991,0.38626609442060084,0.8218884120171673,0.1781115879828326,1207,303,260,644,1050,157,0.2510356255178128,0.21541010770505387,0.5335542667771334,0.8699254349627175,0.1300745650372825
1980,1199,923,276,996,203,0.7698081734778982,0.23019182652210174,0.8306922435362802,0.16930775646371976,1298,225,422,651,1069,229,0.17334360554699538,0.325115562403698,0.5015408320493067,0.8235747303543913,0.17642526964560862
1981,512,346,166,426,86,0.67578125,0.32421875,0.83203125,0.16796875,800,108,186,506,727,73,0.135,0.2325,0.6325,0.90875,0.09125
1982,595,433,162,500,95,0.7277310924369748,0.2722689075630252,0.8403361344537815,0.15966386554621848,1126,258,286,582,966,160,0.2291296625222025,0.2539964476021314,0.5168738898756661,0.8579040852575488,0.14209591474245115
1983,946,672,274,747,199,0.7103594080338267,0.28964059196617337,0.7896405919661733,0.21035940803382663,1332,273,399,660,1104,228,0.20495495495495494,0.29954954954954954,0.4954954954954955,0.8288288288288288,0.17117117117117117
1984,476,273,203,334,142,0.5735294117647058,0.4264705882352941,0.7016806722689075,0.29831932773109243,751,210,210,331,739,12,0.2796271637816245,0.2796271637816245,0.440745672436751,0.9840213049267643,0.015978695073235686
1985,188,94,94,94,94,0.5,0.5,0.5,0.5,211,0,1,210,201,10,0.0,0.004739336492890996,0.995260663507109,0.95260663507109,0.04739336492890995
1986,467,287,180,387,80,0.6145610278372591,0.3854389721627409,0.828693790149893,0.17130620985010706,774,106,215,453,704,70,0.13695090439276486,0.2777777777777778,0.5852713178294574,0.9095607235142119,0.09043927648578812
1987,66,18,48,29,37,0.2727272727272727,0.7272727272727273,0.4393939393939394,0.5606060606060606,633,223,159,251,623,10,0.3522906793048973,0.25118483412322273,0.39652448657187994,0.9842022116903634,0.01579778830963665
1988,344,203,141,303,41,0.5901162790697675,0.40988372093023256,0.8808139534883721,0.11918604651162791,658,126,206,326,601,57,0.19148936170212766,0.3130699088145897,0.49544072948328266,0.9133738601823708,0.08662613981762918
1989,1250,1031,219,1093,157,0.8248,0.1752,0.8744,0.1256,1056,149,280,627,835,221,0.14109848484848486,0.26515151515151514,0.59375,0.790719696969697,0.20928030303030304
1990,710,493,217,571,139,0.6943661971830986,0.3056338028169014,0.8042253521126761,0.19577464788732393,1152,254,371,527,1017,135,0.2204861111111111,0.3220486111111111,0.4574652777777778,0.8828125,0.1171875
1991,769,546,223,615,154,0.7100130039011704,0.28998699609882966,0.7997399219765929,0.20026007802340703,821,102,327,392,752,69,0.12423873325213154,0.3982947624847747,0.4774665042630938,0.9159561510353228,0.08404384896467722
1992,330,199,131,283,47,0.603030303030303,0.396969696969697,0.8575757575757575,0.14242424242424243,741,134,197,410,682,59,0.18083670715249664,0.2658569500674764,0.553306342780027,0.9203778677462888,0.0796221322537112
1993,341,220,121,297,44,0.6451612903225806,0.3548387096774194,0.8709677419354839,0.12903225806451613,815,121,223,471,694,121,0.14846625766871166,0.27361963190184047,0.5779141104294478,0.8515337423312883,0.14846625766871166
1994,1295,1001,294,1084,211,0.772972972972973,0.22702702702702704,0.8370656370656371,0.16293436293436295,1172,102,231,839,894,278,0.08703071672354949,0.197098976109215,0.7158703071672355,0.7627986348122867,0.23720136518771331
1995,342,223,119,298,44,0.652046783625731,0.347953216374269,0.8713450292397661,0.1286549707602339,634,172,206,256,581,53,0.27129337539432175,0.3249211356466877,0.4037854889589905,0.916403785488959,0.083596214511041
1996,600,385,215,475,125,0.6416666666666667,0.35833333333333334,0.7916666666666666,0.20833333333333334,762,107,237,418,688,74,0.14041994750656167,0.3110236220472441,0.5485564304461942,0.9028871391076115,0.09711286089238845
1997,1295,998,297,1086,209,0.7706563706563706,0.22934362934362934,0.8386100386100386,0.1613899613899614,1177,102,231,844,899,278,0.08666100254885302,0.19626168224299065,0.7170773152081563,0.7638062871707731,0.23619371282922685
1998,357,221,136,314,43,0.6190476190476191,0.38095238095238093,0.8795518207282913,0.12044817927170869,797,174,261,362,679,118,0.21831869510664995,0.32747804265997493,0.45420326223337515,0.8519447929736512,0.1480552070263488
1999,1292,998,294,1083,209,0.7724458204334366,0.22755417956656346,0.8382352941176471,0.16176470588235295,1177,102,234,841,899,278,0.08666100254885302,0.1988105352591334,0.7145284621920136,0.7638062871707731,0.23619371282922685
2000,643,400,243,479,164,0.6220839813374806,0.37791601866251945,0.744945567651633,0.25505443234836706,895,182,228,485,830,65,0.20335195530726258,0.2547486033519553,0.5418994413407822,0.9273743016759777,0.07262569832402235
2001,554,346,208,435,119,0.6245487364620939,0.37545126353790614,0.7851985559566786,0.2148014440433213,739,109,221,409,667,72,0.14749661705006767,0.29905277401894453,0.5534506089309879,0.9025710419485792,0.09742895805142084
2002,478,289,189,398,80,0.604602510460251,0.39539748953974896,0.8326359832635983,0.16736401673640167,816,96,233,487,745,71,0.11764705882352941,0.2855392156862745,0.5968137254901961,0.9129901960784313,0.08700980392156862
2003,635,314,321,528,107,0.494488188976378,0.5055118110236221,0.831496062992126,0.16850393700787403,1303,100,190,1013,879,424,0.07674597083653108,0.14581734458940906,0.7774366845740599,0.6745970836531082,0.3254029163468918
2004,779,536,243,654,125,0.6880616174582799,0.3119383825417201,0.8395378690629012,0.16046213093709885,1041,100,210,731,817,224,0.09606147934678194,0.2017291066282421,0.7022094140249759,0.7848222862632085,0.21517771373679154
2005,260,116,144,97,163,0.4461538461538462,0.5538461538461539,0.3730769230769231,0.6269230769230769,407,189,173,45,407,0,0.4643734643734644,0.4250614250614251,0.11056511056511056,1.0,0.0
2006,1290,998,292,1081,209,0.7736434108527132,0.22635658914728682,0.837984496124031,0.162015503875969,1171,102,230,839,893,278,0.08710503842869342,0.1964133219470538,0.7164816396242528,0.762596071733561,0.23740392826643894
2007,690,488,202,557,133,0.7072463768115942,0.2927536231884058,0.8072463768115942,0.1927536231884058,816,106,322,388,748,68,0.12990196078431374,0.3946078431372549,0.47549019607843135,0.9166666666666666,0.08333333333333333
2008,566,354,212,446,120,0.6254416961130742,0.3745583038869258,0.7879858657243817,0.21201413427561838,776,114,233,429,705,71,0.14690721649484537,0.3002577319587629,0.5528350515463918,0.9085051546391752,0.09149484536082474
2009,236,101,135,206,30,0.4279661016949153,0.5720338983050848,0.8728813559322034,0.1271186440677966,615,76,134,405,429,186,0.12357723577235773,0.21788617886178863,0.6585365853658537,0.697560975609756,0.3024390243902439
2010,1257,1035,222,1100,157,0.8233890214797136,0.1766109785202864,0.8750994431185362,0.1249005568814638,1059,149,280,630,837,222,0.14069877242681775,0.26440037771482533,0.5949008498583569,0.7903682719546742,0.2096317280453258
2011,166,41,125,157,9,0.2469879518072289,0.7530120481927711,0.9457831325301205,0.05421686746987952,708,132,174,402,650,58,0.1864406779661017,0.2457627118644068,0.5677966101694916,0.9180790960451978,0.08192090395480225
2012,1226,963,263,1000,226,0.7854812398042414,0.21451876019575855,0.8156606851549756,0.18433931484502447,1236,235,401,600,1070,166,0.1901294498381877,0.3244336569579288,0.4854368932038835,0.8656957928802589,0.1343042071197411
2013,1254,1033,221,1098,156,0.8237639553429027,0.1762360446570973,0.8755980861244019,0.12440191387559808,1069,155,278,636,847,222,0.1449953227315248,0.2600561272217025,0.5949485500467727,0.7923292797006548,0.2076707202993452
2014,408,224,184,317,91,0.5490196078431373,0.45098039215686275,0.7769607843137255,0.22303921568627452,622,107,161,354,555,67,0.1720257234726688,0.25884244372990356,0.5691318327974276,0.8922829581993569,0.10771704180064309
2015,452,278,174,364,88,0.6150442477876106,0.38495575221238937,0.8053097345132744,0.19469026548672566,891,102,190,599,724,167,0.11447811447811448,0.2132435465768799,0.6722783389450057,0.8125701459034792,0.18742985409652077
2016,547,352,195,424,123,0.643510054844607,0.35648994515539306,0.7751371115173674,0.22486288848263253,741,135,198,408,673,68,0.18218623481781376,0.26720647773279355,0.5506072874493927,0.9082321187584346,0.09176788124156546
2017,1539,1283,256,1320,219,0.8336582196231319,0.1663417803768681,0.8576998050682261,0.14230019493177387,1186,172,326,688,962,224,0.14502529510961215,0.2748735244519393,0.5801011804384486,0.8111298482293423,0.18887015177065766
2018,1494,1249,245,1278,216,0.8360107095046854,0.1639892904953146,0.8554216867469879,0.14457831325301204,1134,154,309,671,910,224,0.13580246913580246,0.2724867724867725,0.591710758377425,0.8024691358024691,0.19753086419753085
2019,506,335,171,433,73,0.6620553359683794,0.33794466403162055,0.8557312252964426,0.1442687747035573,470,34,116,320,463,7,0.07234042553191489,0.24680851063829787,0.6808510638297872,0.9851063829787234,0.014893617021276596
2020,396,251,145,333,63,0.6338383838383839,0.3661616161616162,0.8409090909090909,0.1590909090909091,660,178,225,257,608,52,0.2696969696969697,0.3409090909090909,0.3893939393939394,0.9212121212121213,0.07878787878787878
2021,1412,1173,239,1208,204,0.8307365439093485,0.16926345609065155,0.8555240793201133,0.14447592067988668,1170,166,320,684,945,225,0.14188034188034188,0.27350427350427353,0.5846153846153846,0.8076923076923077,0.19230769230769232
2022,1166,878,288,911,255,0.7530017152658662,0.2469982847341338,0.7813036020583191,0.21869639794168097,1157,102,227,828,879,278,0.0881590319792567,0.1961970613656007,0.7156439066551427,0.759723422644771,0.24027657735522903
2023,1304,1015,289,1092,212,0.7783742331288344,0.22162576687116564,0.8374233128834356,0.16257668711656442,759,103,225,431,741,18,0.13570487483530963,0.2964426877470356,0.5678524374176548,0.9762845849802372,0.023715415019762844
2024,335,162,173,274,61,0.4835820895522388,0.5164179104477612,0.817910447761194,0.18208955223880596,601,89,152,360,534,67,0.1480865224625624,0.2529118136439268,0.5990016638935108,0.8885191347753744,0.11148086522462562
2025,5208,4560,648,4449,759,0.8755760368663594,0.12442396313364056,0.8542626728110599,0.14573732718894009,2175,176,596,1403,1710,465,0.08091954022988505,0.27402298850574713,0.6450574712643679,0.7862068965517242,0.21379310344827587
2026,731,499,232,585,146,0.6826265389876881,0.3173734610123119,0.8002735978112175,0.1997264021887825,1180,186,363,631,955,225,0.1576271186440678,0.3076271186440678,0.5347457627118644,0.809322033898305,0.1906779661016949
2027,646,401,245,516,130,0.6207430340557275,0.37925696594427244,0.7987616099071208,0.20123839009287925,842,125,291,426,771,71,0.14845605700712589,0.34560570071258906,0.505938242280285,0.9156769596199525,0.08432304038004751
2028,790,547,243,642,148,0.6924050632911393,0.30759493670886073,0.8126582278481013,0.18734177215189873,1071,98,212,761,844,227,0.0915032679738562,0.19794584500466852,0.7105508870214753,0.7880485527544351,0.2119514472455649
2029,1852,1517,335,1550,302,0.8191144708423326,0.1808855291576674,0.8369330453563715,0.1630669546436285,1257,149,375,733,1079,178,0.11853619729514718,0.29832935560859186,0.5831344470962609,0.858392999204455,0.14160700079554495
2030,1507,1255,252,1291,216,0.8327803583278036,0.1672196416721964,0.8566688785666888,0.14333112143331123,1181,176,321,684,956,225,0.14902624894157493,0.2718035563082134,0.5791701947502117,0.8094834885690093,0.1905165114309907
2031,554,344,210,437,117,0.6209386281588448,0.37906137184115524,0.7888086642599278,0.2111913357400722,764,121,230,413,692,72,0.15837696335078533,0.3010471204188482,0.5405759162303665,0.9057591623036649,0.09424083769633508
2032,332,214,118,287,45,0.6445783132530121,0.35542168674698793,0.8644578313253012,0.1355421686746988,661,128,223,310,545,116,0.19364599092284418,0.3373676248108926,0.4689863842662632,0.8245083207261724,0.17549167927382753
2033,369,192,177,283,86,0.5203252032520326,0.4796747967479675,0.7669376693766937,0.23306233062330622,612,109,158,345,545,67,0.1781045751633987,0.2581699346405229,0.5637254901960784,0.8905228758169934,0.10947712418300654
2034,465,228,237,364,101,0.49032258064516127,0.5096774193548387,0.7827956989247312,0.2172043010752688,1307,99,192,1016,868,439,0.0757459831675593,0.14690130068859986,0.7773527161438408,0.6641162968630452,0.33588370313695487
2035,1168,878,290,913,255,0.7517123287671232,0.2482876712328767,0.7816780821917808,0.2183219178082192,1172,102,235,835,894,278,0.08703071672354949,0.20051194539249148,0.712457337883959,0.7627986348122867,0.23720136518771331
2036,1222,886,336,945,277,0.7250409165302782,0.27495908346972175,0.7733224222585925,0.22667757774140754,1078,166,354,558,939,139,0.15398886827458255,0.32838589981447125,0.5176252319109462,0.8710575139146568,0.12894248608534323
2037,692,502,190,560,132,0.7254335260115607,0.2745664739884393,0.8092485549132948,0.1907514450867052,1134,123,302,709,987,147,0.10846560846560846,0.26631393298059963,0.6252204585537919,0.8703703703703703,0.12962962962962962
2038,6425,5630,795,5288,1137,0.8762645914396887,0.12373540856031129,0.8230350194552529,0.17696498054474707,2291,237,604,1450,1790,501,0.10344827586206896,0.2636403317328677,0.6329113924050633,0.7813182016586644,0.21868179834133566
2039,1413,1121,292,1181,232,0.7933474876150035,0.20665251238499646,0.8358103326256192,0.16418966737438076,1174,102,232,840,896,278,0.0868824531516184,0.19761499148211242,0.7155025553662692,0.7632027257240205,0.23679727427597955
2040,440,319,121,380,60,0.725,0.275,0.8636363636363636,0.13636363636363635,804,199,208,397,706,98,0.24751243781094528,0.25870646766169153,0.4937810945273632,0.8781094527363185,0.12189054726368159
2041,655,467,188,528,127,0.7129770992366412,0.2870229007633588,0.8061068702290076,0.19389312977099238,804,115,315,374,736,68,0.14303482587064675,0.3917910447761194,0.4651741293532338,0.9154228855721394,0.0845771144278607
2042,1252,1031,221,1095,157,0.8234824281150159,0.17651757188498401,0.8746006389776357,0.1253993610223642,1063,149,289,625,842,221,0.14016933207902163,0.2718720602069614,0.587958607714017,0.7920978363123237,0.2079021636876764
2043,1161,879,282,903,258,0.7571059431524548,0.24289405684754523,0.7777777777777778,0.2222222222222222,1156,102,230,824,878,278,0.08823529411764706,0.19896193771626297,0.71280276816609,0.759515570934256,0.24048442906574394
2044,1543,1290,253,1323,220,0.8360337005832793,0.16396629941672067,0.8574206092028516,0.1425793907971484,1172,169,318,685,946,226,0.14419795221843004,0.2713310580204778,0.5844709897610921,0.8071672354948806,0.19283276450511946
2045,1254,1031,223,1097,157,0.8221690590111643,0.17783094098883573,0.8748006379585327,0.1251993620414673,1077,149,294,634,856,221,0.13834726090993502,0.27298050139275765,0.5886722376973074,0.7948003714020427,0.2051996285979573
2046,1226,970,256,1015,211,0.7911908646003263,0.20880913539967375,0.8278955954323002,0.17210440456769985,1167,241,409,517,1036,131,0.20651242502142245,0.350471293916024,0.44301628106255353,0.8877463581833762,0.11225364181662383
2047,479,298,181,395,84,0.6221294363256785,0.3778705636743215,0.824634655532359,0.17536534446764093,792,95,215,482,722,70,0.11994949494949494,0.27146464646464646,0.6085858585858586,0.9116161616161617,0.08838383838383838
2048,1428,1182,246,1219,209,0.8277310924369747,0.1722689075630252,0.853641456582633,0.14635854341736695,1161,166,317,678,935,226,0.1429801894918174,0.2730404823428079,0.5839793281653747,0.8053402239448751,0.19465977605512488
2049,1284,998,286,1075,209,0.7772585669781932,0.22274143302180685,0.8372274143302181,0.16277258566978192,1164,102,228,834,886,278,0.08762886597938144,0.1958762886597938,0.7164948453608248,0.761168384879725,0.23883161512027493
2050,496,324,172,422,74,0.6532258064516129,0.3467741935483871,0.8508064516129032,0.14919354838709678,477,34,115,328,470,7,0.07127882599580712,0.24109014675052412,0.6876310272536688,0.9853249475890985,0.014675052410901468
2051,1303,974,329,1044,259,0.7475057559478128,0.25249424405218723,0.8012279355333844,0.1987720644666155,1239,262,427,550,1103,136,0.21146085552865213,0.3446327683615819,0.44390637610976597,0.8902340597255851,0.10976594027441484
2052,1476,1139,337,1156,320,0.771680216802168,0.22831978319783197,0.7831978319783198,0.21680216802168023,1329,196,400,733,1065,264,0.1474793077501881,0.3009781790820166,0.5515425131677953,0.801354401805869,0.1986455981941309
2053,460,286,174,378,82,0.6217391304347826,0.3782608695652174,0.8217391304347826,0.1782608695652174,790,104,203,483,718,72,0.13164556962025317,0.2569620253164557,0.6113924050632912,0.9088607594936708,0.09113924050632911
2054,1289,998,291,1080,209,0.7742435996896819,0.22575640031031807,0.8378588052754073,0.1621411947245927,1174,102,233,839,896,278,0.0868824531516184,0.19846678023850084,0.7146507666098807,0.7632027257240205,0.23679727427597955
2055,1422,1182,240,1216,206,0.8312236286919831,0.16877637130801687,0.8551336146272855,0.14486638537271448,1134,154,309,671,909,225,0.13580246913580246,0.2724867724867725,0.591710758377425,0.8015873015873016,0.1984126984126984
2056,1248,1032,216,1091,157,0.8269230769230769,0.17307692307692307,0.874198717948718,0.12580128205128205,1053,150,268,635,831,222,0.14245014245014245,0.25451092117758783,0.6030389363722697,0.7891737891737892,0.21082621082621084
2057,566,393,173,476,90,0.6943462897526502,0.30565371024734983,0.8409893992932862,0.15901060070671377,1280,262,324,694,1054,226,0.2046875,0.253125,0.5421875,0.8234375,0.1765625
2058,918,682,236,745,173,0.7429193899782135,0.2570806100217865,0.8115468409586056,0.18845315904139434,838,124,326,388,770,68,0.14797136038186157,0.38902147971360385,0.4630071599045346,0.918854415274463,0.081145584725537
2059,639,321,318,382,257,0.5023474178403756,0.49765258215962443,0.5978090766823161,0.40219092331768386,565,193,191,181,557,8,0.3415929203539823,0.3380530973451327,0.32035398230088497,0.9858407079646018,0.01415929203539823
2060,200,108,92,78,122,0.54,0.46,0.39,0.61,441,202,196,43,441,0,0.4580498866213152,0.4444444444444444,0.09750566893424037,1.0,0.0
2061,174,51,123,157,17,0.29310344827586204,0.7068965517241379,0.9022988505747126,0.09770114942528736,756,144,179,433,698,58,0.19047619047619047,0.23677248677248677,0.5727513227513228,0.9232804232804233,0.07671957671957672
2062,350,228,122,308,42,0.6514285714285715,0.3485714285714286,0.88,0.12,765,177,262,326,649,116,0.23137254901960785,0.34248366013071896,0.4261437908496732,0.8483660130718954,0.15163398692810456
2063,459,281,178,377,82,0.6122004357298475,0.3877995642701525,0.8213507625272332,0.1786492374727669,738,95,189,454,667,71,0.12872628726287264,0.25609756097560976,0.6151761517615176,0.9037940379403794,0.09620596205962059
2064,1571,1290,281,1311,260,0.8211330362826226,0.17886696371737745,0.8345003182686187,0.1654996817313813,1377,253,418,706,1108,269,0.18373275236020334,0.30355846042120554,0.5127087872185911,0.8046477850399419,0.19535221496005808
2065,1293,1001,292,1082,211,0.774168600154679,0.22583139984532097,0.8368136117556071,0.16318638824439288,1168,102,229,837,890,278,0.08732876712328767,0.19606164383561644,0.7166095890410958,0.761986301369863,0.238013698630137
2066,12597,11698,899,11656,941,0.9286338016988172,0.07136619830118282,0.9252996745256807,0.07470032547431928,625,76,125,424,425,200,0.1216,0.2,0.6784,0.68,0.32
2067,1289,998,291,1080,209,0.7742435996896819,0.22575640031031807,0.8378588052754073,0.1621411947245927,1173,102,231,840,895,278,0.08695652173913043,0.1969309462915601,0.7161125319693095,0.763000852514919,0.236999147485081
2068,1279,1051,228,1119,160,0.8217357310398749,0.1782642689601251,0.8749022673964034,0.12509773260359655,1063,149,272,642,842,221,0.14016933207902163,0.2558795860771402,0.6039510818438382,0.7920978363123237,0.2079021636876764
2069,337,221,116,293,44,0.655786350148368,0.34421364985163205,0.8694362017804155,0.13056379821958458,838,150,234,454,717,121,0.17899761336515513,0.27923627684964203,0.5417661097852029,0.8556085918854416,0.14439140811455847
2070,475,281,194,392,83,0.5915789473684211,0.40842105263157896,0.8252631578947368,0.17473684210526316,831,95,238,498,759,72,0.11432009626955475,0.28640192539109505,0.5992779783393501,0.9133574007220217,0.08664259927797834
2071,644,393,251,480,164,0.610248447204969,0.38975155279503104,0.7453416149068323,0.2546583850931677,893,156,231,506,828,65,0.17469204927211646,0.25867861142217247,0.5666293393057111,0.9272116461366181,0.07278835386338185
2072,1503,1256,247,1287,216,0.8356620093147039,0.1643379906852961,0.8562874251497006,0.1437125748502994,1178,175,322,681,954,224,0.14855687606112053,0.2733446519524618,0.5780984719864176,0.8098471986417657,0.19015280135823429
2073,1286,998,288,1077,209,0.776049766718507,0.223950233281493,0.8374805598755832,0.1625194401244168,1171,102,232,837,893,278,0.08710503842869342,0.1981212638770282,0.7147736976942783,0.762596071733561,0.23740392826643894
2074,327,199,128,286,41,0.6085626911314985,0.39143730886850153,0.8746177370030581,0.12538226299694188,591,136,195,260,539,52,0.23011844331641285,0.3299492385786802,0.43993231810490696,0.9120135363790186,0.08798646362098139
2075,799,568,231,660,139,0.7108886107634543,0.28911138923654567,0.8260325406758448,0.1739674593241552,1226,211,382,633,1000,226,0.17210440456769985,0.31158238172920066,0.5163132137030995,0.8156606851549756,0.18433931484502447
2076,343,210,133,298,45,0.6122448979591837,0.3877551020408163,0.8688046647230321,0.13119533527696792,898,135,250,513,775,123,0.15033407572383073,0.27839643652561247,0.5712694877505567,0.8630289532293987,0.13697104677060135
2077,345,171,174,263,82,0.4956521739130435,0.5043478260869565,0.7623188405797101,0.23768115942028986,590,91,152,347,522,68,0.15423728813559323,0.2576271186440678,0.588135593220339,0.8847457627118644,0.1152542372881356
2078,499,320,179,412,87,0.6412825651302605,0.3587174348697395,0.8256513026052105,0.1743486973947896,764,95,193,476,691,73,0.1243455497382199,0.2526178010471204,0.6230366492146597,0.9044502617801047,0.09554973821989529
2079,350,222,128,307,43,0.6342857142857142,0.3657142857142857,0.8771428571428571,0.12285714285714286,715,134,237,344,599,116,0.1874125874125874,0.33146853146853145,0.4811188811188811,0.8377622377622378,0.16223776223776223
2080,579,382,197,466,113,0.6597582037996546,0.34024179620034545,0.8048359240069085,0.19516407599309155,761,116,228,417,688,73,0.15243101182654403,0.2996057818659658,0.5479632063074902,0.9040735873850198,0.09592641261498029
2081,1295,998,297,1086,209,0.7706563706563706,0.22934362934362934,0.8386100386100386,0.1613899613899614,1173,102,229,842,895,278,0.08695652173913043,0.19522591645353793,0.7178175618073316,0.763000852514919,0.236999147485081
2082,1214,877,337,959,255,0.7224052718286655,0.2775947281713344,0.7899505766062603,0.2100494233937397,1204,102,242,860,926,278,0.08471760797342193,0.2009966777408638,0.7142857142857143,0.7691029900332226,0.23089700996677742
2083,1260,1032,228,1103,157,0.819047619047619,0.18095238095238095,0.8753968253968254,0.1246031746031746,1069,149,281,639,847,222,0.13938260056127222,0.2628624883068288,0.5977549111318989,0.7923292797006548,0.2076707202993452
2084,1249,1032,217,1092,157,0.8262610088070457,0.17373899119295436,0.8742994395516414,0.1257005604483587,1073,150,287,636,851,222,0.13979496738117428,0.2674743709226468,0.5927306616961789,0.7931034482758621,0.20689655172413793
2085,393,231,162,324,69,0.5877862595419847,0.4122137404580153,0.8244274809160306,0.17557251908396945,966,185,187,594,805,161,0.1915113871635611,0.19358178053830227,0.6149068322981367,0.8333333333333334,0.16666666666666666
2086,831,625,206,742,89,0.7521058965102286,0.24789410348977137,0.8929001203369434,0.10709987966305656,978,142,246,590,777,201,0.14519427402862986,0.25153374233128833,0.6032719836400818,0.7944785276073619,0.20552147239263804
2087,1183,905,278,956,227,0.7650042265426881,0.23499577345731193,0.8081149619611158,0.19188503803888418,1259,206,410,643,1029,230,0.1636219221604448,0.3256552819698173,0.5107227958697379,0.8173153296266878,0.18268467037331215
2088,538,365,173,440,98,0.6784386617100372,0.3215613382899628,0.8178438661710037,0.1821561338289963,986,191,232,563,827,159,0.19371196754563894,0.23529411764705882,0.5709939148073022,0.8387423935091278,0.1612576064908722
2089,238,114,124,209,29,0.4789915966386555,0.5210084033613446,0.8781512605042017,0.12184873949579832,626,78,123,425,426,200,0.12460063897763578,0.1964856230031949,0.6789137380191693,0.6805111821086262,0.3194888178913738
2090,328,192,136,284,44,0.5853658536585366,0.4146341463414634,0.8658536585365854,0.13414634146341464,773,126,200,447,714,59,0.1630012936610608,0.258732212160414,0.5782664941785253,0.9236739974126779,0.07632600258732213
2091,1289,998,291,1080,209,0.7742435996896819,0.22575640031031807,0.8378588052754073,0.1621411947245927,1174,102,233,839,896,278,0.0868824531516184,0.19846678023850084,0.7146507666098807,0.7632027257240205,0.23679727427597955
2092,1295,998,297,1086,209,0.7706563706563706,0.22934362934362934,0.8386100386100386,0.1613899613899614,1179,102,233,844,901,278,0.08651399491094147,0.19762510602205258,0.7158608990670059,0.7642069550466497,0.2357930449533503
2093,313,183,130,272,41,0.5846645367412141,0.41533546325878595,0.8690095846645367,0.13099041533546327,695,110,191,394,636,59,0.15827338129496402,0.27482014388489207,0.5669064748201439,0.9151079136690647,0.08489208633093526
2094,1255,1039,216,1098,157,0.8278884462151395,0.17211155378486057,0.8749003984063745,0.1250996015936255,1072,155,276,641,850,222,0.14458955223880596,0.2574626865671642,0.5979477611940298,0.792910447761194,0.20708955223880596
2095,326,205,121,279,47,0.6288343558282209,0.37116564417177916,0.8558282208588958,0.1441717791411043,711,126,182,403,653,58,0.17721518987341772,0.2559774964838256,0.5668073136427567,0.9184247538677919,0.08157524613220815
2096,401,224,177,312,89,0.5586034912718204,0.44139650872817954,0.7780548628428927,0.22194513715710723,619,114,160,345,552,67,0.1841680129240711,0.25848142164781907,0.5573505654281099,0.8917609046849758,0.10823909531502424
2097,572,357,215,451,121,0.6241258741258742,0.3758741258741259,0.7884615384615384,0.21153846153846154,737,105,221,411,664,73,0.14246947082767977,0.29986431478968795,0.5576662143826323,0.9009497964721845,0.09905020352781546
2098,441,287,154,381,60,0.6507936507936508,0.3492063492063492,0.8639455782312925,0.1360544217687075,821,159,271,391,701,120,0.19366626065773446,0.33008526187576126,0.4762484774665043,0.853836784409257,0.146163215590743
2099,884,646,238,726,158,0.7307692307692307,0.2692307692307692,0.8212669683257918,0.17873303167420815,1256,292,443,521,1125,131,0.23248407643312102,0.35270700636942676,0.4148089171974522,0.8957006369426752,0.10429936305732485
2100,340,208,132,296,44,0.611764705882353,0.38823529411764707,0.8705882352941177,0.12941176470588237,724,139,245,340,608,116,0.1919889502762431,0.3383977900552486,0.4696132596685083,0.8397790055248618,0.16022099447513813
2101,4686,4107,579,4009,677,0.8764404609475032,0.1235595390524968,0.8555271020059753,0.14447289799402477,2214,231,550,1433,1741,473,0.1043360433604336,0.24841915085817526,0.6472448057813911,0.7863595302619693,0.21364046973803072
2102,1528,1270,258,1309,219,0.831151832460733,0.168848167539267,0.856675392670157,0.14332460732984292,1210,175,336,699,985,225,0.1446280991735537,0.27768595041322314,0.5776859504132231,0.8140495867768595,0.1859504132231405
2103,1514,1266,248,1298,216,0.8361955085865258,0.16380449141347425,0.857331571994716,0.142668428005284,1158,163,321,674,932,226,0.14075993091537134,0.2772020725388601,0.5820379965457686,0.8048359240069085,0.19516407599309155
2104,338,214,124,295,43,0.6331360946745562,0.3668639053254438,0.8727810650887574,0.12721893491124261,680,190,225,265,628,52,0.27941176470588236,0.33088235294117646,0.3897058823529412,0.9235294117647059,0.07647058823529412
2105,570,385,185,470,100,0.6754385964912281,0.32456140350877194,0.8245614035087719,0.17543859649122806,1473,353,376,744,1242,231,0.2396469789545146,0.25526137135098437,0.505091649694501,0.8431771894093686,0.15682281059063136
2106,360,226,134,311,49,0.6277777777777778,0.37222222222222223,0.8638888888888889,0.1361111111111111,714,126,186,402,656,58,0.17647058823529413,0.2605042016806723,0.5630252100840336,0.9187675070028011,0.08123249299719888
2107,1284,998,286,1075,209,0.7772585669781932,0.22274143302180685,0.8372274143302181,0.16277258566978192,1167,102,230,835,889,278,0.08740359897172237,0.19708654670094258,0.715509854327335,0.7617823479005998,0.23821765209940018
2108,1251,1032,219,1094,157,0.8249400479616307,0.1750599520383693,0.8745003996802558,0.1254996003197442,1053,149,274,630,831,222,0.14150047483380818,0.26020892687559355,0.5982905982905983,0.7891737891737892,0.21082621082621084
2109,424,284,140,348,76,0.6698113207547169,0.330188679245283,0.8207547169811321,0.1792452830188679,774,155,216,403,714,60,0.20025839793281655,0.27906976744186046,0.520671834625323,0.9224806201550387,0.07751937984496124
2110,1290,998,292,1081,209,0.7736434108527132,0.22635658914728682,0.837984496124031,0.162015503875969,1176,102,232,842,898,278,0.08673469387755102,0.19727891156462585,0.7159863945578231,0.7636054421768708,0.23639455782312926
2111,73,33,40,43,30,0.4520547945205479,0.547945205479452,0.589041095890411,0.410958904109589,576,153,139,284,530,46,0.265625,0.24131944444444445,0.4930555555555556,0.9201388888888888,0.0798611111111111
2112,340,224,116,286,54,0.6588235294117647,0.3411764705882353,0.8411764705882353,0.1588235294117647,590,160,156,274,578,12,0.2711864406779661,0.26440677966101694,0.46440677966101696,0.9796610169491525,0.020338983050847456
2113,1822,1498,324,1532,290,0.8221734357848518,0.1778265642151482,0.8408342480790341,0.15916575192096596,1249,147,378,724,1070,179,0.1176941553242594,0.3026421136909528,0.5796637309847879,0.8566853482786229,0.1433146517213771
2114,701,500,201,570,131,0.7132667617689016,0.2867332382310984,0.8131241084165478,0.18687589158345222,835,122,316,397,766,69,0.14610778443113773,0.3784431137724551,0.4754491017964072,0.9173652694610779,0.08263473053892216
2115,1201,924,277,991,210,0.7693588676103247,0.23064113238967526,0.8251457119067444,0.17485428809325562,1348,273,426,649,1112,236,0.20252225519287834,0.31602373887240354,0.4814540059347181,0.8249258160237388,0.17507418397626112
2116,1285,998,287,1076,209,0.7766536964980545,0.22334630350194554,0.8373540856031129,0.16264591439688716,1167,102,229,836,889,278,0.08740359897172237,0.19622964867180806,0.7163667523564696,0.7617823479005998,0.23821765209940018
2117,302,185,117,261,41,0.6125827814569537,0.38741721854304634,0.8642384105960265,0.1357615894039735,745,128,192,425,684,61,0.17181208053691274,0.25771812080536916,0.5704697986577181,0.9181208053691275,0.08187919463087248
2118,779,536,243,654,125,0.6880616174582799,0.3119383825417201,0.8395378690629012,0.16046213093709885,1041,100,210,731,817,224,0.09606147934678194,0.2017291066282421,0.7022094140249759,0.7848222862632085,0.21517771373679154
2119,374,193,181,298,76,0.516042780748663,0.4839572192513369,0.7967914438502673,0.20320855614973263,606,98,156,352,538,68,0.1617161716171617,0.25742574257425743,0.5808580858085809,0.8877887788778878,0.11221122112211221
2120,562,367,195,468,94,0.6530249110320284,0.3469750889679715,0.8327402135231317,0.16725978647686832,493,33,102,358,485,8,0.06693711967545639,0.20689655172413793,0.7261663286004056,0.9837728194726166,0.016227180527383367
2121,395,204,191,302,93,0.5164556962025316,0.4835443037974684,0.7645569620253164,0.23544303797468355,465,98,145,222,449,16,0.210752688172043,0.3118279569892473,0.4774193548387097,0.9655913978494624,0.034408602150537634
2122,315,183,132,273,42,0.580952380952381,0.41904761904761906,0.8666666666666667,0.13333333333333333,741,124,200,417,683,58,0.16734143049932523,0.2699055330634278,0.562753036437247,0.921727395411606,0.07827260458839407
2123,380,193,187,289,91,0.5078947368421053,0.4921052631578947,0.7605263157894737,0.2394736842105263,632,111,170,351,567,65,0.17563291139240506,0.2689873417721519,0.555379746835443,0.8971518987341772,0.10284810126582279
2124,1164,878,286,909,255,0.7542955326460481,0.24570446735395188,0.7809278350515464,0.2190721649484536,1166,102,235,829,888,278,0.08747855917667238,0.20154373927958832,0.7109777015437393,0.7615780445969125,0.23842195540308747
2125,317,196,121,277,40,0.6182965299684543,0.38170347003154576,0.8738170347003155,0.12618296529968454,619,147,214,258,566,53,0.23747980613893377,0.345718901453958,0.4168012924071082,0.9143780290791599,0.08562197092084006
2126,343,230,113,301,42,0.6705539358600583,0.3294460641399417,0.8775510204081632,0.12244897959183673,781,113,215,453,661,120,0.1446862996158771,0.2752880921895006,0.5800256081946222,0.8463508322663252,0.15364916773367476
2127,457,281,176,312,145,0.6148796498905909,0.3851203501094092,0.6827133479212254,0.3172866520787746,553,186,195,172,546,7,0.33634719710669075,0.352622061482821,0.31103074141048825,0.9873417721518988,0.012658227848101266
2128,427,231,196,330,97,0.5409836065573771,0.45901639344262296,0.7728337236533958,0.22716627634660422,612,102,157,353,548,64,0.16666666666666666,0.2565359477124183,0.576797385620915,0.8954248366013072,0.10457516339869281
2129,314,151,163,263,51,0.48089171974522293,0.5191082802547771,0.8375796178343949,0.1624203821656051,742,94,158,490,672,70,0.12668463611859837,0.21293800539083557,0.660377358490566,0.9056603773584906,0.09433962264150944
2130,1295,998,297,1086,209,0.7706563706563706,0.22934362934362934,0.8386100386100386,0.1613899613899614,1179,102,233,844,901,278,0.08651399491094147,0.19762510602205258,0.7158608990670059,0.7642069550466497,0.2357930449533503
2131,539,332,207,425,114,0.6159554730983302,0.38404452690166974,0.7884972170686456,0.21150278293135436,740,99,229,412,666,74,0.13378378378378378,0.30945945945945946,0.5567567567567567,0.9,0.1
2132,1288,998,290,1079,209,0.7748447204968945,0.2251552795031056,0.8377329192546584,0.1622670807453416,1172,102,230,840,894,278,0.08703071672354949,0.1962457337883959,0.7167235494880546,0.7627986348122867,0.23720136518771331
2133,886,627,259,704,182,0.7076749435665914,0.29232505643340856,0.7945823927765236,0.2054176072234763,1481,354,459,668,1259,222,0.23902768399729912,0.3099257258609048,0.4510465901417961,0.850101282916948,0.149898717083052
2134,814,592,222,675,139,0.7272727272727273,0.2727272727272727,0.8292383292383292,0.17076167076167076,1163,236,391,536,1037,126,0.20292347377472056,0.33619948409286327,0.46087704213241615,0.8916595012897678,0.10834049871023216
2135,597,403,194,485,112,0.6750418760469011,0.3249581239530988,0.8123953098827471,0.18760469011725292,1059,184,274,601,926,133,0.17374881964117092,0.2587346553352219,0.5675165250236072,0.874409820585458,0.125590179414542
2136,2705,2446,259,2288,417,0.9042513863216266,0.09574861367837338,0.8458410351201479,0.15415896487985212,1703,237,466,1000,1412,291,0.13916617733411626,0.2736347621843805,0.5871990604815033,0.8291250733998825,0.17087492660011744
2137,330,207,123,288,42,0.6272727272727273,0.37272727272727274,0.8727272727272727,0.12727272727272726,658,116,220,322,541,117,0.1762917933130699,0.3343465045592705,0.48936170212765956,0.8221884498480243,0.1778115501519757
2138,379,201,178,296,83,0.5303430079155673,0.46965699208443273,0.7810026385224275,0.21899736147757257,619,111,159,349,552,67,0.17932148626817448,0.2568659127625202,0.5638126009693053,0.8917609046849758,0.10823909531502424
2139,1292,998,294,1083,209,0.7724458204334366,0.22755417956656346,0.8382352941176471,0.16176470588235295,1177,102,234,841,899,278,0.08666100254885302,0.1988105352591334,0.7145284621920136,0.7638062871707731,0.23619371282922685
2140,620,130,490,329,291,0.20967741935483872,0.7903225806451613,0.5306451612903226,0.4693548387096774,180,3,69,108,180,0,0.016666666666666666,0.38333333333333336,0.6,1.0,0.0
2141,838,623,215,749,89,0.7434367541766109,0.256563245823389,0.8937947494033412,0.10620525059665871,1015,142,288,585,815,200,0.1399014778325123,0.28374384236453204,0.5763546798029556,0.8029556650246306,0.19704433497536947
2142,695,478,217,544,151,0.6877697841726619,0.3122302158273381,0.7827338129496403,0.21726618705035972,694,103,181,410,626,68,0.1484149855907781,0.260806916426513,0.590778097982709,0.9020172910662824,0.09798270893371758
2143,1260,1034,226,1101,159,0.8206349206349206,0.17936507936507937,0.8738095238095238,0.1261904761904762,1076,149,295,632,855,221,0.13847583643122677,0.2741635687732342,0.587360594795539,0.7946096654275093,0.2053903345724907
2144,330,199,131,277,53,0.603030303030303,0.396969696969697,0.8393939393939394,0.1606060606060606,613,160,202,251,561,52,0.26101141924959215,0.3295269168026101,0.4094616639477977,0.9151712887438825,0.08482871125611746
2145,1225,966,259,1016,209,0.7885714285714286,0.21142857142857144,0.8293877551020408,0.17061224489795918,1314,259,441,614,1166,148,0.19710806697108066,0.3356164383561644,0.4672754946727549,0.8873668188736682,0.1126331811263318
2146,578,347,231,455,123,0.6003460207612457,0.39965397923875434,0.78719723183391,0.21280276816608998,799,115,254,430,728,71,0.1439299123904881,0.31789737171464333,0.5381727158948686,0.9111389236545682,0.08886107634543179
2147,1172,880,292,914,258,0.7508532423208191,0.24914675767918087,0.7798634812286689,0.22013651877133106,1162,102,231,829,884,278,0.08777969018932874,0.19879518072289157,0.7134251290877797,0.7607573149741824,0.23924268502581755
2148,1291,998,293,1082,209,0.7730441518202944,0.22695584817970565,0.8381099922540666,0.16189000774593337,1172,102,231,839,894,278,0.08703071672354949,0.197098976109215,0.7158703071672355,0.7627986348122867,0.23720136518771331
2149,1262,1035,227,1105,157,0.8201267828843106,0.17987321711568938,0.875594294770206,0.12440570522979398,1094,155,298,641,873,221,0.1416819012797075,0.27239488117001825,0.5859232175502742,0.7979890310786106,0.2020109689213894
2150,167,96,71,74,93,0.5748502994011976,0.4251497005988024,0.4431137724550898,0.5568862275449101,384,170,174,40,384,0,0.4427083333333333,0.453125,0.10416666666666667,1.0,0.0
2151,1169,878,291,914,255,0.7510692899914457,0.24893071000855432,0.7818648417450813,0.21813515825491872,1161,102,230,829,883,278,0.08785529715762273,0.19810508182601205,0.7140396210163652,0.7605512489233419,0.23944875107665806
2152,460,293,167,376,84,0.6369565217391304,0.3630434782608696,0.8173913043478261,0.1826086956521739,772,121,192,459,700,72,0.1567357512953368,0.24870466321243523,0.594559585492228,0.9067357512953368,0.09326424870466321
2153,1284,998,286,1075,209,0.7772585669781932,0.22274143302180685,0.8372274143302181,0.16277258566978192,1170,102,232,836,892,278,0.08717948717948718,0.19829059829059828,0.7145299145299145,0.7623931623931623,0.2376068376068376
2154,623,447,176,523,100,0.7174959871589085,0.2825040128410915,0.8394863563402889,0.16051364365971107,1182,250,371,561,957,225,0.21150592216582065,0.31387478849407785,0.4746192893401015,0.8096446700507615,0.19035532994923857
2155,496,320,176,414,82,0.6451612903225806,0.3548387096774194,0.8346774193548387,0.16532258064516128,838,120,234,484,764,74,0.1431980906921241,0.27923627684964203,0.5775656324582339,0.9116945107398569,0.0883054892601432
2156,339,211,128,297,42,0.6224188790560472,0.3775811209439528,0.8761061946902655,0.12389380530973451,904,140,247,517,780,124,0.15486725663716813,0.27323008849557523,0.5719026548672567,0.8628318584070797,0.13716814159292035
2157,728,522,206,589,139,0.717032967032967,0.28296703296703296,0.8090659340659341,0.19093406593406592,835,109,335,391,766,69,0.13053892215568863,0.40119760479041916,0.4682634730538922,0.9173652694610779,0.08263473053892216
2158,1293,1001,292,1082,211,0.774168600154679,0.22583139984532097,0.8368136117556071,0.16318638824439288,1168,102,229,837,890,278,0.08732876712328767,0.19606164383561644,0.7166095890410958,0.761986301369863,0.238013698630137
2159,487,306,181,401,86,0.6283367556468172,0.37166324435318276,0.8234086242299795,0.17659137577002054,855,103,214,538,781,74,0.12046783625730995,0.25029239766081873,0.6292397660818714,0.9134502923976608,0.08654970760233918
2160,869,653,216,771,98,0.7514384349827388,0.24856156501726123,0.8872266973532796,0.11277330264672036,961,137,236,588,760,201,0.1425598335067638,0.24557752341311134,0.6118626430801248,0.7908428720083247,0.20915712799167535
2161,1324,1055,269,1095,229,0.7968277945619335,0.20317220543806647,0.8270392749244713,0.1729607250755287,1139,241,390,508,1015,124,0.2115891132572432,0.3424056189640035,0.44600526777875327,0.8911325724319579,0.10886742756804214
2162,1507,1260,247,1292,215,0.836098208360982,0.1639017916390179,0.8573324485733245,0.1426675514266755,1160,166,315,679,934,226,0.14310344827586208,0.27155172413793105,0.5853448275862069,0.8051724137931034,0.19482758620689655
2163,372,230,142,290,82,0.6182795698924731,0.3817204301075269,0.7795698924731183,0.22043010752688172,534,181,179,174,526,8,0.3389513108614232,0.3352059925093633,0.3258426966292135,0.9850187265917603,0.0149812734082397
2164,1289,998,291,1080,209,0.7742435996896819,0.22575640031031807,0.8378588052754073,0.1621411947245927,1171,102,231,838,893,278,0.08710503842869342,0.19726729291204098,0.7156276686592656,0.762596071733561,0.23740392826643894
2165,393,246,147,344,49,0.6259541984732825,0.37404580152671757,0.8753180661577609,0.12468193384223919,742,191,243,308,689,53,0.2574123989218329,0.3274932614555256,0.41509433962264153,0.9285714285714286,0.07142857142857142
2166,1247,1031,216,1090,157,0.8267842822774659,0.17321571772253408,0.8740978348035284,0.12590216519647154,1054,149,270,635,832,222,0.1413662239089184,0.25616698292220114,0.6024667931688804,0.7893738140417458,0.21062618595825428
2167,454,344,110,402,52,0.7577092511013216,0.2422907488986784,0.8854625550660793,0.1145374449339207,432,49,181,202,403,29,0.11342592592592593,0.41898148148148145,0.4675925925925926,0.9328703703703703,0.06712962962962964
2168,3757,3299,458,3140,617,0.8780942241149854,0.12190577588501464,0.835773223316476,0.1642267766835241,1884,164,374,1346,1413,471,0.0870488322717622,0.19851380042462846,0.7144373673036093,0.75,0.25
2169,780,555,225,633,147,0.7115384615384616,0.28846153846153844,0.8115384615384615,0.18846153846153846,1198,258,391,549,1068,130,0.21535893155258765,0.32637729549248745,0.4582637729549249,0.8914858096828047,0.10851419031719532
2170,1284,998,286,1075,209,0.7772585669781932,0.22274143302180685,0.8372274143302181,0.16277258566978192,1170,102,232,836,892,278,0.08717948717948718,0.19829059829059828,0.7145299145299145,0.7623931623931623,0.2376068376068376
2171,659,468,191,527,132,0.7101669195751138,0.2898330804248862,0.7996965098634294,0.20030349013657056,803,111,317,375,733,70,0.1382316313823163,0.39476961394769616,0.4669987546699875,0.912826899128269,0.08717310087173101
2172,831,570,261,655,176,0.6859205776173285,0.3140794223826715,0.7882069795427196,0.21179302045728038,960,138,315,507,828,132,0.14375,0.328125,0.528125,0.8625,0.1375
2173,605,392,213,474,131,0.6479338842975206,0.35206611570247937,0.7834710743801653,0.21652892561983472,813,133,245,435,739,74,0.16359163591635917,0.3013530135301353,0.5350553505535055,0.9089790897908979,0.0910209102091021
2174,461,284,177,378,83,0.6160520607375272,0.3839479392624729,0.8199566160520607,0.18004338394793926,811,105,221,485,738,73,0.12946979038224415,0.2725030826140567,0.5980271270036991,0.9099876695437731,0.09001233045622688
2175,1255,1031,224,1098,157,0.8215139442231075,0.17848605577689244,0.8749003984063745,0.1250996015936255,1088,149,312,627,867,221,0.13694852941176472,0.2867647058823529,0.5762867647058824,0.796875,0.203125
2176,399,215,184,303,96,0.5388471177944862,0.46115288220551376,0.7593984962406015,0.24060150375939848,614,100,163,351,548,66,0.16286644951140064,0.26547231270358307,0.5716612377850163,0.8925081433224755,0.10749185667752444
2177,559,387,172,468,91,0.6923076923076923,0.3076923076923077,0.8372093023255814,0.16279069767441862,1226,328,342,556,1094,132,0.26753670473083196,0.27895595432300163,0.4535073409461664,0.8923327895595432,0.10766721044045677
2178,469,281,188,386,83,0.5991471215351812,0.40085287846481876,0.8230277185501066,0.17697228144989338,837,102,228,507,763,74,0.12186379928315412,0.2724014336917563,0.6057347670250897,0.9115890083632019,0.0884109916367981
2179,160,96,64,64,96,0.6,0.4,0.4,0.6,53,0,33,20,52,1,0.0,0.6226415094339622,0.37735849056603776,0.9811320754716981,0.018867924528301886
2180,1290,998,292,1081,209,0.7736434108527132,0.22635658914728682,0.837984496124031,0.162015503875969,1179,102,236,841,901,278,0.08651399491094147,0.2001696352841391,0.7133163698049194,0.7642069550466497,0.2357930449533503
2181,1257,1031,226,1100,157,0.8202068416865553,0.17979315831344472,0.8750994431185362,0.1249005568814638,1083,149,301,633,862,221,0.13758079409048937,0.27793167128347185,0.5844875346260388,0.7959372114496768,0.20406278855032317
2182,1506,1258,248,1291,215,0.8353253652058433,0.1646746347941567,0.8572377158034529,0.14276228419654716,1186,181,320,685,961,225,0.15261382799325462,0.26981450252951095,0.5775716694772344,0.8102866779089376,0.1897133220910624
2183,383,198,185,291,92,0.5169712793733682,0.4830287206266319,0.7597911227154047,0.2402088772845953,627,112,168,347,559,68,0.17862838915470494,0.2679425837320574,0.5534290271132376,0.8915470494417863,0.10845295055821372
2184,973,731,242,799,174,0.7512846865364851,0.24871531346351491,0.8211716341212744,0.17882836587872558,1091,146,323,622,849,242,0.13382218148487626,0.29605866177818513,0.5701191567369386,0.7781851512373968,0.22181484876260313
2185,393,205,188,296,97,0.5216284987277354,0.47837150127226463,0.7531806615776081,0.24681933842239187,626,111,157,358,558,68,0.17731629392971246,0.2507987220447284,0.5718849840255591,0.8913738019169329,0.10862619808306709
2186,473,312,161,408,65,0.6596194503171248,0.3403805496828753,0.8625792811839323,0.13742071881606766,401,39,99,263,394,7,0.09725685785536159,0.24688279301745636,0.655860349127182,0.9825436408977556,0.017456359102244388
2187,395,257,138,349,46,0.6506329113924051,0.3493670886075949,0.8835443037974684,0.11645569620253164,731,143,248,340,615,116,0.19562243502051985,0.3392612859097127,0.46511627906976744,0.841313269493844,0.15868673050615595
2188,476,294,182,393,83,0.6176470588235294,0.38235294117647056,0.8256302521008403,0.17436974789915966,820,96,200,524,745,75,0.11707317073170732,0.24390243902439024,0.6390243902439025,0.9085365853658537,0.09146341463414634
2189,358,232,126,292,66,0.6480446927374302,0.35195530726256985,0.8156424581005587,0.18435754189944134,569,166,176,227,559,10,0.29173989455184535,0.3093145869947276,0.3989455184534271,0.9824253075571178,0.01757469244288225
2190,710,514,196,577,133,0.723943661971831,0.27605633802816903,0.8126760563380282,0.18732394366197183,819,113,331,375,751,68,0.13797313797313798,0.40415140415140416,0.45787545787545786,0.9169719169719169,0.08302808302808302
2191,342,224,118,288,54,0.6549707602339181,0.34502923976608185,0.8421052631578947,0.15789473684210525,495,162,163,170,486,9,0.32727272727272727,0.3292929292929293,0.3434343434343434,0.9818181818181818,0.01818181818181818
2192,1260,1032,228,1103,157,0.819047619047619,0.18095238095238095,0.8753968253968254,0.1246031746031746,1086,149,306,631,864,222,0.13720073664825047,0.281767955801105,0.5810313075506446,0.7955801104972375,0.20441988950276244
2193,406,226,180,316,90,0.5566502463054187,0.4433497536945813,0.7783251231527094,0.22167487684729065,590,104,154,332,522,68,0.17627118644067796,0.26101694915254237,0.5627118644067797,0.8847457627118644,0.1152542372881356
2194,332,200,132,290,42,0.6024096385542169,0.39759036144578314,0.8734939759036144,0.12650602409638553,624,129,202,293,570,54,0.20673076923076922,0.32371794871794873,0.46955128205128205,0.9134615384615384,0.08653846153846154
2195,319,188,131,279,40,0.5893416927899686,0.4106583072100313,0.8746081504702194,0.12539184952978055,741,117,200,424,685,56,0.15789473684210525,0.2699055330634278,0.5721997300944669,0.9244264507422402,0.07557354925775979
2196,459,297,162,330,129,0.6470588235294118,0.35294117647058826,0.7189542483660131,0.28104575163398693,586,186,222,178,579,7,0.3174061433447099,0.378839590443686,0.3037542662116041,0.9880546075085325,0.011945392491467578
2197,355,232,123,311,44,0.6535211267605634,0.3464788732394366,0.8760563380281691,0.12394366197183099,891,160,242,489,758,133,0.17957351290684623,0.2716049382716049,0.5488215488215489,0.8507295173961841,0.14927048260381592
2198,1130,853,277,911,219,0.7548672566371681,0.24513274336283186,0.8061946902654867,0.19380530973451326,1232,199,395,638,1007,225,0.16152597402597402,0.32061688311688313,0.5178571428571429,0.8173701298701299,0.18262987012987014
2199,1508,1258,250,1292,216,0.8342175066312998,0.16578249336870027,0.8567639257294429,0.14323607427055704,1199,175,328,696,974,225,0.14595496246872394,0.2735613010842369,0.5804837364470392,0.8123436196830692,0.18765638031693077
2200,589,392,197,484,105,0.66553480475382,0.33446519524617996,0.8217317487266553,0.17826825127334464,1070,258,292,520,1006,64,0.2411214953271028,0.27289719626168224,0.48598130841121495,0.9401869158878504,0.059813084112149535
2201,340,216,124,296,44,0.6352941176470588,0.36470588235294116,0.8705882352941177,0.12941176470588237,815,128,238,449,692,123,0.1570552147239264,0.2920245398773006,0.550920245398773,0.849079754601227,0.150920245398773
2202,587,395,192,481,106,0.6729131175468483,0.3270868824531516,0.8194207836456558,0.18057921635434412,1121,218,297,606,985,136,0.19446922390722568,0.2649420160570919,0.5405887600356825,0.8786797502230151,0.12132024977698483
2203,357,225,132,312,45,0.6302521008403361,0.3697478991596639,0.8739495798319328,0.12605042016806722,834,116,232,486,713,121,0.13908872901678657,0.27817745803357313,0.5827338129496403,0.854916067146283,0.145083932853717
2204,300,180,120,261,39,0.6,0.4,0.87,0.13,569,127,182,260,516,53,0.22319859402460457,0.31985940246045697,0.45694200351493847,0.9068541300527241,0.09314586994727592
2205,724,513,211,579,145,0.7085635359116023,0.2914364640883978,0.7997237569060773,0.20027624309392264,845,119,327,399,776,69,0.1408284023668639,0.38698224852071006,0.47218934911242605,0.9183431952662722,0.08165680473372781
2206,397,220,177,308,89,0.5541561712846348,0.44584382871536526,0.7758186397984886,0.22418136020151133,629,113,165,351,561,68,0.17965023847376788,0.26232114467408585,0.5580286168521462,0.8918918918918919,0.10810810810810811
2207,477,296,181,397,80,0.6205450733752621,0.37945492662473795,0.8322851153039832,0.16771488469601678,835,95,225,515,762,73,0.11377245508982035,0.2694610778443114,0.6167664670658682,0.9125748502994012,0.08742514970059881
2208,783,561,222,651,132,0.7164750957854407,0.2835249042145594,0.8314176245210728,0.1685823754789272,1282,247,393,642,1058,224,0.19266770670826833,0.30655226209048364,0.500780031201248,0.8252730109204368,0.1747269890795632
2209,376,197,179,289,87,0.523936170212766,0.47606382978723405,0.7686170212765957,0.23138297872340424,617,107,162,348,550,67,0.17341977309562398,0.2625607779578606,0.5640194489465153,0.8914100486223663,0.1085899513776337
2210,634,442,192,504,130,0.6971608832807571,0.3028391167192429,0.7949526813880127,0.20504731861198738,746,99,283,364,679,67,0.13270777479892762,0.37935656836461124,0.4879356568364611,0.9101876675603218,0.08981233243967829
2211,830,574,256,667,163,0.691566265060241,0.30843373493975906,0.8036144578313253,0.1963855421686747,1076,103,205,768,849,227,0.09572490706319703,0.19052044609665428,0.7137546468401487,0.7890334572490706,0.21096654275092938
2212,317,190,127,276,41,0.5993690851735016,0.40063091482649843,0.8706624605678234,0.12933753943217666,620,145,214,261,568,52,0.23387096774193547,0.34516129032258064,0.42096774193548386,0.9161290322580645,0.08387096774193549
2213,333,149,184,275,58,0.44744744744744747,0.5525525525525525,0.8258258258258259,0.17417417417417416,763,92,187,484,692,71,0.12057667103538663,0.24508519003931847,0.6343381389252949,0.9069462647444299,0.09305373525557012
2214,354,215,139,309,45,0.6073446327683616,0.3926553672316384,0.8728813559322034,0.1271186440677966,738,122,248,368,619,119,0.16531165311653118,0.33604336043360433,0.4986449864498645,0.8387533875338753,0.16124661246612465
2215,457,281,176,376,81,0.6148796498905909,0.3851203501094092,0.8227571115973742,0.1772428884026258,789,108,205,476,717,72,0.13688212927756654,0.2598225602027883,0.6032953105196451,0.908745247148289,0.09125475285171103
2216,867,602,265,702,165,0.6943483275663207,0.30565167243367936,0.8096885813148789,0.1903114186851211,1155,155,353,647,922,233,0.1341991341991342,0.30562770562770564,0.5601731601731602,0.7982683982683982,0.20173160173160173
2217,640,427,213,508,132,0.6671875,0.3328125,0.79375,0.20625,1050,246,275,529,983,67,0.2342857142857143,0.2619047619047619,0.5038095238095238,0.9361904761904762,0.06380952380952382
2218,146,85,61,51,95,0.5821917808219178,0.4178082191780822,0.3493150684931507,0.6506849315068494,28,0,3,25,27,1,0.0,0.10714285714285714,0.8928571428571429,0.9642857142857143,0.03571428571428571
2219,1235,880,355,977,258,0.7125506072874493,0.2874493927125506,0.7910931174089069,0.2089068825910931,1218,102,246,870,940,278,0.08374384236453201,0.2019704433497537,0.7142857142857143,0.7717569786535303,0.22824302134646962
2220,613,389,224,479,134,0.634584013050571,0.36541598694942906,0.7814029363784666,0.21859706362153344,743,106,229,408,670,73,0.1426648721399731,0.3082099596231494,0.5491251682368775,0.901749663526245,0.09825033647375504
2221,390,261,129,342,48,0.6692307692307692,0.33076923076923076,0.8769230769230769,0.12307692307692308,927,175,260,492,804,123,0.18878101402373246,0.28047464940668826,0.5307443365695793,0.8673139158576052,0.13268608414239483
2222,1252,1039,213,1096,156,0.8298722044728435,0.17012779552715654,0.8753993610223643,0.12460063897763578,1059,155,271,633,838,221,0.14636449480642116,0.2559017941454202,0.5977337110481586,0.7913125590179415,0.20868744098205855
2223,1234,880,354,976,258,0.713128038897893,0.28687196110210694,0.7909238249594813,0.20907617504051865,1222,102,249,871,944,278,0.08346972176759411,0.2037643207855974,0.7127659574468085,0.7725040916530278,0.22749590834697217
2224,3067,2629,438,2584,483,0.857189435930877,0.14281056406912293,0.8425171177045974,0.15748288229540267,1559,228,427,904,1332,227,0.14624759461193074,0.2738935214881334,0.5798588838999359,0.8543938422065427,0.14560615779345734
2225,3310,2882,428,2850,460,0.8706948640483384,0.12930513595166163,0.8610271903323263,0.13897280966767372,1855,218,517,1120,1436,419,0.11752021563342319,0.27870619946091646,0.6037735849056604,0.7741239892183288,0.22587601078167116
2226,343,211,132,295,48,0.6151603498542274,0.3848396501457726,0.8600583090379009,0.13994169096209913,801,169,225,407,744,57,0.21098626716604243,0.2808988764044944,0.5081148564294632,0.9288389513108615,0.07116104868913857
2227,1794,1479,315,1498,296,0.8244147157190636,0.17558528428093645,0.835005574136009,0.16499442586399107,1418,269,467,682,1171,247,0.18970380818053598,0.32933709449929477,0.4809590973201692,0.8258110014104373,0.17418899858956277
2228,380,245,135,307,73,0.6447368421052632,0.35526315789473684,0.8078947368421052,0.19210526315789472,513,179,177,157,505,8,0.3489278752436647,0.34502923976608185,0.3060428849902534,0.9844054580896686,0.015594541910331383
2229,370,188,182,281,89,0.5081081081081081,0.4918918918918919,0.7594594594594595,0.24054054054054055,610,97,158,355,541,69,0.15901639344262294,0.25901639344262295,0.5819672131147541,0.8868852459016393,0.11311475409836065
2230,888,660,228,734,154,0.7432432432432432,0.25675675675675674,0.8265765765765766,0.17342342342342343,1247,277,427,543,1118,129,0.22213311948676825,0.34242181234963914,0.43544506816359263,0.896551724137931,0.10344827586206896
2231,171,111,60,78,93,0.6491228070175439,0.3508771929824561,0.45614035087719296,0.543859649122807,103,0,79,24,102,1,0.0,0.7669902912621359,0.23300970873786409,0.9902912621359223,0.009708737864077669
2232,587,402,185,481,106,0.6848381601362862,0.3151618398637138,0.8194207836456558,0.18057921635434412,1286,238,301,747,1061,225,0.18506998444790046,0.23405909797822705,0.5808709175738724,0.8250388802488335,0.1749611197511664
2233,456,288,168,373,83,0.631578947368421,0.3684210526315789,0.8179824561403509,0.18201754385964913,799,115,197,487,724,75,0.1439299123904881,0.246558197747184,0.609511889862328,0.9061326658322904,0.09386733416770963
2234,1165,878,287,910,255,0.7536480686695279,0.2463519313304721,0.7811158798283262,0.21888412017167383,1164,102,233,829,886,278,0.08762886597938144,0.20017182130584193,0.7121993127147767,0.761168384879725,0.23883161512027493
2235,1501,1254,247,1285,216,0.8354430379746836,0.16455696202531644,0.8560959360426382,0.14390406395736177,1190,176,323,691,965,225,0.14789915966386555,0.2714285714285714,0.5806722689075631,0.8109243697478992,0.18907563025210083
2236,5092,4453,639,4310,782,0.874509033778476,0.12549096622152395,0.8464257659073056,0.1535742340926944,2214,258,587,1369,1738,476,0.11653116531165311,0.26513098464317975,0.6183378500451672,0.7850045167118338,0.21499548328816623
2237,466,280,186,383,83,0.6008583690987125,0.39914163090128757,0.8218884120171673,0.1781115879828326,829,103,225,501,755,74,0.12424607961399277,0.27141133896260555,0.6043425814234017,0.9107358262967431,0.08926417370325694
2238,835,575,260,672,163,0.688622754491018,0.31137724550898205,0.8047904191616766,0.19520958083832335,1084,103,209,772,857,227,0.09501845018450185,0.19280442804428044,0.7121771217712177,0.790590405904059,0.20940959409594095
2239,489,310,179,403,86,0.6339468302658486,0.3660531697341513,0.8241308793456033,0.17586912065439672,953,116,211,626,783,170,0.12172088142707241,0.22140608604407136,0.6568730325288562,0.8216159496327388,0.1783840503672613
2240,313,181,132,273,40,0.5782747603833865,0.4217252396166134,0.8722044728434505,0.12779552715654952,757,124,207,426,699,58,0.16380449141347425,0.27344782034346105,0.5627476882430648,0.9233817701453104,0.07661822985468957
2241,1928,1588,340,1621,307,0.8236514522821576,0.17634854771784234,0.8407676348547718,0.1592323651452282,1254,226,420,608,1100,154,0.18022328548644337,0.3349282296650718,0.48484848484848486,0.8771929824561403,0.12280701754385964
2242,1240,969,271,1030,210,0.7814516129032258,0.21854838709677418,0.8306451612903226,0.1693548387096774,1347,307,466,574,1199,148,0.22791388270230142,0.3459539717891611,0.4261321455085375,0.8901262063845583,0.10987379361544172
2243,554,372,182,448,106,0.6714801444043321,0.3285198555956679,0.8086642599277978,0.19133574007220217,991,222,246,523,925,66,0.22401614530776992,0.248234106962664,0.5277497477295661,0.9334006054490414,0.06659939455095863
2244,1162,880,282,904,258,0.7573149741824441,0.24268502581755594,0.7779690189328744,0.22203098106712565,1156,102,230,824,878,278,0.08823529411764706,0.19896193771626297,0.71280276816609,0.759515570934256,0.24048442906574394
2245,401,221,180,325,76,0.5511221945137157,0.4488778054862843,0.8104738154613467,0.18952618453865336,601,89,149,363,533,68,0.1480865224625624,0.24792013311148087,0.6039933444259568,0.8868552412645591,0.11314475873544093
2246,342,216,126,298,44,0.631578947368421,0.3684210526315789,0.8713450292397661,0.1286549707602339,759,176,254,329,642,117,0.2318840579710145,0.3346508563899868,0.43346508563899866,0.8458498023715415,0.1541501976284585
2247,1295,998,297,1086,209,0.7706563706563706,0.22934362934362934,0.8386100386100386,0.1613899613899614,1174,102,229,843,896,278,0.0868824531516184,0.1950596252129472,0.7180579216354344,0.7632027257240205,0.23679727427597955
2248,496,325,171,422,74,0.655241935483871,0.34475806451612906,0.8508064516129032,0.14919354838709678,472,34,114,324,465,7,0.07203389830508475,0.24152542372881355,0.6864406779661016,0.9851694915254238,0.014830508474576272
2249,1287,998,289,1078,209,0.7754467754467754,0.22455322455322455,0.8376068376068376,0.1623931623931624,1172,102,231,839,894,278,0.08703071672354949,0.197098976109215,0.7158703071672355,0.7627986348122867,0.23720136518771331
2250,839,575,264,676,163,0.6853396901072706,0.3146603098927294,0.8057210965435042,0.19427890345649582,1080,103,205,772,853,227,0.09537037037037037,0.18981481481481483,0.7148148148148148,0.7898148148148149,0.2101851851851852
2251,555,338,217,436,119,0.609009009009009,0.390990990990991,0.7855855855855856,0.21441441441441442,753,102,242,409,680,73,0.13545816733067728,0.32138114209827356,0.5431606905710491,0.9030544488711819,0.09694555112881806
2252,1284,998,286,1075,209,0.7772585669781932,0.22274143302180685,0.8372274143302181,0.16277258566978192,1170,102,232,836,892,278,0.08717948717948718,0.19829059829059828,0.7145299145299145,0.7623931623931623,0.2376068376068376
2253,465,283,182,384,81,0.6086021505376344,0.3913978494623656,0.8258064516129032,0.17419354838709677,800,104,217,479,727,73,0.13,0.27125,0.59875,0.90875,0.09125
2254,1521,1272,249,1306,215,0.8362919132149902,0.16370808678500987,0.8586456278763971,0.14135437212360288,1204,181,329,694,979,225,0.15033222591362128,0.27325581395348836,0.5764119601328903,0.8131229235880398,0.18687707641196014
2255,1295,998,297,1086,209,0.7706563706563706,0.22934362934362934,0.8386100386100386,0.1613899613899614,1182,102,235,845,904,278,0.08629441624365482,0.1988155668358714,0.7148900169204738,0.7648054145516074,0.23519458544839256
2256,747,532,215,614,133,0.7121820615796519,0.2878179384203481,0.821954484605087,0.17804551539491298,1182,199,372,611,958,224,0.16835871404399322,0.3147208121827411,0.5169204737732657,0.8104906937394247,0.1895093062605753
2257,1006,711,295,794,212,0.7067594433399602,0.2932405566600398,0.7892644135188867,0.21073558648111332,1297,275,418,604,1151,146,0.21202775636083268,0.32228218966846567,0.4656900539707016,0.887432536622976,0.1125674633770239
2258,1243,1030,213,1086,157,0.82864038616251,0.17135961383748993,0.8736926790024135,0.1263073209975865,1059,149,280,630,838,221,0.14069877242681775,0.26440037771482533,0.5949008498583569,0.7913125590179415,0.20868744098205855
2259,1506,1258,248,1289,217,0.8353253652058433,0.1646746347941567,0.8559096945551129,0.14409030544488713,1148,160,316,672,924,224,0.13937282229965156,0.27526132404181186,0.5853658536585366,0.8048780487804879,0.1951219512195122
2260,407,244,163,341,66,0.5995085995085995,0.4004914004914005,0.8378378378378378,0.16216216216216217,847,174,181,492,785,62,0.20543093270365997,0.21369539551357733,0.5808736717827627,0.9268004722550177,0.07319952774498228
2261,575,361,214,455,120,0.6278260869565218,0.37217391304347824,0.7913043478260869,0.20869565217391303,789,122,244,423,717,72,0.15462610899873258,0.30925221799746516,0.5361216730038023,0.908745247148289,0.09125475285171103
2262,542,341,201,425,117,0.6291512915129152,0.37084870848708484,0.7841328413284133,0.2158671586715867,752,123,219,410,678,74,0.16356382978723405,0.2912234042553192,0.5452127659574468,0.901595744680851,0.09840425531914894
2263,474,291,183,391,83,0.6139240506329114,0.3860759493670886,0.8248945147679325,0.1751054852320675,840,106,223,511,768,72,0.1261904761904762,0.2654761904761905,0.6083333333333333,0.9142857142857143,0.08571428571428572
2264,631,439,192,521,110,0.6957210776545166,0.30427892234548337,0.8256735340729001,0.17432646592709986,1182,214,267,701,1015,167,0.18104906937394247,0.22588832487309646,0.5930626057529611,0.8587140439932318,0.1412859560067682
2265,714,510,204,586,128,0.7142857142857143,0.2857142857142857,0.8207282913165266,0.1792717086834734,1090,206,376,508,961,129,0.1889908256880734,0.344954128440367,0.46605504587155966,0.881651376146789,0.11834862385321102
2266,439,319,120,378,61,0.7266514806378133,0.2733485193621868,0.8610478359908884,0.13895216400911162,773,190,185,398,667,106,0.24579560155239327,0.23932729624838292,0.5148771021992238,0.8628719275549805,0.1371280724450194
2267,22637,18389,4248,19121,3516,0.8123426249061272,0.18765737509387287,0.8446790652471617,0.15532093475283829,7347,183,871,6293,3594,3753,0.02490812576561862,0.11855178984619573,0.8565400843881856,0.48917925683952634,0.5108207431604737
2268,389,210,179,298,91,0.5398457583547558,0.4601542416452442,0.7660668380462725,0.23393316195372751,599,104,153,342,532,67,0.17362270450751252,0.25542570951585974,0.5709515859766278,0.8881469115191987,0.11185308848080133
2269,1169,880,289,911,258,0.7527801539777588,0.24721984602224123,0.7792985457656116,0.22070145423438836,1167,102,234,831,889,278,0.08740359897172237,0.20051413881748073,0.712082262210797,0.7617823479005998,0.23821765209940018
2270,579,347,232,450,129,0.5993091537132987,0.4006908462867012,0.7772020725388601,0.22279792746113988,744,99,238,407,672,72,0.13306451612903225,0.31989247311827956,0.5470430107526881,0.9032258064516129,0.0967741935483871
2271,4501,3950,551,3828,673,0.877582759386803,0.12241724061319707,0.8504776716285269,0.149522328371473,1997,216,518,1263,1605,392,0.10816224336504757,0.25938908362543817,0.6324486730095142,0.8037055583375062,0.19629444166249374
2272,1259,1031,228,1102,157,0.8189038919777601,0.18109610802223988,0.8752978554408261,0.12470214455917394,1068,149,289,630,847,221,0.13951310861423222,0.2705992509363296,0.5898876404494382,0.7930711610486891,0.20692883895131087
2273,543,355,188,454,89,0.6537753222836096,0.3462246777163904,0.8360957642725598,0.16390423572744015,979,104,226,649,810,169,0.1062308478038815,0.23084780388151174,0.6629213483146067,0.8273748723186926,0.17262512768130744
2274,804,558,246,656,148,0.6940298507462687,0.30597014925373134,0.8159203980099502,0.18407960199004975,1080,99,214,767,853,227,0.09166666666666666,0.19814814814814816,0.7101851851851851,0.7898148148148149,0.2101851851851852
2275,1272,1036,236,1111,161,0.8144654088050315,0.18553459119496854,0.8734276729559748,0.12657232704402516,1070,149,278,643,848,222,0.13925233644859814,0.25981308411214954,0.6009345794392523,0.7925233644859813,0.20747663551401868
2276,842,633,209,751,91,0.7517814726840855,0.24821852731591448,0.8919239904988123,0.10807600950118765,966,142,234,590,764,202,0.14699792960662525,0.2422360248447205,0.6107660455486542,0.7908902691511387,0.20910973084886128
2277,459,288,171,378,81,0.6274509803921569,0.37254901960784315,0.8235294117647058,0.17647058823529413,824,109,216,499,753,71,0.13228155339805825,0.2621359223300971,0.6055825242718447,0.9138349514563107,0.08616504854368932
2278,443,325,118,372,71,0.7336343115124153,0.26636568848758463,0.8397291196388262,0.16027088036117382,1423,190,256,977,1161,262,0.13352073085031624,0.17990161630358398,0.6865776528460998,0.8158819395643008,0.18411806043569923
2279,602,402,200,465,137,0.6677740863787376,0.33222591362126247,0.7724252491694352,0.22757475083056478,687,110,189,388,617,70,0.16011644832605532,0.27510917030567683,0.5647743813682679,0.8981077147016011,0.10189228529839883
2280,640,409,231,488,152,0.6390625,0.3609375,0.7625,0.2375,1023,143,246,634,799,224,0.13978494623655913,0.2404692082111437,0.6197458455522972,0.7810361681329423,0.21896383186705767
2281,381,249,132,310,71,0.6535433070866141,0.3464566929133858,0.8136482939632546,0.18635170603674542,517,153,189,175,508,9,0.29593810444874274,0.3655705996131528,0.33849129593810445,0.9825918762088974,0.017408123791102514
2282,341,217,124,293,48,0.6363636363636364,0.36363636363636365,0.8592375366568915,0.14076246334310852,728,122,183,423,670,58,0.16758241758241757,0.25137362637362637,0.5810439560439561,0.9203296703296703,0.07967032967032966
2283,875,622,253,713,162,0.7108571428571429,0.28914285714285715,0.8148571428571428,0.18514285714285714,1104,186,364,554,960,144,0.16847826086956522,0.32971014492753625,0.5018115942028986,0.8695652173913043,0.13043478260869565
2284,3434,2935,499,2879,555,0.8546884100174723,0.14531158998252766,0.8383808969132207,0.16161910308677926,1575,236,464,875,1365,210,0.14984126984126983,0.2946031746031746,0.5555555555555556,0.8666666666666667,0.13333333333333333
2285,555,365,190,452,103,0.6576576576576577,0.34234234234234234,0.8144144144144144,0.18558558558558558,1034,268,304,462,971,63,0.25918762088974856,0.2940038684719536,0.44680851063829785,0.9390715667311412,0.0609284332688588
2286,804,595,209,667,137,0.7400497512437811,0.2599502487562189,0.8296019900497512,0.17039800995024876,1090,199,368,523,958,132,0.18256880733944955,0.3376146788990826,0.4798165137614679,0.8788990825688073,0.12110091743119267
2287,1504,1257,247,1287,217,0.8357712765957447,0.16422872340425532,0.855718085106383,0.14428191489361702,1161,166,316,679,936,225,0.1429801894918174,0.2721791559000861,0.5848406546080964,0.8062015503875969,0.1937984496124031
2288,593,408,185,492,101,0.688026981450253,0.31197301854974707,0.8296795952782462,0.1703204047217538,1149,256,305,588,1018,131,0.2228024369016536,0.2654482158398607,0.5117493472584856,0.8859878154917319,0.11401218450826806
2289,399,250,149,331,68,0.6265664160401002,0.37343358395989973,0.8295739348370927,0.17042606516290726,573,134,184,255,520,53,0.2338568935427574,0.32111692844677137,0.44502617801047123,0.9075043630017452,0.0924956369982548
2290,452,303,149,330,122,0.6703539823008849,0.32964601769911506,0.7300884955752213,0.26991150442477874,323,51,107,165,316,7,0.15789473684210525,0.33126934984520123,0.5108359133126935,0.978328173374613,0.021671826625386997
2291,835,575,260,672,163,0.688622754491018,0.31137724550898205,0.8047904191616766,0.19520958083832335,1082,103,209,770,855,227,0.09519408502772643,0.19316081330868762,0.711645101663586,0.7902033271719039,0.2097966728280961
2292,339,208,131,291,48,0.6135693215339233,0.3864306784660767,0.8584070796460177,0.1415929203539823,598,147,195,256,546,52,0.24581939799331104,0.32608695652173914,0.4280936454849498,0.9130434782608695,0.08695652173913043
2293,315,188,127,274,41,0.5968253968253968,0.4031746031746032,0.8698412698412699,0.13015873015873017,732,136,206,390,677,55,0.18579234972677597,0.2814207650273224,0.5327868852459017,0.924863387978142,0.07513661202185792
2294,158,45,113,150,8,0.2848101265822785,0.7151898734177216,0.9493670886075949,0.05063291139240506,533,127,160,246,481,52,0.23827392120075047,0.300187617260788,0.46153846153846156,0.9024390243902439,0.0975609756097561
2295,2173,1854,319,1776,397,0.8531983433041878,0.14680165669581224,0.8173032673722964,0.18269673262770364,1336,239,433,664,1144,192,0.17889221556886228,0.3241017964071856,0.49700598802395207,0.8562874251497006,0.1437125748502994
2296,1241,1032,209,1084,157,0.8315874294923449,0.16841257050765512,0.8734891216760677,0.12651087832393232,1050,149,263,638,828,222,0.1419047619047619,0.25047619047619046,0.6076190476190476,0.7885714285714286,0.21142857142857144
2297,366,232,134,298,68,0.6338797814207651,0.366120218579235,0.8142076502732241,0.18579234972677597,605,182,181,242,596,9,0.30082644628099175,0.2991735537190083,0.4,0.9851239669421488,0.01487603305785124
2298,356,233,123,291,65,0.6544943820224719,0.3455056179775281,0.8174157303370787,0.18258426966292135,602,165,163,274,592,10,0.27408637873754155,0.2707641196013289,0.45514950166112955,0.9833887043189369,0.016611295681063124
2299,1308,1014,294,1097,211,0.7752293577981652,0.22477064220183487,0.8386850152905199,0.16131498470948014,1087,103,234,750,863,224,0.09475620975160993,0.21527138914443422,0.6899724011039559,0.7939282428702852,0.20607175712971482
2300,1292,998,294,1083,209,0.7724458204334366,0.22755417956656346,0.8382352941176471,0.16176470588235295,1180,102,236,842,902,278,0.08644067796610169,0.2,0.7135593220338983,0.764406779661017,0.23559322033898306
2301,1136,878,258,930,206,0.772887323943662,0.22711267605633803,0.8186619718309859,0.1813380281690141,1345,302,418,625,1121,224,0.2245353159851301,0.3107806691449814,0.4646840148698885,0.833457249070632,0.16654275092936802
2302,332,205,127,290,42,0.6174698795180723,0.3825301204819277,0.8734939759036144,0.12650602409638553,782,162,228,392,723,59,0.2071611253196931,0.2915601023017903,0.5012787723785166,0.9245524296675192,0.07544757033248081
2303,149,96,53,62,87,0.6442953020134228,0.35570469798657717,0.4161073825503356,0.5838926174496645,93,0,69,24,92,1,0.0,0.7419354838709677,0.25806451612903225,0.989247311827957,0.010752688172043012
2304,352,222,130,307,45,0.6306818181818182,0.3693181818181818,0.8721590909090909,0.1278409090909091,756,150,247,359,639,117,0.1984126984126984,0.32671957671957674,0.4748677248677249,0.8452380952380952,0.15476190476190477
2305,1243,1030,213,1087,156,0.82864038616251,0.17135961383748993,0.8744971842316975,0.1255028157683025,1062,155,273,634,841,221,0.14595103578154425,0.2570621468926554,0.5969868173258004,0.7919020715630886,0.2080979284369115
2306,1288,998,290,1079,209,0.7748447204968945,0.2251552795031056,0.8377329192546584,0.1622670807453416,1166,102,228,836,888,278,0.08747855917667238,0.1955403087478559,0.7169811320754716,0.7615780445969125,0.23842195540308747
2307,373,240,133,330,43,0.6434316353887399,0.35656836461126007,0.8847184986595175,0.11528150134048257,748,152,255,341,632,116,0.20320855614973263,0.3409090909090909,0.45588235294117646,0.8449197860962567,0.15508021390374332
2308,1295,998,297,1086,209,0.7706563706563706,0.22934362934362934,0.8386100386100386,0.1613899613899614,1194,102,243,849,916,278,0.08542713567839195,0.20351758793969849,0.7110552763819096,0.7671691792294807,0.23283082077051925
2309,579,356,223,460,119,0.614853195164076,0.385146804835924,0.7944732297063903,0.20552677029360966,814,125,246,443,742,72,0.15356265356265356,0.3022113022113022,0.5442260442260443,0.9115479115479116,0.08845208845208845
2310,801,556,245,674,127,0.6941323345817728,0.30586766541822724,0.8414481897627965,0.1585518102372035,1049,102,208,739,824,225,0.09723546234509056,0.1982840800762631,0.7044804575786463,0.7855100095328885,0.21448999046711154
2311,386,208,178,298,88,0.538860103626943,0.46113989637305697,0.772020725388601,0.22797927461139897,602,108,151,343,535,67,0.17940199335548174,0.25083056478405313,0.5697674418604651,0.8887043189368771,0.11129568106312292
2312,573,385,188,452,121,0.6719022687609075,0.32809773123909247,0.7888307155322862,0.2111692844677138,880,175,210,495,815,65,0.19886363636363635,0.23863636363636365,0.5625,0.9261363636363636,0.07386363636363637
2313,892,641,251,723,169,0.718609865470852,0.28139013452914796,0.8105381165919282,0.18946188340807174,1271,260,376,635,1047,224,0.2045633359559402,0.2958300550747443,0.4996066089693155,0.8237608182533438,0.17623918174665618
2314,1285,998,287,1076,209,0.7766536964980545,0.22334630350194554,0.8373540856031129,0.16264591439688716,1169,102,231,836,891,278,0.0872540633019675,0.19760479041916168,0.7151411462788708,0.7621899059024807,0.23781009409751924
2315,561,343,218,443,118,0.6114081996434938,0.38859180035650626,0.7896613190730838,0.2103386809269162,768,116,241,411,694,74,0.15104166666666666,0.3138020833333333,0.53515625,0.9036458333333334,0.09635416666666667
2316,869,653,216,775,94,0.7514384349827388,0.24856156501726123,0.8918296892980437,0.10817031070195628,964,142,235,587,762,202,0.14730290456431536,0.2437759336099585,0.6089211618257261,0.7904564315352697,0.2095435684647303
2317,388,205,183,293,95,0.5283505154639175,0.47164948453608246,0.7551546391752577,0.24484536082474226,618,103,161,354,552,66,0.16666666666666666,0.2605177993527508,0.5728155339805825,0.8932038834951457,0.10679611650485436
2318,393,216,177,319,74,0.549618320610687,0.45038167938931295,0.811704834605598,0.18829516539440203,603,100,155,348,535,68,0.16583747927031509,0.2570480928689884,0.5771144278606966,0.8872305140961857,0.11276948590381426
2319,581,385,196,453,128,0.6626506024096386,0.3373493975903614,0.7796901893287436,0.22030981067125646,677,100,184,393,607,70,0.14771048744460857,0.2717872968980798,0.5805022156573116,0.896602658788774,0.103397341211226
2320,1257,1033,224,1101,156,0.8217979315831344,0.17820206841686556,0.8758949880668258,0.12410501193317422,1095,155,305,635,873,222,0.1415525114155251,0.2785388127853881,0.5799086757990868,0.7972602739726027,0.20273972602739726
2321,945,655,290,743,202,0.6931216931216931,0.30687830687830686,0.7862433862433862,0.21375661375661376,1095,159,357,579,962,133,0.14520547945205478,0.32602739726027397,0.5287671232876713,0.8785388127853881,0.12146118721461187
2322,744,250,494,328,416,0.33602150537634407,0.6639784946236559,0.44086021505376344,0.5591397849462365,565,46,145,374,404,161,0.08141592920353982,0.25663716814159293,0.6619469026548672,0.7150442477876107,0.2849557522123894
2323,383,206,177,291,92,0.5378590078328982,0.4621409921671018,0.7597911227154047,0.2402088772845953,590,101,151,338,522,68,0.1711864406779661,0.2559322033898305,0.5728813559322034,0.8847457627118644,0.1152542372881356
2324,1298,1003,295,1017,281,0.7727272727272727,0.22727272727272727,0.7835130970724191,0.21648690292758088,1163,102,230,831,885,278,0.08770421324161651,0.19776440240756663,0.7145313843508169,0.7609630266552021,0.23903697334479793
2325,526,369,157,439,87,0.7015209125475285,0.2984790874524715,0.8346007604562737,0.16539923954372623,1035,206,223,606,871,164,0.19903381642512077,0.21545893719806763,0.5855072463768116,0.8415458937198068,0.15845410628019324
2326,411,276,135,358,53,0.6715328467153284,0.3284671532846715,0.8710462287104623,0.12895377128953772,828,220,275,333,712,116,0.26570048309178745,0.3321256038647343,0.40217391304347827,0.8599033816425121,0.14009661835748793
2327,570,389,181,466,104,0.6824561403508772,0.3175438596491228,0.8175438596491228,0.1824561403508772,1060,211,237,612,897,163,0.19905660377358492,0.22358490566037736,0.5773584905660377,0.8462264150943396,0.15377358490566037
2328,584,412,172,486,98,0.7054794520547946,0.2945205479452055,0.8321917808219178,0.1678082191780822,1152,258,302,592,1020,132,0.22395833333333334,0.2621527777777778,0.5138888888888888,0.8854166666666666,0.11458333333333333
2329,598,376,222,468,130,0.6287625418060201,0.3712374581939799,0.782608695652174,0.21739130434782608,751,109,228,414,679,72,0.14513981358189082,0.303595206391478,0.5512649800266312,0.9041278295605859,0.09587217043941411
2330,823,623,200,733,90,0.7569866342648846,0.24301336573511542,0.8906439854191981,0.10935601458080195,942,136,224,582,742,200,0.14437367303609341,0.23779193205944799,0.6178343949044586,0.7876857749469215,0.21231422505307856
2331,617,390,227,489,128,0.6320907617504052,0.3679092382495948,0.7925445705024311,0.20745542949756887,773,107,237,429,700,73,0.1384217335058215,0.30659767141009053,0.5549805950840879,0.9055627425614489,0.0944372574385511
2332,338,224,114,285,53,0.6627218934911243,0.33727810650887574,0.8431952662721893,0.15680473372781065,567,137,153,277,554,13,0.24162257495590828,0.2698412698412698,0.48853615520282184,0.9770723104056437,0.02292768959435626
2333,316,188,128,276,40,0.5949367088607594,0.4050632911392405,0.8734177215189873,0.12658227848101267,739,123,186,430,680,59,0.16644113667117727,0.2516914749661705,0.5818673883626523,0.9201623815967523,0.07983761840324763
2334,1292,998,294,1083,209,0.7724458204334366,0.22755417956656346,0.8382352941176471,0.16176470588235295,1171,102,230,839,893,278,0.08710503842869342,0.1964133219470538,0.7164816396242528,0.762596071733561,0.23740392826643894
2335,402,272,130,353,49,0.6766169154228856,0.32338308457711445,0.8781094527363185,0.12189054726368159,706,144,225,337,589,117,0.20396600566572237,0.31869688385269124,0.4773371104815864,0.8342776203966006,0.16572237960339944
2336,1171,879,292,913,258,0.7506404782237404,0.2493595217762596,0.7796754910333049,0.22032450896669514,1162,102,231,829,884,278,0.08777969018932874,0.19879518072289157,0.7134251290877797,0.7607573149741824,0.23924268502581755
2337,556,345,211,437,119,0.6205035971223022,0.37949640287769787,0.7859712230215827,0.21402877697841727,728,112,230,386,658,70,0.15384615384615385,0.3159340659340659,0.5302197802197802,0.9038461538461539,0.09615384615384616
2338,1499,1253,246,1283,216,0.8358905937291528,0.16410940627084722,0.8559039359573049,0.14409606404269512,1203,182,327,694,977,226,0.1512884455527847,0.2718204488778055,0.5768911055694098,0.8121363258520365,0.18786367414796343
2339,374,193,181,288,86,0.516042780748663,0.4839572192513369,0.7700534759358288,0.22994652406417113,633,110,175,348,566,67,0.17377567140600317,0.2764612954186414,0.5497630331753555,0.8941548183254344,0.10584518167456557
2340,110,66,44,57,53,0.6,0.4,0.5181818181818182,0.4818181818181818,178,3,63,112,175,3,0.016853932584269662,0.3539325842696629,0.6292134831460674,0.9831460674157303,0.016853932584269662
2341,346,228,118,288,58,0.6589595375722543,0.34104046242774566,0.8323699421965318,0.1676300578034682,444,123,144,177,436,8,0.27702702702702703,0.32432432432432434,0.39864864864864863,0.9819819819819819,0.018018018018018018
2342,759,532,227,608,151,0.7009222661396575,0.29907773386034253,0.8010540184453228,0.19894598155467721,1165,246,394,525,1036,129,0.2111587982832618,0.3381974248927039,0.45064377682403434,0.8892703862660944,0.11072961373390558
2343,401,271,130,310,91,0.6758104738154613,0.32418952618453867,0.773067331670823,0.22693266832917705,577,189,189,199,568,9,0.3275563258232236,0.3275563258232236,0.34488734835355284,0.9844020797227037,0.01559792027729636
2344,1284,1004,280,1075,209,0.7819314641744548,0.21806853582554517,0.8372274143302181,0.16277258566978192,1294,296,460,538,1145,149,0.2287480680061824,0.3554868624420402,0.41576506955177744,0.884853168469861,0.1151468315301391
2345,344,210,134,298,46,0.6104651162790697,0.38953488372093026,0.8662790697674418,0.13372093023255813,722,138,239,345,606,116,0.19113573407202217,0.33102493074792244,0.4778393351800554,0.8393351800554016,0.16066481994459833
2346,685,483,202,555,130,0.7051094890510949,0.2948905109489051,0.8102189781021898,0.1897810218978102,840,111,328,401,773,67,0.13214285714285715,0.3904761904761905,0.4773809523809524,0.9202380952380952,0.07976190476190476
2347,2794,2382,412,2509,285,0.8525411596277738,0.1474588403722262,0.8979957050823193,0.10200429491768075,3302,161,299,2842,2883,419,0.04875832828588734,0.09055118110236221,0.8606904906117504,0.8731072077528771,0.12689279224712297
2348,350,227,123,287,63,0.6485714285714286,0.3514285714285714,0.82,0.18,571,162,174,235,561,10,0.28371278458844135,0.30472854640980734,0.4115586690017513,0.9824868651488616,0.017513134851138354
2349,583,369,214,463,120,0.6329331046312179,0.3670668953687822,0.7941680960548885,0.2058319039451115,800,124,225,451,723,77,0.155,0.28125,0.56375,0.90375,0.09625
2350,446,302,144,335,111,0.6771300448430493,0.32286995515695066,0.7511210762331838,0.24887892376681614,599,167,220,212,590,9,0.27879799666110183,0.3672787979966611,0.35392320534223703,0.9849749582637729,0.015025041736227046
2351,328,192,136,286,42,0.5853658536585366,0.4146341463414634,0.8719512195121951,0.12804878048780488,632,138,202,292,579,53,0.21835443037974683,0.31962025316455694,0.4620253164556962,0.9161392405063291,0.08386075949367089
2352,827,624,203,737,90,0.75453446191052,0.24546553808948005,0.8911729141475212,0.10882708585247884,955,136,230,589,754,201,0.1424083769633508,0.24083769633507854,0.6167539267015707,0.7895287958115184,0.21047120418848167
2353,315,196,119,272,43,0.6222222222222222,0.37777777777777777,0.8634920634920635,0.1365079365079365,739,142,193,404,681,58,0.19215155615696888,0.26116373477672533,0.5466847090663058,0.9215155615696887,0.07848443843031123
2354,719,505,214,572,147,0.7023643949930459,0.29763560500695413,0.7955493741307371,0.20445062586926285,872,114,363,395,804,68,0.13073394495412843,0.41628440366972475,0.45298165137614677,0.9220183486238532,0.0779816513761468
2355,612,418,194,503,109,0.6830065359477124,0.31699346405228757,0.8218954248366013,0.1781045751633987,1114,245,312,557,983,131,0.2199281867145422,0.2800718132854578,0.5,0.8824057450628366,0.11759425493716337
2356,779,536,243,654,125,0.6880616174582799,0.3119383825417201,0.8395378690629012,0.16046213093709885,1041,100,210,731,817,224,0.09606147934678194,0.2017291066282421,0.7022094140249759,0.7848222862632085,0.21517771373679154
2357,469,281,188,389,80,0.5991471215351812,0.40085287846481876,0.8294243070362474,0.17057569296375266,849,95,213,541,777,72,0.11189634864546526,0.2508833922261484,0.6372202591283863,0.9151943462897526,0.08480565371024736
2358,1249,1032,217,1092,157,0.8262610088070457,0.17373899119295436,0.8742994395516414,0.1257005604483587,1061,149,278,634,840,221,0.14043355325164938,0.26201696512723843,0.5975494816211122,0.7917059377945335,0.20829406220546653
2359,316,153,163,263,53,0.48417721518987344,0.5158227848101266,0.8322784810126582,0.16772151898734178,705,93,155,457,635,70,0.13191489361702127,0.2198581560283688,0.64822695035461,0.900709219858156,0.09929078014184398
2360,1343,1037,306,1109,234,0.7721518987341772,0.22784810126582278,0.8257632166790767,0.1742367833209233,1341,300,471,570,1200,141,0.22371364653243847,0.3512304250559284,0.4250559284116331,0.8948545861297539,0.10514541387024609
2361,1253,1031,222,1097,156,0.8228252194732641,0.17717478052673583,0.8754988028731046,0.12450119712689545,1066,155,276,635,845,221,0.14540337711069418,0.2589118198874296,0.5956848030018762,0.7926829268292683,0.2073170731707317
2362,586,394,192,464,122,0.6723549488054608,0.32764505119453924,0.7918088737201365,0.20819112627986347,1109,290,287,532,1042,67,0.26149684400360684,0.2587917042380523,0.47971145175834085,0.939585211902615,0.060414788097385035
2363,586,403,183,484,102,0.6877133105802048,0.3122866894197952,0.825938566552901,0.17406143344709898,1218,306,340,572,1089,129,0.2512315270935961,0.2791461412151067,0.4696223316912972,0.8940886699507389,0.10591133004926108
2364,1288,998,290,1079,209,0.7748447204968945,0.2251552795031056,0.8377329192546584,0.1622670807453416,1177,102,234,841,899,278,0.08666100254885302,0.1988105352591334,0.7145284621920136,0.7638062871707731,0.23619371282922685
2365,351,230,121,294,57,0.6552706552706553,0.34472934472934474,0.8376068376068376,0.1623931623931624,544,151,156,237,536,8,0.2775735294117647,0.2867647058823529,0.43566176470588236,0.9852941176470589,0.014705882352941176
2366,990,769,221,833,157,0.7767676767676768,0.22323232323232323,0.8414141414141414,0.15858585858585858,1077,213,372,492,945,132,0.1977715877437326,0.34540389972144847,0.4568245125348189,0.8774373259052924,0.12256267409470752
2367,328,196,132,275,53,0.5975609756097561,0.4024390243902439,0.8384146341463414,0.16158536585365854,587,142,186,259,534,53,0.24190800681431004,0.31686541737649065,0.44122657580919933,0.909710391822828,0.09028960817717206
2368,1254,1032,222,1097,157,0.8229665071770335,0.17703349282296652,0.8748006379585327,0.1251993620414673,1068,149,289,630,847,221,0.13951310861423222,0.2705992509363296,0.5898876404494382,0.7930711610486891,0.20692883895131087
2369,335,223,112,278,57,0.6656716417910448,0.33432835820895523,0.8298507462686567,0.1701492537313433,496,163,167,166,488,8,0.3286290322580645,0.33669354838709675,0.3346774193548387,0.9838709677419355,0.016129032258064516
2370,1286,998,288,1077,209,0.776049766718507,0.223950233281493,0.8374805598755832,0.1625194401244168,1168,102,230,836,890,278,0.08732876712328767,0.1969178082191781,0.7157534246575342,0.761986301369863,0.238013698630137
2371,1246,1032,214,1089,157,0.8282504012841091,0.17174959871589085,0.8739967897271268,0.1260032102728732,1054,155,272,627,833,221,0.14705882352941177,0.25806451612903225,0.594876660341556,0.7903225806451613,0.20967741935483872
2372,464,293,171,327,137,0.6314655172413793,0.36853448275862066,0.7047413793103449,0.2952586206896552,342,51,129,162,335,7,0.14912280701754385,0.37719298245614036,0.47368421052631576,0.97953216374269,0.02046783625730994
2373,492,306,186,405,87,0.6219512195121951,0.3780487804878049,0.823170731707317,0.17682926829268292,1003,223,251,529,939,64,0.22233300099700898,0.2502492522432702,0.5274177467597209,0.9361914257228315,0.06380857427716849
2374,1504,1257,247,1287,217,0.8357712765957447,0.16422872340425532,0.855718085106383,0.14428191489361702,1165,166,323,676,941,224,0.1424892703862661,0.2772532188841202,0.5802575107296137,0.8077253218884121,0.192274678111588
2375,544,351,193,451,93,0.6452205882352942,0.3547794117647059,0.8290441176470589,0.17095588235294118,874,93,207,574,708,166,0.10640732265446225,0.23684210526315788,0.6567505720823799,0.8100686498855835,0.18993135011441648
2376,1270,970,300,1026,244,0.7637795275590551,0.23622047244094488,0.8078740157480315,0.1921259842519685,1200,252,399,549,1060,140,0.21,0.3325,0.4575,0.8833333333333333,0.11666666666666667
2377,764,620,144,505,259,0.8115183246073299,0.18848167539267016,0.6609947643979057,0.3390052356020942,2168,131,237,1800,1710,458,0.060424354243542436,0.10931734317343174,0.8302583025830258,0.7887453874538746,0.21125461254612546
2378,787,564,223,638,149,0.7166454891994918,0.2833545108005083,0.8106734434561627,0.18932655654383734,1237,235,382,620,1012,225,0.18997574777687956,0.3088116410670978,0.5012126111560227,0.8181083265966047,0.18189167340339532
2379,152,43,109,144,8,0.28289473684210525,0.7171052631578947,0.9473684210526315,0.05263157894736842,735,153,161,421,678,57,0.20816326530612245,0.21904761904761905,0.5727891156462585,0.9224489795918367,0.07755102040816327
2380,552,346,206,430,122,0.6268115942028986,0.37318840579710144,0.7789855072463768,0.2210144927536232,745,113,212,420,672,73,0.15167785234899328,0.28456375838926173,0.5637583892617449,0.9020134228187919,0.09798657718120805
2381,1503,1256,247,1288,215,0.8356620093147039,0.1643379906852961,0.8569527611443779,0.1430472388556221,1194,181,327,686,969,225,0.15159128978224456,0.27386934673366836,0.5745393634840871,0.8115577889447236,0.1884422110552764
2382,935,686,249,758,177,0.7336898395721925,0.2663101604278075,0.8106951871657754,0.1893048128342246,1330,264,423,643,1107,223,0.19849624060150375,0.3180451127819549,0.48345864661654137,0.8323308270676691,0.16766917293233083
2383,611,415,196,492,119,0.679214402618658,0.32078559738134205,0.8052373158756138,0.19476268412438624,913,182,210,521,847,66,0.19934282584884994,0.23001095290251916,0.5706462212486308,0.927710843373494,0.07228915662650602
2384,466,285,181,385,81,0.6115879828326181,0.388412017167382,0.8261802575107297,0.17381974248927037,840,114,221,505,766,74,0.1357142857142857,0.2630952380952381,0.6011904761904762,0.9119047619047619,0.0880952380952381
2385,1283,998,285,1074,209,0.7778643803585347,0.2221356196414653,0.8371005455962588,0.16289945440374123,1165,102,229,834,887,278,0.08755364806866953,0.1965665236051502,0.7158798283261802,0.76137339055794,0.23862660944206007
2386,1166,878,288,911,255,0.7530017152658662,0.2469982847341338,0.7813036020583191,0.21869639794168097,1166,102,233,831,888,278,0.08747855917667238,0.1998284734133791,0.7126929674099486,0.7615780445969125,0.23842195540308747
2387,763,546,217,624,139,0.7155963302752294,0.28440366972477066,0.817824377457405,0.182175622542595,1143,243,389,511,1008,135,0.2125984251968504,0.34033245844269466,0.44706911636045493,0.8818897637795275,0.11811023622047244
2388,388,218,170,325,63,0.5618556701030928,0.4381443298969072,0.8376288659793815,0.16237113402061856,919,192,207,520,855,64,0.2089227421109902,0.2252448313384113,0.5658324265505985,0.9303590859630033,0.06964091403699674
2389,426,233,193,320,106,0.5469483568075117,0.45305164319248825,0.7511737089201878,0.24882629107981222,597,97,157,343,530,67,0.1624790619765494,0.2629815745393635,0.5745393634840871,0.8877721943048577,0.11222780569514237
2390,1290,998,292,1081,209,0.7736434108527132,0.22635658914728682,0.837984496124031,0.162015503875969,1167,102,228,837,889,278,0.08740359897172237,0.1953727506426735,0.7172236503856041,0.7617823479005998,0.23821765209940018
2391,4884,4272,612,4150,734,0.8746928746928747,0.12530712530712532,0.8497133497133497,0.15028665028665028,2182,261,593,1328,1704,478,0.11961503208065995,0.27176901924839597,0.608615948670944,0.7809349220898258,0.21906507791017416
2392,457,282,175,376,81,0.6170678336980306,0.38293216630196936,0.8227571115973742,0.1772428884026258,818,105,199,514,746,72,0.12836185819070906,0.24327628361858192,0.628361858190709,0.9119804400977995,0.08801955990220049
2393,1292,998,294,1083,209,0.7724458204334366,0.22755417956656346,0.8382352941176471,0.16176470588235295,1177,102,234,841,899,278,0.08666100254885302,0.1988105352591334,0.7145284621920136,0.7638062871707731,0.23619371282922685
2394,1985,1583,402,1701,284,0.7974811083123425,0.20251889168765744,0.856926952141058,0.14307304785894207,1703,162,293,1248,1284,419,0.09512624779800352,0.17204932472108045,0.732824427480916,0.7539635936582502,0.24603640634174986
2395,618,414,204,512,106,0.6699029126213593,0.3300970873786408,0.8284789644012945,0.1715210355987055,921,118,238,565,754,167,0.1281216069489685,0.25841476655808904,0.6134636264929425,0.8186753528773073,0.18132464712269272
2396,350,216,134,305,45,0.6171428571428571,0.38285714285714284,0.8714285714285714,0.12857142857142856,922,152,257,513,800,122,0.1648590021691974,0.2787418655097614,0.5563991323210412,0.8676789587852495,0.13232104121475055
2397,565,391,174,470,95,0.6920353982300885,0.30796460176991153,0.831858407079646,0.168141592920354,1094,237,302,555,966,128,0.21663619744058502,0.2760511882998172,0.5073126142595978,0.8829981718464351,0.1170018281535649
2398,363,186,177,279,84,0.512396694214876,0.48760330578512395,0.768595041322314,0.23140495867768596,573,87,152,334,507,66,0.1518324607329843,0.26527050610820246,0.5828970331588132,0.8848167539267016,0.11518324607329843
2399,1295,998,297,1086,209,0.7706563706563706,0.22934362934362934,0.8386100386100386,0.1613899613899614,1177,102,233,842,899,278,0.08666100254885302,0.1979609175870858,0.7153780798640612,0.7638062871707731,0.23619371282922685
2400,478,301,177,391,87,0.6297071129707112,0.3702928870292887,0.8179916317991632,0.18200836820083682,807,105,203,499,735,72,0.13011152416356878,0.25154894671623296,0.6183395291201983,0.9107806691449815,0.08921933085501858
2401,351,79,272,230,121,0.22507122507122507,0.7749287749287749,0.6552706552706553,0.34472934472934474,122,3,46,73,122,0,0.02459016393442623,0.3770491803278688,0.5983606557377049,1.0,0.0
2402,415,276,139,359,56,0.6650602409638554,0.3349397590361446,0.8650602409638555,0.13493975903614458,870,134,238,498,749,121,0.15402298850574714,0.2735632183908046,0.5724137931034483,0.860919540229885,0.13908045977011493
2403,5788,5210,578,4885,903,0.9001382170006911,0.09986178299930891,0.8439875604699378,0.1560124395300622,2102,219,595,1288,1736,366,0.10418648905803997,0.2830637488106565,0.6127497621313035,0.8258801141769743,0.17411988582302568
2404,550,368,182,454,96,0.6690909090909091,0.33090909090909093,0.8254545454545454,0.17454545454545456,1036,253,286,497,972,64,0.24420849420849422,0.27606177606177607,0.4797297297297297,0.9382239382239382,0.06177606177606178
2405,565,340,225,446,119,0.6017699115044248,0.39823008849557523,0.7893805309734513,0.21061946902654868,761,115,235,411,690,71,0.15111695137976347,0.3088042049934297,0.5400788436268068,0.9067017082785808,0.09329829172141918
2406,317,189,128,276,41,0.5962145110410094,0.4037854889589905,0.8706624605678234,0.12933753943217666,634,158,215,261,582,52,0.24921135646687698,0.3391167192429022,0.4116719242902208,0.917981072555205,0.08201892744479496
2407,1236,957,279,1016,220,0.7742718446601942,0.22572815533980584,0.8220064724919094,0.1779935275080906,1346,273,440,633,1120,226,0.20282317979197623,0.32689450222882616,0.4702823179791976,0.8320950965824666,0.16790490341753342
2408,317,186,131,277,40,0.5867507886435331,0.41324921135646686,0.8738170347003155,0.12618296529968454,599,142,198,259,547,52,0.2370617696160267,0.330550918196995,0.4323873121869783,0.9131886477462438,0.08681135225375626
2409,1241,1032,209,1084,157,0.8315874294923449,0.16841257050765512,0.8734891216760677,0.12651087832393232,1055,149,268,638,833,222,0.14123222748815165,0.25402843601895736,0.604739336492891,0.7895734597156399,0.2104265402843602
2410,1261,1035,226,1103,158,0.8207771609833465,0.17922283901665345,0.8747026169706582,0.1252973830293418,1108,155,318,635,886,222,0.13989169675090252,0.2870036101083033,0.5731046931407943,0.7996389891696751,0.2003610108303249
2411,567,397,170,475,92,0.7001763668430335,0.2998236331569665,0.8377425044091711,0.16225749559082892,1186,295,320,571,1053,133,0.2487352445193929,0.26981450252951095,0.4814502529510961,0.887858347386172,0.112141652613828
2412,558,342,216,437,121,0.6129032258064516,0.3870967741935484,0.7831541218637993,0.2168458781362007,770,114,234,422,696,74,0.14805194805194805,0.3038961038961039,0.548051948051948,0.9038961038961039,0.09610389610389611
2413,823,574,249,660,163,0.6974483596597812,0.3025516403402187,0.8019441069258809,0.19805589307411908,1068,103,203,762,841,227,0.09644194756554307,0.1900749063670412,0.7134831460674157,0.7874531835205992,0.21254681647940074
2414,1283,998,285,1074,209,0.7778643803585347,0.2221356196414653,0.8371005455962588,0.16289945440374123,1168,102,231,835,890,278,0.08732876712328767,0.19777397260273974,0.7148972602739726,0.761986301369863,0.238013698630137
2415,1289,998,291,1080,209,0.7742435996896819,0.22575640031031807,0.8378588052754073,0.1621411947245927,1172,102,231,839,893,279,0.08703071672354949,0.197098976109215,0.7158703071672355,0.7619453924914675,0.2380546075085324
2416,159,96,63,58,101,0.6037735849056604,0.39622641509433965,0.36477987421383645,0.6352201257861635,42,0,23,19,41,1,0.0,0.5476190476190477,0.4523809523809524,0.9761904761904762,0.023809523809523808
2417,1507,1254,253,1290,217,0.8321167883211679,0.1678832116788321,0.8560053085600531,0.14399469143994692,1175,163,327,685,950,225,0.13872340425531915,0.2782978723404255,0.5829787234042553,0.8085106382978723,0.19148936170212766
2418,658,455,203,527,131,0.6914893617021277,0.30851063829787234,0.8009118541033434,0.19908814589665655,866,129,331,406,798,68,0.1489607390300231,0.38221709006928406,0.46882217090069284,0.9214780600461894,0.07852193995381063
2419,337,216,121,289,48,0.6409495548961425,0.3590504451038576,0.857566765578635,0.142433234421365,695,181,219,295,641,54,0.260431654676259,0.31510791366906477,0.4244604316546763,0.9223021582733812,0.0776978417266187
2420,681,472,209,538,143,0.6930983847283406,0.3069016152716593,0.7900146842878121,0.20998531571218795,853,124,333,396,784,69,0.14536928487690504,0.3903868698710434,0.4642438452520516,0.9191090269636577,0.08089097303634232
2421,457,286,171,375,82,0.6258205689277899,0.3741794310722101,0.8205689277899344,0.17943107221006566,773,106,197,470,702,71,0.1371280724450194,0.25485122897800777,0.6080206985769728,0.908150064683053,0.09184993531694696
2422,1293,998,295,1084,209,0.7718484145398299,0.22815158546017014,0.8383604021655066,0.16163959783449341,1178,102,233,843,900,278,0.0865874363327674,0.19779286926994907,0.7156196943972836,0.7640067911714771,0.23599320882852293
2423,4538,3942,596,3699,839,0.8686646099603349,0.13133539003966505,0.8151167915381226,0.18488320846187747,1967,235,595,1137,1566,401,0.11947127605490594,0.302491103202847,0.5780376207422471,0.7961362480935434,0.20386375190645653
2424,349,214,135,305,44,0.6131805157593123,0.3868194842406877,0.8739255014326648,0.12607449856733524,740,134,243,363,620,120,0.1810810810810811,0.32837837837837835,0.4905405405405405,0.8378378378378378,0.16216216216216217
2425,848,629,219,693,155,0.7417452830188679,0.25825471698113206,0.8172169811320755,0.18278301886792453,1166,254,385,527,1040,126,0.21783876500857632,0.330188679245283,0.45197255574614065,0.8919382504288165,0.10806174957118353
2426,1286,998,288,1077,209,0.776049766718507,0.223950233281493,0.8374805598755832,0.1625194401244168,1165,102,228,835,887,278,0.08755364806866953,0.19570815450643778,0.7167381974248928,0.76137339055794,0.23862660944206007
2427,323,200,123,282,41,0.6191950464396285,0.38080495356037153,0.8730650154798761,0.12693498452012383,656,181,221,254,604,52,0.2759146341463415,0.33689024390243905,0.3871951219512195,0.9207317073170732,0.07926829268292683
2428,305,183,122,264,41,0.6,0.4,0.8655737704918033,0.13442622950819672,582,133,196,253,530,52,0.22852233676975944,0.33676975945017185,0.43470790378006874,0.9106529209621993,0.08934707903780069
2429,779,536,243,654,125,0.6880616174582799,0.3119383825417201,0.8395378690629012,0.16046213093709885,1041,100,210,731,817,224,0.09606147934678194,0.2017291066282421,0.7022094140249759,0.7848222862632085,0.21517771373679154
2430,330,146,184,275,55,0.44242424242424244,0.5575757575757576,0.8333333333333334,0.16666666666666666,772,109,200,463,705,67,0.1411917098445596,0.25906735751295334,0.5997409326424871,0.9132124352331606,0.08678756476683938
2431,295,135,160,245,50,0.4576271186440678,0.5423728813559322,0.8305084745762712,0.1694915254237288,717,99,172,446,648,69,0.13807531380753138,0.2398884239888424,0.6220362622036262,0.9037656903765691,0.09623430962343096
2432,1911,1569,342,1600,311,0.8210361067503925,0.17896389324960754,0.837257980115123,0.16274201988487702,1452,248,409,795,1271,181,0.17079889807162535,0.28168044077134985,0.5475206611570248,0.8753443526170799,0.1246556473829201
2433,634,438,196,520,114,0.6908517350157729,0.30914826498422715,0.8201892744479495,0.17981072555205047,1290,288,352,650,1157,133,0.22325581395348837,0.27286821705426356,0.5038759689922481,0.8968992248062015,0.10310077519379846
2434,353,234,119,310,43,0.6628895184135978,0.3371104815864023,0.8781869688385269,0.12181303116147309,898,174,211,513,815,83,0.19376391982182628,0.23496659242761692,0.5712694877505567,0.9075723830734966,0.09242761692650334
2435,603,386,217,480,123,0.6401326699834162,0.3598673300165838,0.7960199004975125,0.20398009950248755,816,131,251,434,742,74,0.16053921568627452,0.3075980392156863,0.5318627450980392,0.9093137254901961,0.09068627450980392
2436,152,84,68,74,78,0.5526315789473685,0.4473684210526316,0.4868421052631579,0.5131578947368421,152,3,60,89,148,4,0.019736842105263157,0.39473684210526316,0.5855263157894737,0.9736842105263158,0.02631578947368421
2437,658,461,197,520,138,0.7006079027355623,0.2993920972644377,0.790273556231003,0.20972644376899696,799,112,322,365,731,68,0.14017521902377972,0.4030037546933667,0.4568210262828536,0.9148936170212766,0.0851063829787234
2438,1511,1262,249,1295,216,0.8352084712111185,0.16479152878888154,0.85704831237591,0.14295168762409,1201,181,329,691,976,225,0.15070774354704414,0.2739383846794338,0.575353871773522,0.8126561199000832,0.18734388009991673
2439,569,399,170,469,100,0.7012302284710018,0.29876977152899825,0.8242530755711776,0.1757469244288225,1072,273,276,523,1002,70,0.25466417910447764,0.2574626865671642,0.4878731343283582,0.9347014925373134,0.06529850746268656
2440,1256,1039,217,1100,156,0.8272292993630573,0.17277070063694266,0.8757961783439491,0.12420382165605096,1084,155,290,639,862,222,0.1429889298892989,0.26752767527675275,0.5894833948339483,0.7952029520295203,0.2047970479704797
2441,723,525,198,594,129,0.7261410788381742,0.27385892116182575,0.8215767634854771,0.17842323651452283,856,125,336,395,787,69,0.14602803738317757,0.3925233644859813,0.4614485981308411,0.919392523364486,0.08060747663551401
2442,350,213,137,306,44,0.6085714285714285,0.3914285714285714,0.8742857142857143,0.12571428571428572,728,116,243,369,612,116,0.15934065934065933,0.33379120879120877,0.5068681318681318,0.8406593406593407,0.15934065934065933
2443,1255,1031,224,1099,156,0.8215139442231075,0.17848605577689244,0.8756972111553785,0.12430278884462151,1069,155,279,635,848,221,0.1449953227315248,0.2609915809167446,0.5940130963517306,0.7932647333956969,0.20673526660430308
2444,1254,1031,223,1097,157,0.8221690590111643,0.17783094098883573,0.8748006379585327,0.1251993620414673,1060,149,280,631,839,221,0.14056603773584905,0.2641509433962264,0.5952830188679246,0.7915094339622641,0.20849056603773586
2445,4644,4054,590,3897,747,0.8729543496985357,0.12704565030146425,0.8391472868217055,0.16085271317829458,2153,234,588,1331,1751,402,0.1086855550394798,0.2731072921504877,0.6182071528100325,0.8132837900603809,0.18671620993961913
2446,651,465,186,524,127,0.7142857142857143,0.2857142857142857,0.804915514592934,0.19508448540706605,805,115,316,374,738,67,0.14285714285714285,0.39254658385093166,0.4645962732919255,0.9167701863354037,0.08322981366459627
2447,611,424,187,508,103,0.6939443535188216,0.3060556464811784,0.8314238952536824,0.1685761047463175,1076,228,356,492,942,134,0.21189591078066913,0.3308550185873606,0.45724907063197023,0.8754646840148699,0.12453531598513011
2448,1287,998,289,1078,209,0.7754467754467754,0.22455322455322455,0.8376068376068376,0.1623931623931624,1173,102,233,838,895,278,0.08695652173913043,0.19863597612958228,0.7144075021312873,0.763000852514919,0.236999147485081
2449,630,449,181,525,105,0.7126984126984127,0.2873015873015873,0.8333333333333334,0.16666666666666666,1145,340,348,457,1016,129,0.29694323144104806,0.30393013100436683,0.39912663755458516,0.8873362445414847,0.11266375545851529
2450,4502,3961,541,3813,689,0.8798311861394935,0.12016881386050644,0.8469569080408708,0.15304309195912927,2072,225,532,1315,1658,414,0.1085907335907336,0.25675675675675674,0.6346525096525096,0.8001930501930502,0.1998069498069498
2451,1502,1260,242,1287,215,0.8388814913448736,0.1611185086551265,0.8568575233022636,0.14314247669773636,1181,175,318,688,956,225,0.14817950889077053,0.26926333615580017,0.5825571549534293,0.8094834885690093,0.1905165114309907
2452,1294,998,296,1085,209,0.7712519319938176,0.2287480680061824,0.8384853168469861,0.1615146831530139,1183,102,236,845,905,278,0.08622147083685545,0.19949281487743026,0.7142857142857143,0.7650042265426881,0.23499577345731193
2453,136,84,52,59,77,0.6176470588235294,0.38235294117647056,0.4338235294117647,0.5661764705882353,70,0,47,23,69,1,0.0,0.6714285714285714,0.32857142857142857,0.9857142857142858,0.014285714285714285
2454,352,212,140,308,44,0.6022727272727273,0.3977272727272727,0.875,0.125,718,120,240,358,602,116,0.1671309192200557,0.3342618384401114,0.4986072423398329,0.8384401114206128,0.1615598885793872
2455,1287,998,289,1078,209,0.7754467754467754,0.22455322455322455,0.8376068376068376,0.1623931623931624,1170,102,231,837,892,278,0.08717948717948718,0.19743589743589743,0.7153846153846154,0.7623931623931623,0.2376068376068376
2456,330,187,143,289,41,0.5666666666666667,0.43333333333333335,0.8757575757575757,0.12424242424242424,647,140,217,290,595,52,0.21638330757341576,0.33539412673879443,0.4482225656877898,0.919629057187017,0.080370942812983
2457,571,357,214,455,116,0.6252189141856392,0.37478108581436076,0.7968476357267951,0.2031523642732049,777,110,240,427,703,74,0.14157014157014158,0.3088803088803089,0.5495495495495496,0.9047619047619048,0.09523809523809523
2458,787,549,238,649,138,0.6975857687420585,0.30241423125794153,0.8246505717916137,0.17534942820838628,1064,99,209,756,837,227,0.09304511278195489,0.19642857142857142,0.7105263157894737,0.7866541353383458,0.21334586466165414
2459,874,640,234,732,142,0.7322654462242563,0.26773455377574373,0.8375286041189931,0.16247139588100687,1332,280,418,634,1108,224,0.21021021021021022,0.3138138138138138,0.47597597597597596,0.8318318318318318,0.16816816816816818
2460,1246,1031,215,1089,157,0.8274478330658106,0.1725521669341894,0.8739967897271268,0.1260032102728732,1041,149,266,626,820,221,0.1431316042267051,0.25552353506243997,0.6013448607108549,0.7877041306436119,0.21229586935638808
2461,343,224,119,288,55,0.6530612244897959,0.3469387755102041,0.8396501457725948,0.16034985422740525,551,143,153,255,542,9,0.2595281306715064,0.2776769509981851,0.4627949183303085,0.9836660617059891,0.016333938294010888
2462,3759,3307,452,3139,620,0.87975525405693,0.12024474594306997,0.8350625166267625,0.16493748337323758,1841,164,355,1322,1392,449,0.08908202064095601,0.1928299837045084,0.7180879956545356,0.7561108093427485,0.24388919065725148
2463,1296,998,298,1087,209,0.7700617283950617,0.22993827160493827,0.8387345679012346,0.16126543209876543,1184,102,236,846,906,278,0.08614864864864864,0.19932432432432431,0.714527027027027,0.7652027027027027,0.23479729729729729
2464,1272,1045,227,1114,158,0.8215408805031447,0.17845911949685533,0.8757861635220126,0.12421383647798742,1061,150,280,631,840,221,0.1413760603204524,0.2639019792648445,0.5947219604147032,0.7917059377945335,0.20829406220546653
2465,630,408,222,490,140,0.6476190476190476,0.3523809523809524,0.7777777777777778,0.2222222222222222,1159,315,288,556,1094,65,0.271786022433132,0.24849007765314926,0.4797238999137187,0.9439171699741156,0.056082830025884385
2466,1101,870,231,914,187,0.7901907356948229,0.2098092643051771,0.8301544050862852,0.16984559491371481,892,199,242,451,793,99,0.22309417040358745,0.2713004484304933,0.5056053811659192,0.8890134529147982,0.1109865470852018
2467,1193,927,266,984,209,0.7770326906957251,0.22296730930427494,0.8248113998323554,0.1751886001676446,1244,212,385,647,1017,227,0.17041800643086816,0.3094855305466238,0.520096463022508,0.817524115755627,0.182475884244373
2468,1250,1034,216,1091,159,0.8272,0.1728,0.8728,0.1272,1078,149,276,653,856,222,0.13821892393320964,0.2560296846011132,0.6057513914656771,0.7940630797773655,0.20593692022263452
2469,1167,878,289,912,255,0.7523564695801199,0.24764353041988005,0.781491002570694,0.2185089974293059,1163,102,232,829,885,278,0.08770421324161651,0.1994840928632846,0.7128116938950989,0.7609630266552021,0.23903697334479793
2470,563,390,173,468,95,0.6927175843694494,0.30728241563055064,0.8312611012433393,0.16873889875666073,1129,279,331,519,1001,128,0.2471213463241807,0.29317980513728964,0.45969884853852966,0.8866253321523472,0.1133746678476528
2471,565,341,224,443,122,0.6035398230088496,0.39646017699115044,0.784070796460177,0.215929203539823,787,114,234,439,715,72,0.144853875476493,0.29733163913595934,0.5578144853875476,0.9085133418043202,0.09148665819567979
2472,1167,880,287,909,258,0.7540702656383891,0.24592973436161097,0.7789203084832905,0.2210796915167095,1161,102,232,827,883,278,0.08785529715762273,0.19982773471145565,0.7123169681309216,0.7605512489233419,0.23944875107665806
2473,339,209,130,295,44,0.616519174041298,0.3834808259587021,0.8702064896755162,0.12979351032448377,743,151,262,330,627,116,0.2032301480484522,0.35262449528936746,0.44414535666218036,0.8438761776581427,0.15612382234185734
2474,464,286,178,380,84,0.6163793103448276,0.38362068965517243,0.8189655172413793,0.1810344827586207,927,107,209,611,756,171,0.11542610571736785,0.22545846817691478,0.6591154261057174,0.8155339805825242,0.18446601941747573
2475,586,421,165,493,93,0.7184300341296929,0.2815699658703072,0.841296928327645,0.15870307167235495,1026,232,276,518,959,67,0.22612085769980506,0.26900584795321636,0.5048732943469786,0.9346978557504874,0.06530214424951267
2476,438,308,130,373,65,0.7031963470319634,0.2968036529680365,0.8515981735159818,0.14840182648401826,1502,134,253,1115,1142,360,0.08921438082556592,0.16844207723035953,0.7423435419440746,0.7603195739014648,0.2396804260985353
2477,390,206,184,311,79,0.5282051282051282,0.4717948717948718,0.7974358974358975,0.20256410256410257,621,95,161,365,555,66,0.1529790660225443,0.25925925925925924,0.5877616747181964,0.893719806763285,0.10628019323671498
2478,468,280,188,386,82,0.5982905982905983,0.4017094017094017,0.8247863247863247,0.1752136752136752,797,103,225,469,724,73,0.12923462986198245,0.2823086574654956,0.588456712672522,0.9084065244667503,0.09159347553324969
2479,388,207,181,293,95,0.5335051546391752,0.46649484536082475,0.7551546391752577,0.24484536082474226,630,115,161,354,562,68,0.18253968253968253,0.25555555555555554,0.5619047619047619,0.8920634920634921,0.10793650793650794
2480,346,156,190,165,181,0.4508670520231214,0.5491329479768786,0.476878612716763,0.523121387283237,536,203,247,86,535,1,0.3787313432835821,0.4608208955223881,0.16044776119402984,0.9981343283582089,0.0018656716417910447
2481,1167,878,289,912,255,0.7523564695801199,0.24764353041988005,0.781491002570694,0.2185089974293059,1165,102,232,831,887,278,0.08755364806866953,0.19914163090128756,0.7133047210300429,0.76137339055794,0.23862660944206007
2482,411,228,183,337,74,0.5547445255474452,0.44525547445255476,0.8199513381995134,0.18004866180048662,625,98,161,366,558,67,0.1568,0.2576,0.5856,0.8928,0.1072
2483,336,223,113,279,57,0.6636904761904762,0.33630952380952384,0.8303571428571429,0.16964285714285715,636,185,193,258,626,10,0.2908805031446541,0.30345911949685533,0.4056603773584906,0.9842767295597484,0.015723270440251572
2484,188,65,123,179,9,0.34574468085106386,0.6542553191489362,0.9521276595744681,0.047872340425531915,559,128,182,249,508,51,0.22898032200357782,0.32558139534883723,0.44543828264758495,0.9087656529516994,0.09123434704830054
2485,1291,998,293,1082,209,0.7730441518202944,0.22695584817970565,0.8381099922540666,0.16189000774593337,1172,102,231,839,894,278,0.08703071672354949,0.197098976109215,0.7158703071672355,0.7627986348122867,0.23720136518771331
2486,344,174,170,261,83,0.5058139534883721,0.4941860465116279,0.7587209302325582,0.24127906976744187,581,98,148,335,513,68,0.1686746987951807,0.2547332185886403,0.576592082616179,0.882960413080895,0.11703958691910499
2487,1114,850,264,931,183,0.7630161579892281,0.236983842010772,0.8357271095152603,0.16427289048473967,1262,231,405,626,1038,224,0.18304278922345482,0.32091917591125196,0.4960380348652932,0.8225039619651348,0.1774960380348653
2488,750,514,236,601,149,0.6853333333333333,0.31466666666666665,0.8013333333333333,0.19866666666666666,1297,265,311,721,1070,227,0.20431765612952968,0.23978411719352352,0.5558982266769468,0.8249807247494217,0.17501927525057825
2489,563,348,215,442,121,0.6181172291296625,0.38188277087033745,0.7850799289520426,0.21492007104795738,781,123,237,421,709,72,0.15749039692701663,0.3034571062740077,0.5390524967989757,0.9078104993597952,0.09218950064020487
2490,858,636,222,767,91,0.7412587412587412,0.25874125874125875,0.8939393939393939,0.10606060606060606,982,136,261,585,781,201,0.1384928716904277,0.26578411405295316,0.5957230142566191,0.7953156822810591,0.20468431771894094
2491,297,137,160,249,48,0.4612794612794613,0.5387205387205387,0.8383838383838383,0.16161616161616163,702,83,147,472,631,71,0.11823361823361823,0.2094017094017094,0.6723646723646723,0.8988603988603988,0.10113960113960115
2492,1290,998,292,1081,209,0.7736434108527132,0.22635658914728682,0.837984496124031,0.162015503875969,1175,102,232,841,897,278,0.08680851063829788,0.1974468085106383,0.7157446808510638,0.7634042553191489,0.23659574468085107
2493,361,225,136,318,43,0.6232686980609419,0.3767313019390582,0.8808864265927978,0.11911357340720222,618,135,215,268,566,52,0.21844660194174756,0.3478964401294498,0.4336569579288026,0.9158576051779935,0.08414239482200647
2494,316,189,127,276,40,0.5981012658227848,0.40189873417721517,0.8734177215189873,0.12658227848101267,621,126,190,305,565,56,0.2028985507246377,0.3059581320450886,0.49114331723027377,0.9098228663446055,0.09017713365539452
2495,1115,846,269,910,205,0.758744394618834,0.24125560538116592,0.8161434977578476,0.18385650224215247,1269,222,410,637,1045,224,0.17494089834515367,0.32308904649330183,0.5019700551615445,0.8234830575256107,0.1765169424743893
2496,1169,880,289,911,258,0.7527801539777588,0.24721984602224123,0.7792985457656116,0.22070145423438836,1167,102,234,831,889,278,0.08740359897172237,0.20051413881748073,0.712082262210797,0.7617823479005998,0.23821765209940018
2497,1503,1261,242,1288,215,0.8389886892880905,0.16101131071190952,0.8569527611443779,0.1430472388556221,1189,181,325,683,964,225,0.15222876366694701,0.27333894028595457,0.5744322960470984,0.8107653490328006,0.18923465096719932
2498,396,252,144,351,45,0.6363636363636364,0.36363636363636365,0.8863636363636364,0.11363636363636363,874,161,283,430,738,136,0.18421052631578946,0.32379862700228834,0.4919908466819222,0.8443935926773455,0.15560640732265446
2499,374,251,123,308,66,0.6711229946524064,0.32887700534759357,0.8235294117647058,0.17647058823529413,834,115,220,499,712,122,0.13788968824940048,0.2637889688249401,0.5983213429256595,0.8537170263788969,0.14628297362110312
2500,1276,1056,220,1118,158,0.8275862068965517,0.1724137931034483,0.8761755485893417,0.1238244514106583,1061,155,265,641,839,222,0.1460885956644675,0.24976437323279924,0.6041470311027333,0.7907634307257304,0.20923656927426956
2501,334,194,140,294,40,0.5808383233532934,0.41916167664670656,0.8802395209580839,0.11976047904191617,645,152,221,272,593,52,0.23565891472868217,0.3426356589147287,0.42170542635658914,0.9193798449612403,0.08062015503875969
2502,640,432,208,499,141,0.675,0.325,0.7796875,0.2203125,710,111,205,394,641,69,0.1563380281690141,0.2887323943661972,0.5549295774647888,0.9028169014084507,0.09718309859154929
2503,467,298,169,386,81,0.6381156316916489,0.3618843683083512,0.8265524625267666,0.1734475374732334,836,114,199,523,762,74,0.13636363636363635,0.23803827751196172,0.6255980861244019,0.9114832535885168,0.08851674641148326
2504,1253,1039,214,1096,157,0.8292098962490024,0.1707901037509976,0.8747007182761373,0.12529928172386273,1048,149,261,638,826,222,0.14217557251908397,0.24904580152671757,0.6087786259541985,0.7881679389312977,0.21183206106870228
2505,662,428,234,519,143,0.6465256797583081,0.35347432024169184,0.783987915407855,0.21601208459214502,1233,276,331,626,1103,130,0.22384428223844283,0.2684509326845093,0.5077047850770479,0.894566098945661,0.10543390105433902
2506,309,185,124,268,41,0.598705501618123,0.40129449838187703,0.8673139158576052,0.13268608414239483,587,128,197,262,534,53,0.21805792163543442,0.33560477001703576,0.4463373083475298,0.909710391822828,0.09028960817717206
2507,543,374,169,451,92,0.6887661141804788,0.31123388581952116,0.8305709023941068,0.1694290976058932,1107,229,247,631,943,164,0.2068654019873532,0.22312556458897922,0.5700090334236676,0.8518518518518519,0.14814814814814814
2508,431,283,148,366,65,0.6566125290023201,0.3433874709976798,0.8491879350348028,0.15081206496519722,354,35,97,222,348,6,0.09887005649717515,0.2740112994350282,0.6271186440677966,0.9830508474576272,0.01694915254237288
2509,1291,998,293,1082,209,0.7730441518202944,0.22695584817970565,0.8381099922540666,0.16189000774593337,1178,102,233,843,900,278,0.0865874363327674,0.19779286926994907,0.7156196943972836,0.7640067911714771,0.23599320882852293
2510,1503,1254,249,1286,217,0.8343313373253493,0.1656686626746507,0.8556220891550232,0.14437791084497673,1175,166,323,686,950,225,0.14127659574468085,0.27489361702127657,0.5838297872340426,0.8085106382978723,0.19148936170212766
2511,504,314,190,420,84,0.623015873015873,0.376984126984127,0.8333333333333334,0.16666666666666666,823,108,221,494,751,72,0.13122721749696234,0.26852976913730253,0.6002430133657352,0.9125151883353585,0.08748481166464156
2512,386,251,135,333,53,0.6502590673575129,0.34974093264248707,0.8626943005181347,0.13730569948186527,830,110,249,471,709,121,0.13253012048192772,0.3,0.5674698795180723,0.8542168674698796,0.14578313253012049
2513,740,535,205,606,134,0.722972972972973,0.27702702702702703,0.8189189189189189,0.1810810810810811,852,114,343,395,784,68,0.13380281690140844,0.4025821596244131,0.4636150234741784,0.92018779342723,0.07981220657276995
2514,774,550,224,639,135,0.710594315245478,0.28940568475452194,0.8255813953488372,0.1744186046511628,1129,222,370,537,1003,126,0.1966341895482728,0.32772364924712133,0.47564216120460584,0.8883968113374667,0.11160318866253321
2515,1291,998,293,1082,209,0.7730441518202944,0.22695584817970565,0.8381099922540666,0.16189000774593337,1178,102,235,841,900,278,0.0865874363327674,0.199490662139219,0.7139219015280136,0.7640067911714771,0.23599320882852293
2516,356,226,130,312,44,0.6348314606741573,0.3651685393258427,0.8764044943820225,0.12359550561797752,768,161,259,348,652,116,0.20963541666666666,0.3372395833333333,0.453125,0.8489583333333334,0.15104166666666666
2517,1251,1033,218,1095,156,0.8257394084732215,0.17426059152677859,0.8752997601918465,0.12470023980815348,1092,155,302,635,868,224,0.14194139194139194,0.2765567765567766,0.5815018315018315,0.7948717948717948,0.20512820512820512
2518,367,233,134,310,57,0.6348773841961853,0.3651226158038147,0.8446866485013624,0.1553133514986376,662,135,215,312,546,116,0.2039274924471299,0.324773413897281,0.47129909365558914,0.824773413897281,0.17522658610271905
2519,1502,1252,250,1285,217,0.833555259653795,0.16644474034620507,0.855525965379494,0.14447403462050598,1161,163,316,682,936,225,0.14039621016365203,0.2721791559000861,0.5874246339362619,0.8062015503875969,0.1937984496124031
2520,1506,1258,248,1290,216,0.8353253652058433,0.1646746347941567,0.8565737051792829,0.14342629482071714,1160,166,316,678,936,224,0.14310344827586208,0.27241379310344827,0.5844827586206897,0.8068965517241379,0.19310344827586207
2521,454,279,175,372,82,0.6145374449339207,0.3854625550660793,0.8193832599118943,0.18061674008810572,821,110,217,494,746,75,0.13398294762484775,0.26431181485992694,0.6017052375152253,0.9086479902557856,0.09135200974421437
2522,565,347,218,441,124,0.6141592920353982,0.3858407079646018,0.7805309734513274,0.21946902654867256,772,103,237,432,698,74,0.133419689119171,0.3069948186528497,0.5595854922279793,0.9041450777202072,0.09585492227979274
2523,802,558,244,654,148,0.6957605985037406,0.30423940149625933,0.8154613466334164,0.18453865336658354,1075,98,211,766,848,227,0.09116279069767441,0.19627906976744186,0.7125581395348837,0.7888372093023256,0.2111627906976744
2524,1253,1031,222,1096,157,0.8228252194732641,0.17717478052673583,0.8747007182761373,0.12529928172386273,1063,149,285,629,843,220,0.14016933207902163,0.2681091251175917,0.5917215428033866,0.793038570084666,0.20696142991533395
2525,383,210,173,298,85,0.5483028720626631,0.4516971279373368,0.7780678851174935,0.22193211488250653,630,120,160,350,562,68,0.19047619047619047,0.25396825396825395,0.5555555555555556,0.8920634920634921,0.10793650793650794
2526,824,575,249,661,163,0.6978155339805825,0.30218446601941745,0.8021844660194175,0.19781553398058252,1068,103,203,762,841,227,0.09644194756554307,0.1900749063670412,0.7134831460674157,0.7874531835205992,0.21254681647940074
2527,1166,878,288,911,255,0.7530017152658662,0.2469982847341338,0.7813036020583191,0.21869639794168097,1163,102,231,830,885,278,0.08770421324161651,0.19862424763542563,0.7136715391229579,0.7609630266552021,0.23903697334479793
2528,490,304,186,409,81,0.6204081632653061,0.3795918367346939,0.8346938775510204,0.1653061224489796,913,94,217,602,747,166,0.10295728368017525,0.23767798466593648,0.6593647316538883,0.8181818181818182,0.18181818181818182
2529,178,65,113,167,11,0.3651685393258427,0.6348314606741573,0.9382022471910112,0.06179775280898876,679,148,166,365,624,55,0.21796759941089838,0.24447717231222385,0.5375552282768777,0.9189985272459499,0.08100147275405008
2530,1511,1265,246,1295,216,0.8371939113170086,0.1628060886829914,0.85704831237591,0.14295168762409,1148,163,310,675,923,225,0.14198606271777003,0.2700348432055749,0.587979094076655,0.804006968641115,0.19599303135888502
2531,948,655,293,738,210,0.6909282700421941,0.3090717299578059,0.7784810126582279,0.22151898734177214,1146,151,353,642,911,235,0.13176265270506107,0.3080279232111693,0.5602094240837696,0.7949389179755671,0.20506108202443282
2532,1290,998,292,1081,209,0.7736434108527132,0.22635658914728682,0.837984496124031,0.162015503875969,1164,102,226,836,886,278,0.08762886597938144,0.19415807560137457,0.718213058419244,0.761168384879725,0.23883161512027493
2533,408,225,183,321,87,0.5514705882352942,0.4485294117647059,0.7867647058823529,0.21323529411764705,688,132,166,390,620,68,0.19186046511627908,0.24127906976744187,0.5668604651162791,0.9011627906976745,0.09883720930232558
2534,592,398,194,475,117,0.6722972972972973,0.3277027027027027,0.8023648648648649,0.19763513513513514,1250,274,286,690,1088,162,0.2192,0.2288,0.552,0.8704,0.1296
2535,355,214,141,306,49,0.6028169014084507,0.3971830985915493,0.8619718309859155,0.13802816901408452,760,136,204,420,704,56,0.17894736842105263,0.26842105263157895,0.5526315789473685,0.9263157894736842,0.07368421052631578
2536,133,72,61,61,72,0.5413533834586466,0.45864661654135336,0.45864661654135336,0.5413533834586466,139,3,42,94,137,2,0.02158273381294964,0.302158273381295,0.6762589928057554,0.9856115107913669,0.014388489208633094
2537,669,469,200,546,123,0.7010463378176383,0.29895366218236175,0.8161434977578476,0.18385650224215247,1400,318,345,737,1174,226,0.22714285714285715,0.24642857142857144,0.5264285714285715,0.8385714285714285,0.16142857142857142
2538,497,306,191,409,88,0.6156941649899397,0.3843058350100604,0.8229376257545271,0.17706237424547283,860,115,227,518,786,74,0.13372093023255813,0.26395348837209304,0.6023255813953489,0.913953488372093,0.08604651162790698
2539,1864,1575,289,1515,349,0.8449570815450643,0.15504291845493562,0.8127682403433476,0.18723175965665237,1366,218,404,744,1081,285,0.1595900439238653,0.2957540263543192,0.5446559297218155,0.7913616398243045,0.20863836017569545
2540,1151,919,232,948,203,0.7984361424847958,0.20156385751520417,0.8236316246741964,0.17636837532580366,1505,348,478,679,1241,264,0.23122923588039868,0.3176079734219269,0.4511627906976744,0.8245847176079735,0.17541528239202658
2541,400,267,133,304,96,0.6675,0.3325,0.76,0.24,290,45,97,148,283,7,0.15517241379310345,0.33448275862068966,0.5103448275862069,0.9758620689655172,0.02413793103448276
2542,1253,1034,219,1094,159,0.825219473264166,0.174780526735834,0.8731045490822027,0.12689545091779728,1067,149,285,633,845,222,0.13964386129334583,0.26710402999062793,0.5932521087160263,0.7919400187441424,0.20805998125585753
2543,371,246,125,327,44,0.6630727762803235,0.33692722371967654,0.8814016172506739,0.11859838274932614,667,155,208,304,612,55,0.23238380809595202,0.3118440779610195,0.45577211394302847,0.9175412293853074,0.08245877061469266
2544,647,457,190,539,108,0.7063369397217929,0.2936630602782071,0.8330757341576507,0.16692426584234932,1132,269,284,579,1062,70,0.23763250883392226,0.2508833922261484,0.5114840989399293,0.9381625441696113,0.061837455830388695
2545,335,215,120,285,50,0.6417910447761194,0.3582089552238806,0.8507462686567164,0.14925373134328357,824,123,214,487,702,122,0.14927184466019416,0.25970873786407767,0.5910194174757282,0.8519417475728155,0.14805825242718446
2546,1448,1237,211,1267,181,0.8542817679558011,0.1457182320441989,0.875,0.125,1073,155,289,629,851,222,0.14445479962721341,0.26933830382106244,0.5862068965517241,0.7931034482758621,0.20689655172413793
2547,807,558,249,647,160,0.6914498141263941,0.30855018587360594,0.8017348203221809,0.1982651796778191,1256,239,389,628,1035,221,0.19028662420382167,0.30971337579617836,0.5,0.8240445859872612,0.17595541401273884
2548,1276,1043,233,1117,159,0.817398119122257,0.18260188087774296,0.8753918495297806,0.12460815047021943,1061,150,281,630,840,221,0.1413760603204524,0.2648444863336475,0.5937794533459001,0.7917059377945335,0.20829406220546653
2549,1289,998,291,1080,209,0.7742435996896819,0.22575640031031807,0.8378588052754073,0.1621411947245927,1168,102,229,837,890,278,0.08732876712328767,0.19606164383561644,0.7166095890410958,0.761986301369863,0.238013698630137
2550,672,483,189,544,128,0.71875,0.28125,0.8095238095238095,0.19047619047619047,819,126,319,374,750,69,0.15384615384615385,0.3894993894993895,0.45665445665445664,0.9157509157509157,0.08424908424908426
2551,1274,1052,222,1115,159,0.82574568288854,0.17425431711145997,0.8751962323390895,0.12480376766091052,1056,150,274,632,835,221,0.14204545454545456,0.25946969696969696,0.5984848484848485,0.790719696969697,0.20928030303030304
2552,345,213,132,301,44,0.6173913043478261,0.3826086956521739,0.8724637681159421,0.12753623188405797,843,134,259,450,722,121,0.15895610913404506,0.30723606168446027,0.5338078291814946,0.8564650059311981,0.1435349940688019
2553,834,625,209,745,89,0.749400479616307,0.25059952038369304,0.8932853717026379,0.10671462829736211,1006,142,277,587,805,201,0.1411530815109344,0.2753479125248509,0.5834990059642147,0.8001988071570576,0.19980119284294234
2554,620,393,227,489,131,0.6338709677419355,0.36612903225806454,0.7887096774193548,0.21129032258064517,788,116,249,423,715,73,0.14720812182741116,0.315989847715736,0.5368020304568528,0.9073604060913706,0.09263959390862944
2555,1294,998,296,1085,209,0.7712519319938176,0.2287480680061824,0.8384853168469861,0.1615146831530139,1169,102,228,839,891,278,0.0872540633019675,0.19503849443969204,0.7177074422583405,0.7621899059024807,0.23781009409751924
2556,599,402,197,485,114,0.671118530884808,0.328881469115192,0.8096828046744574,0.19031719532554256,1211,278,302,631,1048,163,0.2295623451692816,0.24938067712634188,0.5210569777043765,0.8654004954582989,0.13459950454170108
2557,233,100,133,204,29,0.4291845493562232,0.5708154506437768,0.8755364806866953,0.12446351931330472,610,76,134,400,424,186,0.12459016393442623,0.21967213114754097,0.6557377049180327,0.6950819672131148,0.30491803278688523
2558,362,239,123,297,65,0.6602209944751382,0.3397790055248619,0.8204419889502762,0.17955801104972377,551,139,150,262,542,9,0.25226860254083483,0.27223230490018147,0.47549909255898365,0.9836660617059891,0.016333938294010888
2559,572,370,202,461,111,0.6468531468531469,0.3531468531468531,0.8059440559440559,0.19405594405594406,1249,263,310,676,1080,169,0.21056845476381106,0.24819855884707767,0.5412329863891113,0.8646917534027222,0.13530824659727783
2560,572,349,223,453,119,0.6101398601398601,0.38986013986013984,0.791958041958042,0.20804195804195805,822,117,273,432,748,74,0.14233576642335766,0.33211678832116787,0.5255474452554745,0.9099756690997567,0.09002433090024331
2561,382,249,133,310,72,0.6518324607329843,0.3481675392670157,0.8115183246073299,0.18848167539267016,617,209,233,175,608,9,0.3387358184764992,0.37763371150729336,0.28363047001620745,0.9854132901134521,0.014586709886547812
2562,371,234,137,326,45,0.6307277628032345,0.3692722371967655,0.8787061994609164,0.12129380053908356,1028,170,286,572,875,153,0.16536964980544747,0.2782101167315175,0.556420233463035,0.8511673151750972,0.14883268482490272
2563,360,221,139,314,46,0.6138888888888889,0.3861111111111111,0.8722222222222222,0.12777777777777777,697,106,193,398,643,54,0.15208034433285508,0.2769010043041607,0.5710186513629842,0.9225251076040172,0.07747489239598278
2564,164,48,116,154,10,0.2926829268292683,0.7073170731707317,0.9390243902439024,0.06097560975609756,500,103,152,245,451,49,0.206,0.304,0.49,0.902,0.098
2565,548,159,389,313,235,0.29014598540145986,0.7098540145985401,0.5711678832116789,0.42883211678832117,390,0,204,186,390,0,0.0,0.5230769230769231,0.47692307692307695,1.0,0.0
2566,417,228,189,325,92,0.5467625899280576,0.45323741007194246,0.7793764988009593,0.22062350119904076,612,88,149,375,546,66,0.1437908496732026,0.2434640522875817,0.6127450980392157,0.8921568627450981,0.10784313725490197
2567,570,355,215,447,123,0.6228070175438597,0.37719298245614036,0.7842105263157895,0.21578947368421053,794,134,233,427,721,73,0.16876574307304787,0.29345088161209065,0.5377833753148614,0.9080604534005038,0.09193954659949623
2568,922,681,241,744,178,0.7386117136659436,0.2613882863340564,0.806941431670282,0.19305856832971802,837,118,317,402,768,69,0.14097968936678615,0.37873357228195936,0.48028673835125446,0.9175627240143369,0.08243727598566308
2569,599,412,187,486,113,0.6878130217028381,0.3121869782971619,0.8113522537562604,0.18864774624373956,1248,303,341,604,1113,135,0.24278846153846154,0.27323717948717946,0.483974358974359,0.8918269230769231,0.10817307692307693
2570,836,630,206,745,91,0.7535885167464115,0.24641148325358853,0.8911483253588517,0.10885167464114832,965,137,242,586,764,201,0.14196891191709846,0.25077720207253884,0.6072538860103627,0.7917098445595855,0.20829015544041452
2571,1149,891,258,957,192,0.7754569190600522,0.2245430809399478,0.8328981723237598,0.1671018276762402,1232,256,412,564,1096,136,0.2077922077922078,0.3344155844155844,0.4577922077922078,0.8896103896103896,0.11038961038961038
2572,839,576,263,655,184,0.6865315852205006,0.3134684147794994,0.7806912991656734,0.21930870083432658,1278,243,398,637,1056,222,0.19014084507042253,0.3114241001564945,0.4984350547730829,0.8262910798122066,0.17370892018779344
2573,419,230,189,324,95,0.548926014319809,0.4510739856801909,0.7732696897374701,0.22673031026252982,635,97,161,377,569,66,0.15275590551181104,0.25354330708661416,0.5937007874015748,0.8960629921259843,0.10393700787401575
2574,1283,998,285,1074,209,0.7778643803585347,0.2221356196414653,0.8371005455962588,0.16289945440374123,1168,102,231,835,890,278,0.08732876712328767,0.19777397260273974,0.7148972602739726,0.761986301369863,0.238013698630137
2575,779,562,217,628,151,0.7214377406931964,0.2785622593068036,0.8061617458279846,0.19383825417201542,801,103,332,366,733,68,0.1285892634207241,0.41448189762796506,0.45692883895131087,0.9151061173533084,0.08489388264669163
2576,410,226,184,311,99,0.551219512195122,0.44878048780487806,0.7585365853658537,0.24146341463414633,614,104,155,355,547,67,0.16938110749185667,0.252442996742671,0.5781758957654723,0.8908794788273615,0.10912052117263844
2577,1288,998,290,1079,209,0.7748447204968945,0.2251552795031056,0.8377329192546584,0.1622670807453416,1174,102,232,840,896,278,0.0868824531516184,0.19761499148211242,0.7155025553662692,0.7632027257240205,0.23679727427597955
2578,218,111,107,135,83,0.5091743119266054,0.4908256880733945,0.6192660550458715,0.38073394495412843,162,0,103,59,162,0,0.0,0.6358024691358025,0.36419753086419754,1.0,0.0
2579,1071,816,255,887,184,0.7619047619047619,0.23809523809523808,0.8281979458450047,0.17180205415499533,1372,301,434,637,1147,225,0.2193877551020408,0.3163265306122449,0.4642857142857143,0.8360058309037901,0.16399416909620992
2580,1543,1290,253,1323,220,0.8360337005832793,0.16396629941672067,0.8574206092028516,0.1425793907971484,1164,163,320,681,938,226,0.1400343642611684,0.27491408934707906,0.5850515463917526,0.8058419243986255,0.19415807560137457
2581,475,281,194,393,82,0.5915789473684211,0.40842105263157896,0.8273684210526315,0.1726315789473684,855,117,241,497,783,72,0.1368421052631579,0.2818713450292398,0.5812865497076023,0.9157894736842105,0.08421052631578947
2582,170,41,129,161,9,0.2411764705882353,0.7588235294117647,0.9470588235294117,0.052941176470588235,570,118,169,283,520,50,0.20701754385964913,0.2964912280701754,0.4964912280701754,0.9122807017543859,0.08771929824561403
2583,473,292,181,391,82,0.6173361522198731,0.38266384778012685,0.8266384778012685,0.1733615221987315,836,106,209,521,762,74,0.12679425837320574,0.25,0.6232057416267942,0.9114832535885168,0.08851674641148326
2584,834,625,209,745,89,0.749400479616307,0.25059952038369304,0.8932853717026379,0.10671462829736211,969,142,243,584,768,201,0.14654282765737875,0.25077399380804954,0.6026831785345718,0.7925696594427245,0.20743034055727555
2585,1240,1030,210,1083,157,0.8306451612903226,0.1693548387096774,0.8733870967741936,0.12661290322580646,1049,149,272,628,828,221,0.14204003813155386,0.25929456625357483,0.5986653956148713,0.7893231649189705,0.21067683508102955
2586,324,193,131,282,42,0.595679012345679,0.404320987654321,0.8703703703703703,0.12962962962962962,596,134,197,265,544,52,0.22483221476510068,0.33053691275167785,0.4446308724832215,0.912751677852349,0.087248322147651
2587,4439,3823,616,3760,679,0.8612300067582789,0.1387699932417211,0.8470376210858301,0.15296237891416986,1955,204,567,1184,1549,406,0.10434782608695652,0.29002557544757035,0.6056265984654732,0.7923273657289003,0.20767263427109975
2588,352,227,125,307,45,0.6448863636363636,0.35511363636363635,0.8721590909090909,0.1278409090909091,897,143,241,513,773,124,0.15942028985507245,0.2686733556298774,0.5719063545150501,0.8617614269788183,0.13823857302118173
2589,422,232,190,331,91,0.5497630331753555,0.45023696682464454,0.7843601895734598,0.2156398104265403,581,87,157,337,515,66,0.14974182444061962,0.270223752151463,0.5800344234079173,0.8864027538726333,0.11359724612736662
2590,304,183,121,263,41,0.6019736842105263,0.3980263157894737,0.8651315789473685,0.13486842105263158,530,113,171,246,478,52,0.21320754716981133,0.32264150943396225,0.4641509433962264,0.9018867924528302,0.09811320754716982
2591,1251,1033,218,1092,159,0.8257394084732215,0.17426059152677859,0.8729016786570744,0.12709832134292565,1052,149,277,626,831,221,0.14163498098859315,0.2633079847908745,0.5950570342205324,0.7899239543726235,0.21007604562737642
2592,359,240,119,292,67,0.6685236768802229,0.33147632311977715,0.8133704735376045,0.18662952646239556,677,171,201,305,666,11,0.25258493353028066,0.2968980797636632,0.4505169867060561,0.983751846381093,0.01624815361890694
2593,558,390,168,463,95,0.6989247311827957,0.3010752688172043,0.8297491039426523,0.17025089605734767,1016,226,282,508,888,128,0.22244094488188976,0.27755905511811024,0.5,0.8740157480314961,0.12598425196850394
2594,484,304,180,400,84,0.628099173553719,0.371900826446281,0.8264462809917356,0.17355371900826447,838,114,228,496,764,74,0.1360381861575179,0.2720763723150358,0.5918854415274463,0.9116945107398569,0.0883054892601432
2595,567,379,188,445,122,0.6684303350970018,0.3315696649029982,0.7848324514991182,0.21516754850088182,733,138,199,396,665,68,0.1882673942701228,0.27148703956343795,0.5402455661664393,0.9072305593451568,0.0927694406548431
2596,1248,921,327,1109,139,0.7379807692307693,0.2620192307692308,0.8886217948717948,0.11137820512820513,621,64,173,384,517,104,0.10305958132045089,0.2785829307568438,0.6183574879227053,0.8325281803542673,0.16747181964573268
2597,1250,1035,215,1094,156,0.828,0.172,0.8752,0.1248,1062,156,279,627,841,221,0.14689265536723164,0.2627118644067797,0.5903954802259888,0.7919020715630886,0.2080979284369115
2598,485,304,181,405,80,0.6268041237113402,0.3731958762886598,0.8350515463917526,0.16494845360824742,812,107,233,472,738,74,0.13177339901477833,0.2869458128078818,0.5812807881773399,0.9088669950738916,0.09113300492610837
2599,394,76,318,260,134,0.19289340101522842,0.8071065989847716,0.6598984771573604,0.3401015228426396,152,3,55,94,152,0,0.019736842105263157,0.3618421052631579,0.618421052631579,1.0,0.0
2600,6644,5706,938,5616,1028,0.8588199879590608,0.1411800120409392,0.8452739313666466,0.1547260686333534,2634,242,672,1720,2138,496,0.09187547456340167,0.255125284738041,0.6529992406985573,0.8116932422171602,0.18830675778283978
2601,582,388,194,465,117,0.6666666666666666,0.3333333333333333,0.7989690721649485,0.20103092783505155,1034,290,269,475,970,64,0.2804642166344294,0.2601547388781431,0.45938104448742745,0.9381044487427466,0.061895551257253385
2602,1231,880,351,973,258,0.7148659626320065,0.2851340373679935,0.7904142973192526,0.20958570268074736,1219,102,248,869,941,278,0.08367514356029532,0.20344544708777687,0.7128794093519278,0.7719442165709598,0.2280557834290402
2603,1239,880,359,981,258,0.7102502017756255,0.2897497982243745,0.7917675544794189,0.20823244552058112,1220,102,246,872,942,278,0.08360655737704918,0.20163934426229507,0.7147540983606557,0.7721311475409836,0.2278688524590164
2604,137,76,61,56,81,0.5547445255474452,0.44525547445255476,0.40875912408759124,0.5912408759124088,321,165,119,37,321,0,0.514018691588785,0.3707165109034268,0.11526479750778816,1.0,0.0
2605,546,367,179,449,97,0.6721611721611722,0.32783882783882784,0.8223443223443223,0.17765567765567766,1054,207,237,610,888,166,0.19639468690702086,0.22485768500948766,0.5787476280834914,0.8425047438330171,0.15749525616698293
2606,482,306,176,403,79,0.6348547717842323,0.3651452282157676,0.8360995850622407,0.16390041493775934,911,92,214,605,745,166,0.10098792535675083,0.2349066959385291,0.6641053787047201,0.8177826564215148,0.18221734357848518
2607,1258,1035,223,1100,158,0.8227344992050875,0.17726550079491257,0.8744038155802861,0.12559618441971382,1080,155,287,638,858,222,0.14351851851851852,0.2657407407407407,0.5907407407407408,0.7944444444444444,0.20555555555555555
2608,495,292,203,389,106,0.5898989898989899,0.4101010101010101,0.7858585858585858,0.21414141414141413,738,104,226,408,664,74,0.14092140921409213,0.3062330623306233,0.5528455284552846,0.8997289972899729,0.1002710027100271
2609,1247,1031,216,1091,156,0.8267842822774659,0.17321571772253408,0.8748997594226142,0.12510024057738572,1053,155,273,625,832,221,0.14719848053181386,0.25925925925925924,0.5935422602089269,0.7901234567901234,0.20987654320987653
2610,697,448,249,535,162,0.642754662840746,0.35724533715925394,0.7675753228120517,0.23242467718794835,1069,129,250,690,845,224,0.12067352666043031,0.23386342376052385,0.6454630495790459,0.7904583723105706,0.20954162768942938
2611,493,295,198,417,76,0.5983772819472617,0.40162271805273836,0.845841784989858,0.15415821501014199,853,80,176,597,690,163,0.09378663540445487,0.2063305978898007,0.6998827667057445,0.8089097303634232,0.1910902696365768
2612,1261,1031,230,1105,156,0.8176050753370341,0.1823949246629659,0.8762886597938144,0.12371134020618557,1079,155,291,633,858,221,0.14365152919369786,0.26969416126042633,0.5866543095458758,0.7951807228915663,0.20481927710843373
2613,461,283,178,380,81,0.613882863340564,0.38611713665943603,0.824295010845987,0.175704989154013,838,120,231,487,766,72,0.1431980906921241,0.2756563245823389,0.581145584725537,0.9140811455847255,0.08591885441527446
2614,350,219,131,306,44,0.6257142857142857,0.3742857142857143,0.8742857142857143,0.12571428571428572,912,156,255,501,791,121,0.17105263157894737,0.27960526315789475,0.5493421052631579,0.8673245614035088,0.13267543859649122
2615,648,458,190,519,129,0.7067901234567902,0.2932098765432099,0.8009259259259259,0.19907407407407407,768,111,288,369,701,67,0.14453125,0.375,0.48046875,0.9127604166666666,0.08723958333333333
2616,1046,809,237,868,178,0.7734225621414914,0.22657743785850862,0.8298279158699808,0.1701720841300191,1343,284,433,626,1117,226,0.2114668652271035,0.32241250930752047,0.466120625465376,0.8317200297840656,0.16827997021593447
2617,564,358,206,439,125,0.6347517730496454,0.36524822695035464,0.7783687943262412,0.22163120567375885,755,118,225,412,682,73,0.1562913907284768,0.2980132450331126,0.5456953642384106,0.9033112582781457,0.09668874172185431
2618,310,191,119,270,40,0.6161290322580645,0.38387096774193546,0.8709677419354839,0.12903225806451613,731,132,190,409,674,57,0.18057455540355677,0.25991792065663477,0.5595075239398085,0.9220246238030095,0.07797537619699042
2619,1416,1155,261,1174,242,0.815677966101695,0.1843220338983051,0.8290960451977402,0.1709039548022599,1184,203,392,589,1021,163,0.17145270270270271,0.3310810810810811,0.49746621621621623,0.862331081081081,0.13766891891891891
2620,10692,10130,562,6591,4101,0.9474373363262252,0.05256266367377478,0.6164421997755332,0.3835578002244669,2110,222,582,1306,1691,419,0.1052132701421801,0.27582938388625594,0.6189573459715639,0.8014218009478673,0.1985781990521327
2621,868,610,258,687,181,0.7027649769585254,0.29723502304147464,0.7914746543778802,0.20852534562211983,1081,182,355,544,954,127,0.1683626271970398,0.3283996299722479,0.5032377428307123,0.8825161887141536,0.11748381128584644
2622,1162,880,282,904,258,0.7573149741824441,0.24268502581755594,0.7779690189328744,0.22203098106712565,1156,102,230,824,878,278,0.08823529411764706,0.19896193771626297,0.71280276816609,0.759515570934256,0.24048442906574394
2623,4812,4194,618,4107,705,0.871571072319202,0.128428927680798,0.8534912718204489,0.14650872817955113,2076,210,504,1362,1611,465,0.10115606936416185,0.24277456647398843,0.6560693641618497,0.7760115606936416,0.2239884393063584
2624,595,415,180,491,104,0.6974789915966386,0.3025210084033613,0.8252100840336134,0.17478991596638654,946,200,236,510,879,67,0.21141649048625794,0.24947145877378435,0.5391120507399577,0.9291754756871036,0.0708245243128964
2625,334,208,126,290,44,0.6227544910179641,0.3772455089820359,0.8682634730538922,0.1317365269461078,791,146,216,429,732,59,0.1845764854614412,0.27307206068268014,0.5423514538558787,0.9254108723135271,0.07458912768647281
2626,1284,998,286,1075,209,0.7772585669781932,0.22274143302180685,0.8372274143302181,0.16277258566978192,1171,102,232,837,893,278,0.08710503842869342,0.1981212638770282,0.7147736976942783,0.762596071733561,0.23740392826643894
2627,329,207,122,286,43,0.6291793313069909,0.3708206686930091,0.8693009118541033,0.13069908814589665,830,107,221,502,708,122,0.12891566265060242,0.26626506024096386,0.6048192771084338,0.8530120481927711,0.14698795180722893
2628,824,575,249,661,163,0.6978155339805825,0.30218446601941745,0.8021844660194175,0.19781553398058252,1068,103,203,762,841,227,0.09644194756554307,0.1900749063670412,0.7134831460674157,0.7874531835205992,0.21254681647940074
2629,343,215,128,298,45,0.6268221574344023,0.37317784256559766,0.8688046647230321,0.13119533527696792,741,131,244,366,624,117,0.1767881241565452,0.3292847503373819,0.4939271255060729,0.8421052631578947,0.15789473684210525
2630,749,544,205,615,134,0.7263017356475301,0.27369826435246997,0.8210947930574098,0.17890520694259013,1163,255,395,513,1031,132,0.21926053310404128,0.33963886500429924,0.4411006018916595,0.8865004299226139,0.11349957007738606
2631,367,239,128,296,71,0.6512261580381471,0.34877384196185285,0.8065395095367848,0.19346049046321526,411,114,140,157,404,7,0.2773722627737226,0.340632603406326,0.3819951338199513,0.9829683698296837,0.0170316301703163
2632,556,391,165,462,94,0.7032374100719424,0.29676258992805754,0.8309352517985612,0.16906474820143885,1219,244,300,675,992,227,0.20016406890894176,0.2461033634126333,0.5537325676784249,0.8137817883511075,0.18621821164889255
2633,1366,999,367,1092,274,0.7313323572474377,0.2686676427525622,0.7994143484626647,0.2005856515373353,1238,104,256,878,960,278,0.0840064620355412,0.20678513731825526,0.7092084006462036,0.7754442649434572,0.2245557350565428
2634,350,228,122,285,65,0.6514285714285715,0.3485714285714286,0.8142857142857143,0.18571428571428572,580,158,182,240,572,8,0.27241379310344827,0.3137931034482759,0.41379310344827586,0.9862068965517241,0.013793103448275862
2635,580,405,175,478,102,0.6982758620689655,0.3017241379310345,0.8241379310344827,0.17586206896551723,1319,331,345,643,1184,135,0.25094768764215314,0.26156178923426837,0.4874905231235785,0.8976497346474602,0.1023502653525398
2636,461,280,181,379,82,0.6073752711496746,0.3926247288503254,0.8221258134490239,0.17787418655097614,873,118,218,537,798,75,0.13516609392898052,0.24971363115693013,0.6151202749140894,0.9140893470790378,0.0859106529209622
2637,436,292,144,322,114,0.6697247706422018,0.3302752293577982,0.7385321100917431,0.26146788990825687,583,179,203,201,574,9,0.307032590051458,0.3481989708404803,0.34476843910806176,0.9845626072041166,0.015437392795883362
2638,1297,998,299,1088,209,0.7694680030840401,0.2305319969159599,0.8388589051657671,0.16114109483423283,1178,102,233,843,900,278,0.0865874363327674,0.19779286926994907,0.7156196943972836,0.7640067911714771,0.23599320882852293
2639,547,345,202,424,123,0.6307129798903108,0.3692870201096892,0.7751371115173674,0.22486288848263253,702,106,196,400,628,74,0.150997150997151,0.2792022792022792,0.5698005698005698,0.8945868945868946,0.10541310541310542
2640,389,216,173,325,64,0.5552699228791774,0.44473007712082263,0.8354755784061697,0.16452442159383032,820,168,178,474,758,62,0.2048780487804878,0.21707317073170732,0.5780487804878048,0.9243902439024391,0.07560975609756097
2641,398,214,184,307,91,0.5376884422110553,0.4623115577889447,0.7713567839195979,0.228643216080402,627,102,165,360,561,66,0.16267942583732056,0.2631578947368421,0.5741626794258373,0.8947368421052632,0.10526315789473684
2642,1285,998,287,1076,209,0.7766536964980545,0.22334630350194554,0.8373540856031129,0.16264591439688716,1169,102,231,836,891,278,0.0872540633019675,0.19760479041916168,0.7151411462788708,0.7621899059024807,0.23781009409751924
2643,3757,3299,458,3140,617,0.8780942241149854,0.12190577588501464,0.835773223316476,0.1642267766835241,1884,164,374,1346,1413,471,0.0870488322717622,0.19851380042462846,0.7144373673036093,0.75,0.25
2644,1291,998,293,1082,209,0.7730441518202944,0.22695584817970565,0.8381099922540666,0.16189000774593337,1177,102,233,842,899,278,0.08666100254885302,0.1979609175870858,0.7153780798640612,0.7638062871707731,0.23619371282922685
2645,841,624,217,752,89,0.7419738406658739,0.25802615933412604,0.8941736028537456,0.10582639714625446,975,143,252,580,775,200,0.14666666666666667,0.25846153846153846,0.5948717948717949,0.7948717948717948,0.20512820512820512
2646,557,374,183,456,101,0.6714542190305206,0.32854578096947934,0.8186714542190305,0.1813285457809695,1059,258,278,523,993,66,0.24362606232294617,0.26251180358829085,0.493862134088763,0.9376770538243626,0.06232294617563739
2647,448,280,168,365,83,0.625,0.375,0.8147321428571429,0.18526785714285715,859,103,186,570,690,169,0.119906868451688,0.21653084982537835,0.6635622817229336,0.8032596041909197,0.19674039580908032
2648,565,399,166,470,95,0.7061946902654868,0.2938053097345133,0.831858407079646,0.168141592920354,1262,254,303,705,1031,231,0.20126782884310618,0.24009508716323297,0.5586370839936609,0.8169572107765452,0.18304278922345482
2649,422,221,201,324,98,0.523696682464455,0.476303317535545,0.7677725118483413,0.23222748815165878,797,147,170,480,734,63,0.18444165621079048,0.21329987452948557,0.6022584692597239,0.9209535759096612,0.07904642409033877
2650,1529,1276,253,1309,220,0.8345323741007195,0.16546762589928057,0.8561151079136691,0.14388489208633093,1159,163,317,679,934,225,0.14063848144952545,0.27351164797238997,0.5858498705780846,0.8058671268334772,0.19413287316652286
2651,1891,1530,361,1585,306,0.8090957165520889,0.19090428344791116,0.8381808566895822,0.16181914331041777,1323,260,453,610,1172,151,0.1965230536659108,0.3424036281179138,0.46107331821617537,0.8858654572940288,0.11413454270597127
2652,1164,877,287,909,255,0.7534364261168385,0.24656357388316152,0.7809278350515464,0.2190721649484536,1170,102,236,832,892,278,0.08717948717948718,0.20170940170940171,0.7111111111111111,0.7623931623931623,0.2376068376068376
2653,287,104,183,111,176,0.3623693379790941,0.6376306620209059,0.3867595818815331,0.6132404181184669,124,0,72,52,124,0,0.0,0.5806451612903226,0.41935483870967744,1.0,0.0
2654,733,502,231,582,151,0.684856753069577,0.3151432469304229,0.7939972714870396,0.20600272851296045,1164,185,367,612,942,222,0.15893470790378006,0.31529209621993126,0.5257731958762887,0.8092783505154639,0.19072164948453607
2655,1260,1049,211,1101,159,0.8325396825396826,0.16746031746031745,0.8738095238095238,0.1261904761904762,1040,149,259,632,819,221,0.14326923076923076,0.24903846153846154,0.6076923076923076,0.7875,0.2125
2656,311,188,123,269,42,0.6045016077170418,0.3954983922829582,0.864951768488746,0.13504823151125403,559,124,180,255,507,52,0.22182468694096602,0.3220035778175313,0.4561717352415027,0.9069767441860465,0.09302325581395349
2657,1105,838,267,897,208,0.7583710407239819,0.2416289592760181,0.8117647058823529,0.18823529411764706,1171,237,412,522,1040,131,0.20239111870196413,0.3518360375747225,0.4457728437233134,0.888129803586678,0.11187019641332195
2658,298,132,166,250,48,0.4429530201342282,0.5570469798657718,0.8389261744966443,0.1610738255033557,775,95,172,508,703,72,0.12258064516129032,0.22193548387096773,0.655483870967742,0.9070967741935484,0.09290322580645162
2659,695,497,198,553,142,0.7151079136690648,0.28489208633093527,0.7956834532374101,0.20431654676258992,811,119,322,370,742,69,0.1467324290998767,0.3970406905055487,0.4562268803945746,0.9149198520345253,0.08508014796547472
2660,342,209,133,299,43,0.6111111111111112,0.3888888888888889,0.8742690058479532,0.12573099415204678,832,138,241,453,711,121,0.1658653846153846,0.28966346153846156,0.5444711538461539,0.8545673076923077,0.14543269230769232
2661,600,405,195,498,102,0.675,0.325,0.83,0.17,883,101,202,580,715,168,0.1143827859569649,0.2287655719139298,0.6568516421291053,0.8097395243488109,0.19026047565118911
2662,558,334,224,440,118,0.5985663082437276,0.4014336917562724,0.7885304659498208,0.2114695340501792,746,105,236,405,674,72,0.14075067024128687,0.3163538873994638,0.5428954423592494,0.903485254691689,0.09651474530831099
2663,452,280,172,370,82,0.6194690265486725,0.3805309734513274,0.8185840707964602,0.18141592920353983,759,95,190,474,686,73,0.1251646903820817,0.2503293807641634,0.6245059288537549,0.9038208168642952,0.09617918313570488
2664,367,242,125,312,55,0.659400544959128,0.3405994550408719,0.8501362397820164,0.14986376021798364,567,172,226,169,559,8,0.30335097001763667,0.3985890652557319,0.2980599647266314,0.9858906525573192,0.014109347442680775
2665,0,0,0,0,0,0.0,0.0,0.0,0.0,0,0,0,0,0,0,0.0,0.0,0.0,0.0,0.0
2666,1552,1298,254,1331,221,0.836340206185567,0.163659793814433,0.8576030927835051,0.14239690721649484,1207,181,327,699,981,226,0.1499585749792875,0.27091963545981773,0.5791217895608948,0.8127589063794531,0.1872410936205468
2667,1969,1632,337,1642,327,0.8288471305231082,0.17115286947689182,0.8339258506856272,0.16607414931437278,1310,219,412,679,1103,207,0.16717557251908396,0.3145038167938931,0.518320610687023,0.8419847328244274,0.15801526717557252
2668,1503,1259,244,1289,214,0.8376580172987359,0.16234198270126413,0.8576180971390552,0.14238190286094476,1170,172,320,678,945,225,0.147008547008547,0.27350427350427353,0.5794871794871795,0.8076923076923077,0.19230769230769232
2669,1455,1152,303,1228,227,0.7917525773195876,0.20824742268041238,0.8439862542955326,0.15601374570446735,1315,288,447,580,1168,147,0.21901140684410647,0.33992395437262357,0.44106463878326996,0.888212927756654,0.11178707224334601
2670,927,681,246,756,171,0.7346278317152104,0.26537216828478966,0.8155339805825242,0.18446601941747573,1075,98,211,766,848,227,0.09116279069767441,0.19627906976744186,0.7125581395348837,0.7888372093023256,0.2111627906976744
2671,1404,1117,287,1157,247,0.7955840455840456,0.20441595441595442,0.8240740740740741,0.17592592592592593,1434,271,412,751,1130,304,0.18898186889818688,0.28730822873082285,0.5237099023709902,0.7880055788005579,0.21199442119944212
2672,1334,1089,245,1167,167,0.8163418290854573,0.18365817091454273,0.8748125937031485,0.12518740629685157,1073,149,288,636,852,221,0.13886300093196646,0.2684063373718546,0.5927306616961789,0.7940354147250699,0.2059645852749301
2673,676,491,185,574,102,0.7263313609467456,0.27366863905325445,0.849112426035503,0.15088757396449703,1121,252,366,503,987,134,0.2247992863514719,0.3264942016057092,0.4487065120428189,0.8804638715432649,0.11953612845673506
2674,1499,1253,246,1282,217,0.8358905937291528,0.16410940627084722,0.8552368245496998,0.1447631754503002,1187,175,323,689,962,225,0.14743049705139005,0.2721145745577085,0.5804549283909014,0.81044650379107,0.18955349620893008
2675,316,188,128,275,41,0.5949367088607594,0.4050632911392405,0.870253164556962,0.12974683544303797,657,169,219,269,604,53,0.2572298325722983,0.3333333333333333,0.4094368340943683,0.9193302891933028,0.0806697108066971
2676,320,183,137,279,41,0.571875,0.428125,0.871875,0.128125,605,127,206,272,553,52,0.20991735537190082,0.34049586776859503,0.44958677685950416,0.9140495867768595,0.0859504132231405
2677,309,137,172,258,51,0.44336569579288027,0.5566343042071198,0.8349514563106796,0.1650485436893204,720,93,186,441,649,71,0.12916666666666668,0.25833333333333336,0.6125,0.9013888888888889,0.09861111111111111
2678,1259,1033,226,1103,156,0.8204924543288324,0.17950754567116758,0.8760921366163622,0.12390786338363781,1088,156,292,640,866,222,0.14338235294117646,0.26838235294117646,0.5882352941176471,0.7959558823529411,0.20404411764705882
2679,846,624,222,756,90,0.7375886524822695,0.2624113475177305,0.8936170212765957,0.10638297872340426,988,136,261,591,787,201,0.13765182186234817,0.26417004048583,0.5981781376518218,0.7965587044534413,0.2034412955465587
2680,699,490,209,556,143,0.7010014306151645,0.2989985693848355,0.7954220314735336,0.20457796852646637,853,134,333,386,783,70,0.1570926143024619,0.3903868698710434,0.4525205158264947,0.917936694021102,0.08206330597889801
2681,1323,1084,239,1157,166,0.8193499622071051,0.18065003779289493,0.8745275888133031,0.1254724111866969,1071,149,279,643,849,222,0.13912231559290383,0.2605042016806723,0.6003734827264239,0.7927170868347339,0.20728291316526612
2682,183,65,118,175,8,0.3551912568306011,0.644808743169399,0.9562841530054644,0.04371584699453552,730,180,187,363,676,54,0.2465753424657534,0.25616438356164384,0.49726027397260275,0.9260273972602739,0.07397260273972603
2683,1165,877,288,910,255,0.7527896995708154,0.24721030042918454,0.7811158798283262,0.21888412017167383,1155,102,227,826,877,278,0.08831168831168831,0.19653679653679654,0.7151515151515152,0.7593073593073593,0.24069264069264068
2684,874,631,243,712,162,0.7219679633867276,0.2780320366132723,0.8146453089244852,0.1853546910755149,1198,259,403,536,1069,129,0.21619365609348914,0.3363939899833055,0.44741235392320533,0.8923205342237062,0.10767946577629382
2685,557,373,184,459,98,0.6696588868940754,0.3303411131059246,0.8240574506283662,0.17594254937163376,1146,242,263,641,983,163,0.2111692844677138,0.22949389179755672,0.5593368237347295,0.8577661431064573,0.14223385689354276
2686,1183,894,289,957,226,0.7557058326289096,0.24429416737109044,0.8089602704987321,0.19103972950126796,1354,264,441,649,1131,223,0.19497784342688332,0.3257016248153619,0.4793205317577548,0.8353028064992615,0.16469719350073855
2687,914,679,235,741,173,0.7428884026258206,0.25711159737417943,0.8107221006564551,0.18927789934354486,865,136,323,406,796,69,0.15722543352601157,0.37341040462427744,0.46936416184971097,0.9202312138728324,0.07976878612716763
2688,212,127,85,99,113,0.5990566037735849,0.4009433962264151,0.4669811320754717,0.5330188679245284,397,171,194,32,397,0,0.43073047858942065,0.48866498740554154,0.08060453400503778,1.0,0.0
2689,327,205,122,285,42,0.6269113149847095,0.3730886850152905,0.8715596330275229,0.12844036697247707,739,153,192,394,683,56,0.2070365358592693,0.2598105548037889,0.5331529093369418,0.9242219215155616,0.07577807848443843
2690,317,200,117,276,41,0.6309148264984227,0.36908517350157727,0.8706624605678234,0.12933753943217666,721,120,165,436,663,58,0.1664355062413315,0.2288488210818308,0.6047156726768377,0.9195561719833565,0.08044382801664356
2691,594,379,215,465,129,0.6380471380471381,0.36195286195286197,0.7828282828282829,0.21717171717171718,731,100,227,404,657,74,0.13679890560875513,0.31053351573187415,0.5526675786593708,0.8987688098495212,0.1012311901504788
2692,1504,1255,249,1288,216,0.8344414893617021,0.16555851063829788,0.8563829787234043,0.14361702127659576,1162,163,321,678,936,226,0.14027538726333907,0.2762478485370052,0.5834767641996558,0.8055077452667814,0.1944922547332186
2693,577,364,213,452,125,0.6308492201039861,0.36915077989601386,0.7833622183708839,0.21663778162911612,707,97,213,397,635,72,0.1371994342291372,0.3012729844413013,0.5615275813295615,0.8981612446958982,0.10183875530410184
2694,514,311,203,429,85,0.6050583657587548,0.3949416342412451,0.8346303501945526,0.16536964980544747,850,95,244,511,777,73,0.11176470588235295,0.28705882352941176,0.6011764705882353,0.9141176470588235,0.08588235294117647
2695,304,184,120,262,42,0.6052631578947368,0.39473684210526316,0.8618421052631579,0.13815789473684212,562,127,181,254,510,52,0.22597864768683273,0.3220640569395018,0.45195729537366547,0.9074733096085409,0.09252669039145907
2696,3260,2921,339,2809,451,0.8960122699386504,0.10398773006134969,0.8616564417177914,0.1383435582822086,959,90,274,595,870,89,0.09384775808133472,0.2857142857142857,0.6204379562043796,0.9071949947862357,0.09280500521376434
2697,481,300,181,398,83,0.6237006237006237,0.3762993762993763,0.8274428274428275,0.17255717255717257,841,107,219,515,767,74,0.1272294887039239,0.26040428061831156,0.6123662306777645,0.9120095124851367,0.08799048751486326
2698,504,258,246,359,145,0.5119047619047619,0.4880952380952381,0.7123015873015873,0.2876984126984127,813,155,186,472,752,61,0.1906519065190652,0.22878228782287824,0.5805658056580566,0.9249692496924969,0.07503075030750307
2699,474,298,176,393,81,0.6286919831223629,0.37130801687763715,0.8291139240506329,0.17088607594936708,852,121,234,497,780,72,0.142018779342723,0.2746478873239437,0.5833333333333334,0.9154929577464789,0.08450704225352113
2700,462,283,179,380,82,0.6125541125541125,0.3874458874458874,0.8225108225108225,0.1774891774891775,797,106,213,478,725,72,0.1329987452948557,0.2672521957340025,0.5997490589711418,0.9096612296110415,0.0903387703889586
2701,1290,998,292,1081,209,0.7736434108527132,0.22635658914728682,0.837984496124031,0.162015503875969,1181,102,236,843,903,278,0.0863674851820491,0.19983065198983913,0.7138018628281118,0.7646062658763759,0.23539373412362405
2702,382,206,176,293,89,0.5392670157068062,0.4607329842931937,0.7670157068062827,0.23298429319371727,613,113,158,342,546,67,0.18433931484502447,0.25774877650897227,0.5579119086460033,0.8907014681892332,0.10929853181076672
2703,1164,878,286,909,255,0.7542955326460481,0.24570446735395188,0.7809278350515464,0.2190721649484536,1166,102,235,829,888,278,0.08747855917667238,0.20154373927958832,0.7109777015437393,0.7615780445969125,0.23842195540308747
2704,1415,1121,294,1183,232,0.792226148409894,0.207773851590106,0.8360424028268552,0.16395759717314487,1167,102,228,837,889,278,0.08740359897172237,0.1953727506426735,0.7172236503856041,0.7617823479005998,0.23821765209940018
2705,391,251,140,336,55,0.6419437340153452,0.35805626598465473,0.8593350383631714,0.14066496163682865,696,126,235,335,580,116,0.1810344827586207,0.33764367816091956,0.4813218390804598,0.8333333333333334,0.16666666666666666
2706,470,281,189,388,82,0.597872340425532,0.4021276595744681,0.825531914893617,0.17446808510638298,830,95,228,507,758,72,0.1144578313253012,0.2746987951807229,0.6108433734939759,0.9132530120481928,0.08674698795180723
2707,1293,998,295,1084,209,0.7718484145398299,0.22815158546017014,0.8383604021655066,0.16163959783449341,1178,102,233,843,900,278,0.0865874363327674,0.19779286926994907,0.7156196943972836,0.7640067911714771,0.23599320882852293
2708,305,180,125,266,39,0.5901639344262295,0.4098360655737705,0.8721311475409836,0.12786885245901639,590,133,196,261,538,52,0.22542372881355932,0.33220338983050846,0.4423728813559322,0.911864406779661,0.08813559322033898
2709,620,423,197,507,113,0.682258064516129,0.317741935483871,0.817741935483871,0.18225806451612903,1171,290,343,538,1043,128,0.24765157984628522,0.2929120409906063,0.4594363791631085,0.8906917164816396,0.10930828351836037
2710,318,201,117,276,42,0.6320754716981132,0.36792452830188677,0.8679245283018868,0.1320754716981132,585,146,186,253,532,53,0.24957264957264957,0.31794871794871793,0.4324786324786325,0.9094017094017094,0.0905982905982906
2711,1290,1001,289,1079,211,0.775968992248062,0.224031007751938,0.8364341085271317,0.1635658914728682,1168,102,230,836,890,278,0.08732876712328767,0.1969178082191781,0.7157534246575342,0.761986301369863,0.238013698630137
2712,1397,1132,265,1145,252,0.8103078024337866,0.1896921975662133,0.819613457408733,0.180386542591267,1134,170,369,595,963,171,0.14991181657848324,0.3253968253968254,0.5246913580246914,0.8492063492063492,0.15079365079365079
2713,477,298,179,394,83,0.6247379454926625,0.3752620545073375,0.8259958071278826,0.1740041928721174,838,106,238,494,766,72,0.12649164677804295,0.2840095465393795,0.5894988066825776,0.9140811455847255,0.08591885441527446
2714,450,263,187,373,77,0.5844444444444444,0.41555555555555557,0.8288888888888889,0.1711111111111111,806,128,164,514,743,63,0.1588089330024814,0.20347394540942929,0.6377171215880894,0.9218362282878412,0.07816377171215881
2715,1530,1282,248,1311,219,0.8379084967320262,0.16209150326797386,0.8568627450980392,0.14313725490196078,1159,166,315,678,935,224,0.14322691975841242,0.271786022433132,0.5849870578084556,0.8067299396031061,0.19327006039689387
2716,1291,998,293,1082,209,0.7730441518202944,0.22695584817970565,0.8381099922540666,0.16189000774593337,1180,102,235,843,902,278,0.08644067796610169,0.19915254237288135,0.714406779661017,0.764406779661017,0.23559322033898306
2717,752,514,238,591,161,0.6835106382978723,0.31648936170212766,0.785904255319149,0.21409574468085107,1004,145,332,527,867,137,0.14442231075697212,0.33067729083665337,0.5249003984063745,0.8635458167330677,0.13645418326693226
2718,1249,1033,216,1093,156,0.8270616493194556,0.17293835068054444,0.8751000800640513,0.12489991993594876,1069,155,273,641,847,222,0.1449953227315248,0.255378858746492,0.5996258185219832,0.7923292797006548,0.2076707202993452
2719,1273,1041,232,1107,166,0.8177533385703064,0.18224666142969365,0.8695993715632364,0.13040062843676356,1069,150,281,638,847,222,0.1403180542563143,0.2628624883068288,0.5968194574368568,0.7923292797006548,0.2076707202993452
2720,329,199,130,288,41,0.6048632218844985,0.3951367781155015,0.8753799392097265,0.12462006079027356,619,145,203,271,566,53,0.23424878836833601,0.32794830371567046,0.4378029079159935,0.9143780290791599,0.08562197092084006
2721,322,191,131,279,43,0.593167701863354,0.40683229813664595,0.8664596273291926,0.13354037267080746,776,127,214,435,719,57,0.163659793814433,0.2757731958762887,0.5605670103092784,0.9265463917525774,0.07345360824742268
2722,1296,998,298,1087,209,0.7700617283950617,0.22993827160493827,0.8387345679012346,0.16126543209876543,1176,102,232,842,898,278,0.08673469387755102,0.19727891156462585,0.7159863945578231,0.7636054421768708,0.23639455782312926
2723,567,384,183,469,98,0.6772486772486772,0.32275132275132273,0.8271604938271605,0.1728395061728395,1161,315,321,525,1096,65,0.2713178294573643,0.27648578811369506,0.45219638242894056,0.9440137812230835,0.05598621877691645
2724,1122,861,261,940,182,0.767379679144385,0.232620320855615,0.8377896613190731,0.1622103386809269,1302,254,433,615,1075,227,0.19508448540706605,0.3325652841781874,0.47235023041474655,0.825652841781874,0.17434715821812596
2725,571,352,219,449,122,0.6164623467600701,0.38353765323992994,0.7863397548161121,0.2136602451838879,787,120,237,430,714,73,0.15247776365946633,0.301143583227446,0.5463786531130876,0.9072426937738246,0.09275730622617535
2726,567,369,198,474,93,0.6507936507936508,0.3492063492063492,0.8359788359788359,0.164021164021164,499,33,105,361,491,8,0.06613226452905811,0.21042084168336672,0.7234468937875751,0.9839679358717435,0.01603206412825651
2727,835,574,261,672,163,0.6874251497005988,0.3125748502994012,0.8047904191616766,0.19520958083832335,1075,103,204,768,848,227,0.09581395348837209,0.18976744186046512,0.7144186046511628,0.7888372093023256,0.2111627906976744
2728,470,289,181,387,83,0.6148936170212767,0.3851063829787234,0.823404255319149,0.17659574468085107,769,109,205,455,698,71,0.14174252275682706,0.2665799739921977,0.5916775032509753,0.9076723016905072,0.09232769830949285
2729,1296,998,298,1087,209,0.7700617283950617,0.22993827160493827,0.8387345679012346,0.16126543209876543,1181,102,234,845,903,278,0.0863674851820491,0.19813717188823032,0.7154953429297206,0.7646062658763759,0.23539373412362405
2730,425,222,203,338,87,0.5223529411764706,0.4776470588235294,0.7952941176470588,0.20470588235294118,753,131,214,408,684,69,0.17397078353253653,0.28419654714475434,0.5418326693227091,0.9083665338645418,0.09163346613545817
2731,1043,775,268,847,196,0.7430488974113135,0.2569511025886865,0.8120805369127517,0.18791946308724833,1286,259,424,603,1144,142,0.20139968895800933,0.3297045101088647,0.468895800933126,0.8895800933125972,0.1104199066874028
2732,1252,1033,219,1096,156,0.8250798722044729,0.17492012779552715,0.8753993610223643,0.12460063897763578,1075,155,282,638,854,221,0.14418604651162792,0.26232558139534884,0.5934883720930233,0.7944186046511628,0.2055813953488372
2733,339,219,120,293,46,0.6460176991150443,0.35398230088495575,0.8643067846607669,0.13569321533923304,907,168,251,488,784,123,0.185226019845645,0.27673649393605293,0.538037486218302,0.86438809261301,0.13561190738699008
2734,1172,879,293,914,258,0.75,0.25,0.7798634812286689,0.22013651877133106,1166,102,232,832,888,278,0.08747855917667238,0.19897084048027444,0.7135506003430532,0.7615780445969125,0.23842195540308747
2735,668,474,194,547,121,0.7095808383233533,0.2904191616766467,0.8188622754491018,0.18113772455089822,1009,185,344,480,879,130,0.18334985133795836,0.3409316154608523,0.4757185332011893,0.8711595639246779,0.1288404360753221
2736,1146,874,272,935,211,0.7626527050610821,0.23734729493891799,0.8158813263525305,0.18411867364746945,1284,231,412,641,1059,225,0.17990654205607476,0.32087227414330216,0.4992211838006231,0.8247663551401869,0.17523364485981308
2737,1565,1201,364,1285,280,0.7674121405750799,0.23258785942492013,0.8210862619808307,0.17891373801916932,1169,175,385,609,1024,145,0.1497005988023952,0.32934131736526945,0.5209580838323353,0.8759623609923011,0.12403763900769889
2738,341,208,133,298,43,0.6099706744868035,0.39002932551319647,0.873900293255132,0.12609970674486803,692,125,235,332,576,116,0.18063583815028902,0.33959537572254334,0.4797687861271676,0.8323699421965318,0.1676300578034682
2739,350,212,138,304,46,0.6057142857142858,0.3942857142857143,0.8685714285714285,0.13142857142857142,601,127,205,269,548,53,0.2113144758735441,0.3410981697171381,0.4475873544093178,0.9118136439267887,0.08818635607321132
2740,312,188,124,271,41,0.6025641025641025,0.3974358974358974,0.8685897435897436,0.13141025641025642,580,112,175,293,526,54,0.19310344827586207,0.3017241379310345,0.5051724137931034,0.906896551724138,0.09310344827586207
2741,1287,998,289,1078,209,0.7754467754467754,0.22455322455322455,0.8376068376068376,0.1623931623931624,1178,102,235,841,900,278,0.0865874363327674,0.199490662139219,0.7139219015280136,0.7640067911714771,0.23599320882852293
2742,92,44,48,33,59,0.4782608695652174,0.5217391304347826,0.358695652173913,0.6413043478260869,151,3,25,123,148,3,0.019867549668874173,0.16556291390728478,0.8145695364238411,0.9801324503311258,0.019867549668874173
2743,475,279,196,392,83,0.5873684210526315,0.4126315789473684,0.8252631578947368,0.17473684210526316,840,112,235,493,768,72,0.13333333333333333,0.27976190476190477,0.5869047619047619,0.9142857142857143,0.08571428571428572
2744,1283,998,285,1074,209,0.7778643803585347,0.2221356196414653,0.8371005455962588,0.16289945440374123,1168,102,231,835,890,278,0.08732876712328767,0.19777397260273974,0.7148972602739726,0.761986301369863,0.238013698630137
2745,426,232,194,287,139,0.5446009389671361,0.45539906103286387,0.6737089201877934,0.32629107981220656,603,146,166,291,593,10,0.24212271973466004,0.2752902155887231,0.48258706467661694,0.9834162520729685,0.01658374792703151
2746,561,371,190,442,119,0.661319073083779,0.33868092691622104,0.7878787878787878,0.21212121212121213,678,104,183,391,611,67,0.15339233038348082,0.26991150442477874,0.5766961651917404,0.9011799410029498,0.09882005899705015
2747,330,198,132,289,41,0.6,0.4,0.8757575757575757,0.12424242424242424,641,157,219,265,589,52,0.24492979719188768,0.3416536661466459,0.41341653666146644,0.9188767550702028,0.0811232449297972
2748,1276,1061,215,1118,158,0.8315047021943573,0.16849529780564262,0.8761755485893417,0.1238244514106583,1077,155,287,635,855,222,0.14391829155060354,0.26648096564531104,0.5896007428040855,0.7938718662952646,0.20612813370473537
2749,2662,2405,257,2257,405,0.9034560480841473,0.09654395191585274,0.8478587528174305,0.1521412471825695,1649,200,454,995,1355,294,0.1212856276531231,0.27531837477258947,0.6033959975742874,0.821710127349909,0.17828987265009097
2750,648,448,200,534,114,0.691358024691358,0.30864197530864196,0.8240740740740741,0.17592592592592593,1165,304,312,549,1098,67,0.2609442060085837,0.26781115879828327,0.47124463519313303,0.9424892703862661,0.05751072961373391
2751,320,186,134,280,40,0.58125,0.41875,0.875,0.125,649,150,231,268,597,52,0.23112480739599384,0.3559322033898305,0.41294298921417566,0.9198767334360555,0.08012326656394453
2752,558,373,185,459,99,0.6684587813620072,0.33154121863799285,0.8225806451612904,0.1774193548387097,933,192,241,500,866,67,0.2057877813504823,0.2583065380493033,0.5359056806002144,0.9281886387995713,0.07181136120042872
2753,530,314,216,427,103,0.5924528301886792,0.4075471698113208,0.8056603773584906,0.19433962264150945,843,104,241,498,772,71,0.12336892052194544,0.2858837485172005,0.5907473309608541,0.9157769869513642,0.08422301304863583
2754,342,226,116,288,54,0.6608187134502924,0.3391812865497076,0.8421052631578947,0.15789473684210525,631,174,187,270,622,9,0.2757527733755943,0.29635499207606975,0.42789223454833597,0.9857369255150554,0.014263074484944533
2755,165,104,61,65,100,0.6303030303030303,0.3696969696969697,0.3939393939393939,0.6060606060606061,73,0,51,22,72,1,0.0,0.6986301369863014,0.3013698630136986,0.9863013698630136,0.0136986301369863
2756,341,216,125,290,51,0.6334310850439883,0.36656891495601174,0.8504398826979472,0.1495601173020528,707,123,196,388,651,56,0.173974540311174,0.27722772277227725,0.5487977369165488,0.9207920792079208,0.07920792079207921
2757,341,210,131,298,43,0.6158357771260997,0.3841642228739003,0.873900293255132,0.12609970674486803,762,166,262,334,646,116,0.2178477690288714,0.3438320209973753,0.43832020997375326,0.847769028871391,0.15223097112860892
2758,1286,998,288,1077,209,0.776049766718507,0.223950233281493,0.8374805598755832,0.1625194401244168,1165,102,228,835,887,278,0.08755364806866953,0.19570815450643778,0.7167381974248928,0.76137339055794,0.23862660944206007
2759,435,287,148,363,72,0.6597701149425287,0.34022988505747126,0.8344827586206897,0.16551724137931034,360,35,97,228,354,6,0.09722222222222222,0.26944444444444443,0.6333333333333333,0.9833333333333333,0.016666666666666666
2760,809,536,273,606,203,0.6625463535228677,0.3374536464771323,0.7490729295426453,0.25092707045735474,1083,253,242,588,994,89,0.23361034164358263,0.2234533702677747,0.5429362880886427,0.9178208679593721,0.08217913204062789
2761,1246,1031,215,1090,156,0.8274478330658106,0.1725521669341894,0.8747993579454254,0.12520064205457465,1059,155,273,631,838,221,0.14636449480642116,0.2577903682719547,0.5958451369216242,0.7913125590179415,0.20868744098205855
2762,313,187,126,273,40,0.597444089456869,0.402555910543131,0.8722044728434505,0.12779552715654952,558,118,181,259,506,52,0.2114695340501792,0.32437275985663083,0.46415770609318996,0.9068100358422939,0.0931899641577061
2763,1256,1032,224,1099,157,0.821656050955414,0.17834394904458598,0.875,0.125,1076,149,298,629,855,221,0.13847583643122677,0.27695167286245354,0.5845724907063197,0.7946096654275093,0.2053903345724907
2764,569,390,179,471,98,0.6854130052724078,0.3145869947275923,0.827768014059754,0.17223198594024605,1076,232,299,545,947,129,0.21561338289962825,0.2778810408921933,0.5065055762081785,0.8801115241635687,0.11988847583643122
2765,568,389,179,476,92,0.6848591549295775,0.31514084507042256,0.8380281690140845,0.1619718309859155,1365,294,348,723,1140,225,0.2153846153846154,0.2549450549450549,0.5296703296703297,0.8351648351648352,0.16483516483516483
2766,106,55,51,46,60,0.5188679245283019,0.4811320754716981,0.4339622641509434,0.5660377358490566,165,3,46,116,164,1,0.01818181818181818,0.2787878787878788,0.703030303030303,0.9939393939393939,0.006060606060606061
2767,1293,1056,237,1132,161,0.8167053364269141,0.18329466357308585,0.8754833720030936,0.12451662799690642,1074,149,291,634,852,222,0.1387337057728119,0.2709497206703911,0.590316573556797,0.7932960893854749,0.20670391061452514
2768,1284,998,286,1075,209,0.7772585669781932,0.22274143302180685,0.8372274143302181,0.16277258566978192,1170,102,232,836,892,278,0.08717948717948718,0.19829059829059828,0.7145299145299145,0.7623931623931623,0.2376068376068376
2769,1678,1378,300,1398,280,0.8212157330154947,0.17878426698450536,0.833134684147795,0.16686531585220502,1403,226,439,738,1099,304,0.16108339272986458,0.31290092658588736,0.5260156806842481,0.7833214540270849,0.2166785459729152
2770,920,659,261,736,184,0.716304347826087,0.28369565217391307,0.8,0.2,1240,264,428,548,1111,129,0.2129032258064516,0.34516129032258064,0.44193548387096776,0.8959677419354839,0.10403225806451613
2771,1537,1282,255,1317,220,0.8340923877683799,0.16590761223162004,0.8568640208197787,0.14313597918022122,1199,175,327,697,973,226,0.14595496246872394,0.2727272727272727,0.5813177648040033,0.8115095913261051,0.1884904086738949
2772,404,225,179,329,75,0.556930693069307,0.4430693069306931,0.8143564356435643,0.18564356435643564,623,107,158,358,554,69,0.17174959871589085,0.2536115569823435,0.5746388443017657,0.8892455858747994,0.11075441412520064
2773,324,197,127,283,41,0.6080246913580247,0.39197530864197533,0.8734567901234568,0.12654320987654322,745,132,202,411,686,59,0.17718120805369128,0.27114093959731544,0.5516778523489932,0.9208053691275168,0.07919463087248323
2774,1162,880,282,904,258,0.7573149741824441,0.24268502581755594,0.7779690189328744,0.22203098106712565,1156,102,230,824,878,278,0.08823529411764706,0.19896193771626297,0.71280276816609,0.759515570934256,0.24048442906574394
2775,345,217,128,300,45,0.6289855072463768,0.3710144927536232,0.8695652173913043,0.13043478260869565,776,161,255,360,658,118,0.20747422680412372,0.3286082474226804,0.4639175257731959,0.8479381443298969,0.15206185567010308
2776,388,208,180,294,94,0.5360824742268041,0.4639175257731959,0.7577319587628866,0.2422680412371134,567,88,144,335,501,66,0.15520282186948853,0.25396825396825395,0.5908289241622575,0.8835978835978836,0.1164021164021164
2777,335,214,121,291,44,0.6388059701492538,0.3611940298507463,0.8686567164179104,0.13134328358208955,723,151,229,343,605,118,0.20885200553250347,0.31673582295988933,0.47441217150760717,0.8367911479944675,0.1632088520055325
2778,1283,998,285,1074,209,0.7778643803585347,0.2221356196414653,0.8371005455962588,0.16289945440374123,1165,102,229,834,887,278,0.08755364806866953,0.1965665236051502,0.7158798283261802,0.76137339055794,0.23862660944206007
2779,383,249,134,338,45,0.6501305483028721,0.34986945169712796,0.8825065274151436,0.1174934725848564,741,132,242,367,622,119,0.17813765182186234,0.3265856950067476,0.49527665317139,0.8394062078272605,0.16059379217273953
2780,1426,1186,240,1220,206,0.8316970546984572,0.16830294530154277,0.8555399719495091,0.14446002805049088,1154,163,313,678,929,225,0.1412478336221837,0.27123050259965337,0.587521663778163,0.8050259965337955,0.1949740034662045
2781,1248,1032,216,1091,157,0.8269230769230769,0.17307692307692307,0.874198717948718,0.12580128205128205,1050,149,274,627,828,222,0.1419047619047619,0.26095238095238094,0.5971428571428572,0.7885714285714286,0.21142857142857144
2782,1236,880,356,978,258,0.7119741100323624,0.28802588996763756,0.7912621359223301,0.2087378640776699,1226,102,251,873,948,278,0.08319738988580751,0.20473083197389885,0.7120717781402937,0.7732463295269169,0.2267536704730832
2783,421,226,195,321,100,0.5368171021377672,0.46318289786223277,0.7624703087885986,0.2375296912114014,603,101,160,342,536,67,0.16749585406301823,0.26533996683250416,0.5671641791044776,0.8888888888888888,0.1111111111111111
2784,839,575,264,676,163,0.6853396901072706,0.3146603098927294,0.8057210965435042,0.19427890345649582,1083,103,207,773,856,227,0.0951061865189289,0.19113573407202217,0.7137580794090489,0.7903970452446907,0.20960295475530932
2785,1199,931,268,996,203,0.7764804003336113,0.22351959966638865,0.8306922435362802,0.16930775646371976,1169,168,372,629,942,227,0.1437125748502994,0.31822070145423437,0.5380667236954663,0.8058169375534645,0.1941830624465355
2786,1293,998,295,1084,209,0.7718484145398299,0.22815158546017014,0.8383604021655066,0.16163959783449341,1179,102,235,842,901,278,0.08651399491094147,0.1993214588634436,0.714164546225615,0.7642069550466497,0.2357930449533503
2787,1251,1033,218,1095,156,0.8257394084732215,0.17426059152677859,0.8752997601918465,0.12470023980815348,1089,155,293,641,867,222,0.1423324150596878,0.26905417814508725,0.588613406795225,0.7961432506887053,0.20385674931129477
2788,832,624,208,742,90,0.75,0.25,0.8918269230769231,0.10817307692307693,965,137,239,589,764,201,0.14196891191709846,0.24766839378238342,0.6103626943005181,0.7917098445595855,0.20829015544041452
2789,837,581,256,685,152,0.6941457586618877,0.3058542413381123,0.8183990442054958,0.1816009557945042,1009,101,216,692,829,180,0.10009910802775025,0.21407333994053518,0.6858275520317145,0.821605550049554,0.17839444995044598
2790,1249,1031,218,1092,157,0.8254603682946358,0.1745396317053643,0.8742994395516414,0.1257005604483587,1054,149,272,633,833,221,0.1413662239089184,0.25806451612903225,0.6005692599620494,0.7903225806451613,0.20967741935483872
2791,1243,1031,212,1087,156,0.829444891391794,0.17055510860820594,0.8744971842316975,0.1255028157683025,1056,155,272,629,835,221,0.14678030303030304,0.25757575757575757,0.5956439393939394,0.790719696969697,0.20928030303030304
2792,572,362,210,453,119,0.6328671328671329,0.36713286713286714,0.791958041958042,0.20804195804195805,797,123,230,444,723,74,0.15432873274780426,0.28858218318695106,0.5570890840652447,0.9071518193224593,0.09284818067754078
2793,461,283,178,380,81,0.613882863340564,0.38611713665943603,0.824295010845987,0.175704989154013,883,115,230,538,810,73,0.13023782559456398,0.26047565118912797,0.609286523216308,0.9173272933182333,0.08267270668176671
2794,570,340,230,441,129,0.5964912280701754,0.40350877192982454,0.7736842105263158,0.22631578947368422,720,100,224,396,650,70,0.1388888888888889,0.3111111111111111,0.55,0.9027777777777778,0.09722222222222222
2795,314,184,130,273,41,0.5859872611464968,0.4140127388535032,0.8694267515923567,0.1305732484076433,648,145,204,299,594,54,0.22376543209876543,0.3148148148148148,0.46141975308641975,0.9166666666666666,0.08333333333333333
2796,328,162,166,273,55,0.49390243902439024,0.5060975609756098,0.8323170731707317,0.1676829268292683,704,103,170,431,635,69,0.14630681818181818,0.24147727272727273,0.6122159090909091,0.9019886363636364,0.09801136363636363
2797,710,426,284,502,208,0.6,0.4,0.7070422535211267,0.29295774647887324,1044,159,254,631,914,130,0.15229885057471265,0.24329501915708812,0.6044061302681992,0.8754789272030651,0.12452107279693486
2798,577,354,223,459,118,0.6135181975736569,0.38648180242634317,0.7954939341421143,0.2045060658578856,815,118,259,438,743,72,0.14478527607361963,0.3177914110429448,0.5374233128834356,0.9116564417177914,0.08834355828220859
2799,469,284,185,389,80,0.605543710021322,0.39445628997867804,0.8294243070362474,0.17057569296375266,824,95,216,513,751,73,0.11529126213592233,0.2621359223300971,0.6225728155339806,0.9114077669902912,0.08859223300970874
2800,1258,1033,225,1100,158,0.8211446740858506,0.17885532591414943,0.8744038155802861,0.12559618441971382,1062,155,284,623,841,221,0.14595103578154425,0.2674199623352166,0.5866290018832392,0.7919020715630886,0.2080979284369115
2801,1169,880,289,911,258,0.7527801539777588,0.24721984602224123,0.7792985457656116,0.22070145423438836,1167,102,234,831,889,278,0.08740359897172237,0.20051413881748073,0.712082262210797,0.7617823479005998,0.23821765209940018
2802,595,409,186,494,101,0.6873949579831933,0.3126050420168067,0.8302521008403362,0.16974789915966387,1252,236,311,705,1026,226,0.18849840255591055,0.24840255591054314,0.5630990415335463,0.8194888178913738,0.1805111821086262
2803,1257,1031,226,1101,156,0.8202068416865553,0.17979315831344472,0.8758949880668258,0.12410501193317422,1098,155,316,627,877,221,0.14116575591985428,0.2877959927140255,0.5710382513661202,0.7987249544626593,0.20127504553734063
2804,566,397,169,470,96,0.7014134275618374,0.29858657243816256,0.8303886925795053,0.1696113074204947,1428,339,350,739,1200,228,0.23739495798319327,0.24509803921568626,0.5175070028011205,0.8403361344537815,0.15966386554621848
2805,413,99,314,311,102,0.2397094430992736,0.7602905569007264,0.7530266343825666,0.2469733656174334,529,0,271,258,529,0,0.0,0.5122873345935728,0.4877126654064272,1.0,0.0
2806,302,189,113,262,40,0.6258278145695364,0.3741721854304636,0.8675496688741722,0.13245033112582782,678,126,176,376,621,57,0.18584070796460178,0.25958702064896755,0.5545722713864307,0.915929203539823,0.084070796460177
2807,439,302,137,339,100,0.6879271070615034,0.3120728929384966,0.7722095671981777,0.22779043280182232,594,177,249,168,588,6,0.29797979797979796,0.41919191919191917,0.2828282828282828,0.98989898989899,0.010101010101010102
2808,1255,1034,221,1096,159,0.8239043824701195,0.17609561752988048,0.8733067729083666,0.12669322709163347,1050,156,268,626,828,222,0.14857142857142858,0.25523809523809526,0.5961904761904762,0.7885714285714286,0.21142857142857144
2809,1261,1035,226,1103,158,0.8207771609833465,0.17922283901665345,0.8747026169706582,0.1252973830293418,1091,149,313,629,870,221,0.13657195233730524,0.28689275893675525,0.5765352887259395,0.7974335472043996,0.20256645279560037
2810,1256,1034,222,1097,159,0.8232484076433121,0.1767515923566879,0.8734076433121019,0.1265923566878981,1075,155,285,635,853,222,0.14418604651162792,0.2651162790697674,0.5906976744186047,0.7934883720930233,0.20651162790697675
2811,423,293,130,321,102,0.6926713947990544,0.3073286052009456,0.7588652482269503,0.24113475177304963,861,128,235,498,737,124,0.148664343786295,0.27293844367015097,0.578397212543554,0.8559814169570267,0.1440185830429733
2812,560,381,179,457,103,0.6803571428571429,0.3196428571428571,0.8160714285714286,0.18392857142857144,1043,284,286,473,979,64,0.2722914669223394,0.274209012464046,0.4534995206136146,0.9386385426653883,0.061361457334611694
2813,698,491,207,564,134,0.7034383954154728,0.29656160458452724,0.8080229226361032,0.19197707736389685,890,125,353,412,821,69,0.1404494382022472,0.39662921348314606,0.46292134831460674,0.9224719101123595,0.07752808988764046
2814,447,258,189,346,101,0.5771812080536913,0.4228187919463087,0.7740492170022372,0.22595078299776286,585,96,151,338,519,66,0.1641025641025641,0.25811965811965815,0.5777777777777777,0.8871794871794871,0.11282051282051282
2815,581,415,166,483,98,0.7142857142857143,0.2857142857142857,0.8313253012048193,0.1686746987951807,1187,277,320,590,1056,131,0.2333614153327717,0.2695871946082561,0.4970513900589722,0.8896377422072451,0.11036225779275484
2816,178,67,111,165,13,0.37640449438202245,0.6235955056179775,0.9269662921348315,0.07303370786516854,1341,133,163,1045,1085,256,0.09917971662938106,0.1215510812826249,0.779269202087994,0.8090976882923192,0.19090231170768082
2817,1286,998,288,1077,209,0.776049766718507,0.223950233281493,0.8374805598755832,0.1625194401244168,1172,102,232,838,894,278,0.08703071672354949,0.19795221843003413,0.7150170648464164,0.7627986348122867,0.23720136518771331
2818,1373,1091,282,1119,254,0.7946103423160962,0.20538965768390385,0.8150036416605972,0.18499635833940276,1474,292,457,725,1211,263,0.19810040705563092,0.3100407055630936,0.4918588873812754,0.8215739484396201,0.1784260515603799
2819,343,212,131,299,44,0.6180758017492711,0.3819241982507289,0.8717201166180758,0.1282798833819242,707,131,235,341,591,116,0.18528995756718528,0.3323903818953324,0.4823196605374823,0.8359264497878359,0.16407355021216408
2820,334,211,123,291,43,0.6317365269461078,0.36826347305389223,0.8712574850299402,0.12874251497005987,687,132,227,328,569,118,0.19213973799126638,0.3304221251819505,0.4774381368267831,0.8282387190684134,0.1717612809315866
2821,692,501,191,561,131,0.7239884393063584,0.27601156069364163,0.8106936416184971,0.1893063583815029,739,99,290,350,673,66,0.13396481732070364,0.39242219215155616,0.4736129905277402,0.9106901217861976,0.08930987821380243
2822,495,325,170,421,74,0.6565656565656566,0.3434343434343434,0.8505050505050505,0.1494949494949495,473,34,115,324,466,7,0.07188160676532769,0.24312896405919662,0.6849894291754757,0.985200845665962,0.014799154334038054
2823,548,351,197,425,123,0.6405109489051095,0.3594890510948905,0.7755474452554745,0.22445255474452555,735,122,208,405,662,73,0.16598639455782313,0.2829931972789116,0.5510204081632653,0.9006802721088435,0.09931972789115646
2824,571,345,226,445,126,0.6042031523642732,0.3957968476357268,0.7793345008756567,0.22066549912434325,806,111,245,450,730,76,0.13771712158808933,0.303970223325062,0.5583126550868487,0.9057071960297767,0.09429280397022333
2825,800,561,239,644,156,0.70125,0.29875,0.805,0.195,1199,243,399,557,1067,132,0.20266889074228525,0.3327773144286906,0.4645537948290242,0.8899082568807339,0.11009174311926606
2826,574,344,230,450,124,0.5993031358885017,0.40069686411149824,0.7839721254355401,0.21602787456445993,769,103,239,427,695,74,0.13394018205461639,0.3107932379713914,0.5552665799739922,0.9037711313394018,0.09622886866059818
2827,1518,1189,329,1284,234,0.7832674571805006,0.21673254281949933,0.8458498023715415,0.1541501976284585,1167,177,387,603,1029,138,0.15167095115681234,0.33161953727506427,0.5167095115681234,0.8817480719794345,0.11825192802056556
2828,338,221,117,296,42,0.6538461538461539,0.34615384615384615,0.8757396449704142,0.1242603550295858,853,151,236,466,730,123,0.17702227432590856,0.27667057444314186,0.5463071512309496,0.8558030480656507,0.14419695193434937
2829,484,303,181,406,78,0.6260330578512396,0.3739669421487603,0.8388429752066116,0.16115702479338842,644,107,163,374,577,67,0.16614906832298137,0.2531055900621118,0.5807453416149069,0.8959627329192547,0.10403726708074534
2830,311,187,124,270,41,0.6012861736334405,0.3987138263665595,0.8681672025723473,0.13183279742765272,709,113,185,411,651,58,0.15937940761636107,0.2609308885754584,0.5796897038081805,0.918194640338505,0.08180535966149506
2831,561,345,216,440,121,0.6149732620320856,0.3850267379679144,0.7843137254901961,0.21568627450980393,778,114,241,423,706,72,0.14652956298200515,0.3097686375321337,0.5437017994858612,0.9074550128534704,0.09254498714652956
2832,591,373,218,455,136,0.6311336717428088,0.3688663282571912,0.7698815566835872,0.23011844331641285,992,153,217,622,830,162,0.15423387096774194,0.21875,0.6270161290322581,0.8366935483870968,0.16330645161290322
2833,580,345,235,455,125,0.5948275862068966,0.4051724137931034,0.7844827586206896,0.21551724137931033,797,115,248,434,726,71,0.14429109159347553,0.3111668757841907,0.5445420326223338,0.9109159347553325,0.0890840652446675
2834,653,462,191,538,115,0.7075038284839203,0.29249617151607965,0.8238897396630934,0.17611026033690658,1154,213,275,666,1008,146,0.18457538994800693,0.23830155979202772,0.5771230502599654,0.8734835355285961,0.1265164644714038
2835,1261,1033,228,1104,157,0.8191911181601903,0.18080888183980967,0.8754956383822363,0.12450436161776368,1078,149,286,643,856,222,0.13821892393320964,0.2653061224489796,0.5964749536178108,0.7940630797773655,0.20593692022263452
2836,1285,998,287,1076,209,0.7766536964980545,0.22334630350194554,0.8373540856031129,0.16264591439688716,1166,102,229,835,888,278,0.08747855917667238,0.19639794168096056,0.7161234991423671,0.7615780445969125,0.23842195540308747
2837,576,355,221,448,128,0.6163194444444444,0.3836805555555556,0.7777777777777778,0.2222222222222222,786,117,240,429,713,73,0.14885496183206107,0.3053435114503817,0.5458015267175572,0.9071246819338422,0.09287531806615776
2838,381,206,175,291,90,0.5406824146981627,0.45931758530183725,0.7637795275590551,0.23622047244094488,604,108,157,339,537,67,0.17880794701986755,0.2599337748344371,0.5612582781456954,0.8890728476821192,0.11092715231788079
2839,660,440,220,516,144,0.6666666666666666,0.3333333333333333,0.7818181818181819,0.21818181818181817,1230,305,343,582,1101,129,0.24796747967479674,0.2788617886178862,0.47317073170731705,0.8951219512195122,0.1048780487804878
2840,1291,998,293,1082,209,0.7730441518202944,0.22695584817970565,0.8381099922540666,0.16189000774593337,1175,102,233,840,897,278,0.08680851063829788,0.19829787234042554,0.7148936170212766,0.7634042553191489,0.23659574468085107
2841,322,188,134,280,42,0.5838509316770186,0.4161490683229814,0.8695652173913043,0.13043478260869565,734,121,208,405,675,59,0.164850136239782,0.28337874659400547,0.5517711171662125,0.9196185286103542,0.08038147138964577
2842,889,645,244,732,157,0.7255343082114736,0.2744656917885264,0.8233970753655793,0.1766029246344207,804,181,235,388,775,29,0.22512437810945274,0.2922885572139303,0.48258706467661694,0.9639303482587065,0.036069651741293535
2843,1257,1039,218,1096,161,0.8265712012728719,0.17342879872712808,0.8719172633253779,0.1280827366746221,1058,155,269,634,835,223,0.14650283553875237,0.2542533081285444,0.5992438563327032,0.7892249527410208,0.2107750472589792
2844,451,280,171,371,80,0.6208425720620843,0.37915742793791574,0.8226164079822617,0.17738359201773837,771,108,198,465,699,72,0.14007782101167315,0.25680933852140075,0.603112840466926,0.9066147859922179,0.0933852140077821
2845,1283,1057,226,1123,160,0.8238503507404521,0.17614964925954793,0.8752922837100545,0.12470771628994544,1081,155,285,641,860,221,0.14338575393154487,0.26364477335800185,0.5929694727104533,0.7955596669750231,0.20444033302497688
2846,380,201,179,291,89,0.5289473684210526,0.4710526315789474,0.7657894736842106,0.23421052631578948,606,105,153,348,532,74,0.17326732673267325,0.2524752475247525,0.5742574257425742,0.8778877887788779,0.12211221122112212
2847,346,224,122,289,57,0.6473988439306358,0.35260115606936415,0.8352601156069365,0.16473988439306358,749,217,222,310,737,12,0.2897196261682243,0.2963951935914553,0.41388518024032045,0.9839786381842457,0.01602136181575434
2848,565,388,177,467,98,0.6867256637168142,0.31327433628318585,0.8265486725663717,0.17345132743362832,1067,274,287,506,1004,63,0.25679475164011245,0.2689784442361762,0.4742268041237113,0.9409559512652296,0.059044048734770385
2849,566,377,189,459,107,0.666077738515901,0.3339222614840989,0.8109540636042403,0.18904593639575973,1119,210,258,651,956,163,0.1876675603217158,0.23056300268096513,0.5817694369973191,0.8543342269883825,0.1456657730116175
2850,589,416,173,494,95,0.7062818336162988,0.2937181663837012,0.8387096774193549,0.16129032258064516,1472,360,372,740,1243,229,0.24456521739130435,0.25271739130434784,0.5027173913043478,0.8444293478260869,0.15557065217391305
2851,1807,1476,331,1488,319,0.8168234643054787,0.1831765356945213,0.823464305478694,0.17653569452130602,1384,287,500,597,1233,151,0.2073699421965318,0.36127167630057805,0.4313583815028902,0.8908959537572254,0.10910404624277456
2852,1287,998,289,1078,209,0.7754467754467754,0.22455322455322455,0.8376068376068376,0.1623931623931624,1166,102,227,837,888,278,0.08747855917667238,0.1946826758147513,0.7178387650085764,0.7615780445969125,0.23842195540308747
2853,584,360,224,459,125,0.6164383561643836,0.3835616438356164,0.785958904109589,0.21404109589041095,788,114,248,426,717,71,0.1446700507614213,0.3147208121827411,0.5406091370558376,0.9098984771573604,0.0901015228426396
2854,1254,1034,220,1097,157,0.8245614035087719,0.17543859649122806,0.8748006379585327,0.1251993620414673,1053,149,269,635,832,221,0.14150047483380818,0.25546058879392214,0.6030389363722697,0.7901234567901234,0.20987654320987653
2855,308,186,122,268,40,0.6038961038961039,0.3961038961038961,0.8701298701298701,0.12987012987012986,742,118,185,439,681,61,0.15902964959568733,0.24932614555256064,0.5916442048517521,0.9177897574123989,0.08221024258760108
2856,399,254,145,315,84,0.6365914786967418,0.3634085213032581,0.7894736842105263,0.21052631578947367,690,222,211,257,679,11,0.3217391304347826,0.30579710144927535,0.372463768115942,0.9840579710144928,0.015942028985507246
2857,1286,998,288,1077,209,0.776049766718507,0.223950233281493,0.8374805598755832,0.1625194401244168,1174,102,234,838,896,278,0.0868824531516184,0.19931856899488926,0.7137989778534923,0.7632027257240205,0.23679727427597955
2858,154,34,120,147,7,0.22077922077922077,0.7792207792207793,0.9545454545454546,0.045454545454545456,498,107,153,238,448,50,0.21485943775100402,0.3072289156626506,0.4779116465863454,0.8995983935742972,0.10040160642570281
2859,3053,2612,441,2613,440,0.8555519161480512,0.1444480838519489,0.8558794628234524,0.14412053717654766,1840,199,494,1147,1431,409,0.10815217391304348,0.2684782608695652,0.6233695652173913,0.7777173913043478,0.22228260869565217
2860,232,64,168,145,87,0.27586206896551724,0.7241379310344828,0.625,0.375,493,114,236,143,493,0,0.23123732251521298,0.4787018255578093,0.29006085192697767,1.0,0.0
2861,791,548,243,664,127,0.6927939317319848,0.30720606826801516,0.8394437420986094,0.16055625790139064,887,100,210,577,781,106,0.11273957158962795,0.23675310033821872,0.6505073280721533,0.8804960541149943,0.11950394588500564
2862,599,410,189,492,107,0.6844741235392321,0.31552587646076796,0.8213689482470785,0.17863105175292154,1122,243,306,573,992,130,0.21657754010695188,0.2727272727272727,0.5106951871657754,0.8841354723707665,0.11586452762923351
2863,526,320,206,414,112,0.6083650190114068,0.3916349809885932,0.7870722433460076,0.21292775665399238,630,107,163,360,562,68,0.16984126984126985,0.25873015873015875,0.5714285714285714,0.8920634920634921,0.10793650793650794
2864,382,246,136,338,44,0.643979057591623,0.35602094240837695,0.8848167539267016,0.11518324607329843,721,130,246,345,605,116,0.18030513176144244,0.34119278779472956,0.478502080443828,0.8391123439667129,0.1608876560332871
2865,1146,865,281,928,218,0.7547993019197208,0.24520069808027922,0.8097731239092496,0.19022687609075042,1109,202,378,529,976,133,0.18214607754733994,0.3408476104598738,0.4770063119927863,0.8800721370604148,0.11992786293958521
2866,1987,1583,404,1703,284,0.7966784096628082,0.20332159033719174,0.8570709612481128,0.14292903875188726,1711,162,296,1253,1291,420,0.09468147282291058,0.17299824663939217,0.7323202805376973,0.7545295149035651,0.24547048509643482
2867,704,502,202,574,130,0.7130681818181818,0.2869318181818182,0.8153409090909091,0.1846590909090909,822,127,296,399,753,69,0.15450121654501217,0.36009732360097324,0.4854014598540146,0.916058394160584,0.08394160583941605
2868,910,681,229,729,181,0.7483516483516484,0.25164835164835164,0.8010989010989011,0.1989010989010989,789,103,320,366,722,67,0.13054499366286437,0.4055766793409379,0.46387832699619774,0.9150823827629911,0.08491761723700887
2869,1286,998,288,1077,209,0.776049766718507,0.223950233281493,0.8374805598755832,0.1625194401244168,1171,102,232,837,893,278,0.08710503842869342,0.1981212638770282,0.7147736976942783,0.762596071733561,0.23740392826643894
2870,311,190,121,270,41,0.6109324758842444,0.3890675241157556,0.8681672025723473,0.13183279742765272,669,187,216,266,616,53,0.2795216741405082,0.32286995515695066,0.3976083707025411,0.9207772795216741,0.07922272047832586
2871,509,293,216,405,104,0.5756385068762279,0.4243614931237721,0.7956777996070727,0.2043222003929273,775,116,248,411,702,73,0.14967741935483872,0.32,0.5303225806451612,0.9058064516129032,0.09419354838709677
2872,1196,928,268,949,247,0.7759197324414716,0.22408026755852842,0.7934782608695652,0.20652173913043478,1168,189,370,609,1006,162,0.1618150684931507,0.3167808219178082,0.521404109589041,0.8613013698630136,0.1386986301369863
2873,629,436,193,514,115,0.6931637519872814,0.3068362480127186,0.8171701112877583,0.18282988871224165,1349,340,342,667,1213,136,0.2520385470719051,0.2535211267605634,0.49444032616753153,0.899184581171238,0.10081541882876205
2874,323,193,130,282,41,0.5975232198142415,0.4024767801857585,0.8730650154798761,0.12693498452012383,598,130,199,269,545,53,0.21739130434782608,0.33277591973244147,0.4498327759197324,0.9113712374581939,0.08862876254180602
2875,1252,1032,220,1095,157,0.8242811501597445,0.1757188498402556,0.8746006389776357,0.1253993610223642,1058,149,268,641,834,224,0.14083175803402648,0.2533081285444234,0.6058601134215501,0.7882797731568998,0.21172022684310018
2876,1346,1070,276,1108,238,0.7949479940564635,0.2050520059435364,0.8231797919762258,0.17682020802377416,1189,187,390,612,963,226,0.15727502102607233,0.3280067283431455,0.5147182506307821,0.8099243061396131,0.1900756938603869
2877,799,558,241,655,144,0.6983729662077597,0.3016270337922403,0.8197747183979975,0.1802252816020025,1070,98,210,762,843,227,0.09158878504672897,0.19626168224299065,0.7121495327102804,0.7878504672897196,0.21214953271028036
2878,469,278,191,387,82,0.5927505330490405,0.4072494669509595,0.8251599147121536,0.17484008528784648,955,100,229,626,787,168,0.10471204188481675,0.23979057591623038,0.6554973821989529,0.8240837696335078,0.17591623036649215
2879,308,192,116,268,40,0.6233766233766234,0.37662337662337664,0.8701298701298701,0.12987012987012986,560,130,179,251,507,53,0.23214285714285715,0.3196428571428571,0.44821428571428573,0.9053571428571429,0.09464285714285714
2880,966,679,287,766,200,0.7028985507246377,0.2971014492753623,0.7929606625258799,0.2070393374741201,1245,234,424,587,1100,145,0.18795180722891566,0.3405622489959839,0.4714859437751004,0.8835341365461847,0.11646586345381527
2881,385,249,136,338,47,0.6467532467532467,0.35324675324675325,0.8779220779220779,0.12207792207792208,746,121,249,376,627,119,0.16219839142091153,0.33378016085790885,0.5040214477211796,0.8404825737265416,0.15951742627345844
2882,1560,1305,255,1339,221,0.8365384615384616,0.16346153846153846,0.8583333333333333,0.14166666666666666,1204,181,331,692,978,226,0.15033222591362128,0.2749169435215947,0.574750830564784,0.8122923588039868,0.1877076411960133
2883,368,238,130,325,43,0.6467391304347826,0.3532608695652174,0.8831521739130435,0.11684782608695653,890,165,262,463,770,120,0.1853932584269663,0.2943820224719101,0.5202247191011236,0.8651685393258427,0.1348314606741573
2884,467,295,172,386,81,0.6316916488222698,0.3683083511777302,0.8265524625267666,0.1734475374732334,922,104,194,624,753,169,0.11279826464208242,0.210412147505423,0.6767895878524945,0.8167028199566161,0.18329718004338394
2885,551,331,220,430,121,0.6007259528130672,0.3992740471869328,0.7803992740471869,0.21960072595281308,735,101,232,402,663,72,0.13741496598639455,0.31564625850340133,0.5469387755102041,0.9020408163265307,0.09795918367346938
2886,1444,1234,210,1262,182,0.8545706371191135,0.14542936288088643,0.8739612188365651,0.1260387811634349,1055,149,276,630,834,221,0.14123222748815165,0.2616113744075829,0.5971563981042654,0.790521327014218,0.209478672985782
2887,238,114,124,209,29,0.4789915966386555,0.5210084033613446,0.8781512605042017,0.12184873949579832,626,78,123,425,426,200,0.12460063897763578,0.1964856230031949,0.6789137380191693,0.6805111821086262,0.3194888178913738
2888,1504,1255,249,1289,215,0.8344414893617021,0.16555851063829788,0.8570478723404256,0.14295212765957446,1183,175,325,683,957,226,0.14792899408284024,0.27472527472527475,0.577345731191885,0.8089602704987321,0.19103972950126796
2889,1284,998,286,1075,209,0.7772585669781932,0.22274143302180685,0.8372274143302181,0.16277258566978192,1164,102,228,834,886,278,0.08762886597938144,0.1958762886597938,0.7164948453608248,0.761168384879725,0.23883161512027493
2890,494,291,203,387,107,0.5890688259109311,0.4109311740890688,0.7834008097165992,0.2165991902834008,711,97,221,393,641,70,0.13642756680731363,0.3108298171589311,0.5527426160337553,0.9015471167369902,0.09845288326300984
2891,164,44,120,156,8,0.2682926829268293,0.7317073170731707,0.9512195121951219,0.04878048780487805,569,152,173,244,519,50,0.2671353251318102,0.30404217926186294,0.4288224956063269,0.9121265377855887,0.08787346221441125
2892,1548,1292,256,1326,222,0.834625322997416,0.165374677002584,0.8565891472868217,0.1434108527131783,1200,175,330,695,975,225,0.14583333333333334,0.275,0.5791666666666667,0.8125,0.1875
2893,409,278,131,310,99,0.6797066014669927,0.3202933985330073,0.7579462102689487,0.24205378973105135,595,175,208,212,587,8,0.29411764705882354,0.3495798319327731,0.3563025210084034,0.9865546218487395,0.013445378151260505
2894,584,402,182,484,100,0.6883561643835616,0.3116438356164384,0.8287671232876712,0.17123287671232876,1256,235,305,716,1021,235,0.18710191082802546,0.2428343949044586,0.5700636942675159,0.8128980891719745,0.18710191082802546
2895,411,264,147,353,58,0.6423357664233577,0.35766423357664234,0.8588807785888077,0.1411192214111922,854,180,229,445,795,59,0.2107728337236534,0.2681498829039813,0.5210772833723654,0.9309133489461359,0.06908665105386416
2896,1242,1031,211,1086,156,0.8301127214170693,0.16988727858293076,0.8743961352657005,0.12560386473429952,1055,155,268,632,834,221,0.14691943127962084,0.25402843601895736,0.5990521327014218,0.790521327014218,0.209478672985782
2897,347,214,133,303,44,0.6167146974063401,0.38328530259365995,0.8731988472622478,0.12680115273775217,696,115,230,351,578,118,0.16522988505747127,0.33045977011494254,0.5043103448275862,0.8304597701149425,0.16954022988505746
2898,1284,998,286,1075,209,0.7772585669781932,0.22274143302180685,0.8372274143302181,0.16277258566978192,1167,102,230,835,889,278,0.08740359897172237,0.19708654670094258,0.715509854327335,0.7617823479005998,0.23821765209940018
2899,382,196,186,285,97,0.5130890052356021,0.4869109947643979,0.7460732984293194,0.25392670157068065,556,85,143,328,489,67,0.1528776978417266,0.25719424460431656,0.5899280575539568,0.8794964028776978,0.12050359712230216
2900,494,303,191,411,83,0.6133603238866396,0.3866396761133603,0.8319838056680162,0.1680161943319838,849,107,237,505,780,69,0.12603062426383982,0.2791519434628975,0.5948174322732627,0.9187279151943463,0.0812720848056537
2901,1282,998,284,1073,209,0.7784711388455539,0.22152886115444617,0.8369734789391575,0.16302652106084242,1166,102,230,834,888,278,0.08747855917667238,0.19725557461406518,0.7152658662092625,0.7615780445969125,0.23842195540308747
2902,1300,1001,299,1089,211,0.77,0.23,0.8376923076923077,0.16230769230769232,1182,102,236,844,904,278,0.08629441624365482,0.1996615905245347,0.7140439932318104,0.7648054145516074,0.23519458544839256
2903,353,213,140,309,44,0.603399433427762,0.39660056657223797,0.8753541076487252,0.12464589235127478,727,123,246,358,611,116,0.16918844566712518,0.33837689133425036,0.4924346629986245,0.8404401650618982,0.15955983493810177
2904,366,230,136,317,49,0.6284153005464481,0.37158469945355194,0.8661202185792349,0.13387978142076504,722,130,234,358,605,117,0.18005540166204986,0.32409972299168976,0.49584487534626037,0.8379501385041551,0.16204986149584488
2905,354,235,119,308,46,0.6638418079096046,0.3361581920903955,0.8700564971751412,0.12994350282485875,1024,139,228,657,851,173,0.1357421875,0.22265625,0.6416015625,0.8310546875,0.1689453125
2906,818,579,239,661,157,0.7078239608801956,0.2921760391198044,0.8080684596577017,0.19193154034229828,1099,101,209,789,872,227,0.09190172884440401,0.19017288444040037,0.7179253867151957,0.7934485896269335,0.20655141037306643
2907,5102,4478,624,4375,727,0.8776950215601724,0.12230497843982752,0.8575068600548804,0.14249313994511956,2238,236,551,1451,1768,470,0.10545129579982127,0.24620196604110814,0.6483467381590706,0.7899910634495085,0.21000893655049152
2908,442,300,142,341,101,0.6787330316742082,0.3212669683257919,0.7714932126696833,0.22850678733031674,545,139,211,195,537,8,0.25504587155963304,0.3871559633027523,0.3577981651376147,0.9853211009174312,0.014678899082568808
2909,760,527,233,591,169,0.6934210526315789,0.30657894736842106,0.7776315789473685,0.22236842105263158,848,116,318,414,780,68,0.13679245283018868,0.375,0.4882075471698113,0.9198113207547169,0.08018867924528301
2910,371,240,131,323,48,0.6469002695417789,0.353099730458221,0.8706199460916442,0.1293800539083558,675,132,221,322,559,116,0.19555555555555557,0.3274074074074074,0.47703703703703704,0.8281481481481482,0.17185185185185184
2911,883,620,263,705,178,0.7021517553793885,0.29784824462061155,0.79841449603624,0.2015855039637599,1146,210,391,545,1012,134,0.18324607329842932,0.3411867364746946,0.4755671902268761,0.8830715532286213,0.1169284467713787
2912,550,368,182,456,94,0.6690909090909091,0.33090909090909093,0.8290909090909091,0.1709090909090909,1001,220,259,522,935,66,0.21978021978021978,0.25874125874125875,0.5214785214785215,0.9340659340659341,0.06593406593406594
2913,576,351,225,450,126,0.609375,0.390625,0.78125,0.21875,796,124,259,413,726,70,0.15577889447236182,0.32537688442211055,0.5188442211055276,0.9120603015075377,0.08793969849246232
2914,216,105,111,122,94,0.4861111111111111,0.5138888888888888,0.5648148148148148,0.4351851851851852,166,0,108,58,166,0,0.0,0.6506024096385542,0.3493975903614458,1.0,0.0
2915,1252,1032,220,1095,157,0.8242811501597445,0.1757188498402556,0.8746006389776357,0.1253993610223642,1060,149,277,634,838,222,0.14056603773584905,0.26132075471698113,0.5981132075471698,0.7905660377358491,0.20943396226415095
2916,338,201,137,296,42,0.5946745562130178,0.40532544378698226,0.8757396449704142,0.1242603550295858,666,137,207,322,610,56,0.2057057057057057,0.3108108108108108,0.48348348348348347,0.9159159159159159,0.08408408408408409
2917,404,215,189,303,101,0.5321782178217822,0.46782178217821785,0.75,0.25,594,98,154,342,526,68,0.16498316498316498,0.25925925925925924,0.5757575757575758,0.8855218855218855,0.11447811447811448
2918,1106,855,251,919,187,0.7730560578661845,0.22694394213381555,0.8309222423146474,0.16907775768535263,1276,249,409,618,1040,236,0.195141065830721,0.32053291536050155,0.4843260188087774,0.8150470219435737,0.18495297805642633
2919,174,60,114,164,10,0.3448275862068966,0.6551724137931034,0.9425287356321839,0.05747126436781609,581,96,137,348,530,51,0.16523235800344235,0.23580034423407917,0.5989672977624785,0.9122203098106713,0.08777969018932874
2920,331,203,128,290,41,0.6132930513595166,0.3867069486404834,0.8761329305135952,0.12386706948640483,647,144,192,311,592,55,0.22256568778979907,0.29675425038639874,0.4806800618238022,0.9149922720247295,0.08500772797527048
2921,1213,922,291,994,219,0.7600989282769992,0.23990107172300082,0.8194558944765046,0.18054410552349548,1140,162,352,626,910,230,0.14210526315789473,0.3087719298245614,0.5491228070175439,0.7982456140350878,0.20175438596491227
2922,1544,1215,329,1288,256,0.7869170984455959,0.21308290155440415,0.8341968911917098,0.16580310880829016,1247,230,419,598,1109,138,0.18444266238973536,0.3360064153969527,0.47955092221331197,0.8893344025661588,0.11066559743384122
2923,3007,1973,1034,2403,604,0.6561356834053874,0.3438643165946126,0.7991353508480212,0.2008646491519787,3005,231,452,2322,2263,742,0.07687188019966722,0.15041597337770382,0.772712146422629,0.7530782029950083,0.24692179700499167
2924,826,551,275,665,161,0.6670702179176755,0.33292978208232443,0.8050847457627118,0.19491525423728814,846,115,274,457,775,71,0.1359338061465721,0.32387706855791965,0.5401891252955082,0.9160756501182034,0.08392434988179669
2925,494,295,199,395,99,0.597165991902834,0.402834008097166,0.7995951417004049,0.20040485829959515,839,102,207,530,764,75,0.12157330154946365,0.2467222884386174,0.6317044100119189,0.9106078665077473,0.08939213349225268
2926,1295,998,297,1086,209,0.7706563706563706,0.22934362934362934,0.8386100386100386,0.1613899613899614,1188,102,239,847,910,278,0.08585858585858586,0.20117845117845118,0.7129629629629629,0.765993265993266,0.234006734006734
2927,691,416,275,507,184,0.6020260492040521,0.3979739507959479,0.7337192474674384,0.2662807525325615,889,142,226,521,824,65,0.1597300337457818,0.2542182227221597,0.5860517435320585,0.9268841394825647,0.07311586051743532
2928,341,225,116,287,54,0.6598240469208211,0.34017595307917886,0.841642228739003,0.15835777126099707,626,152,180,294,615,11,0.24281150159744408,0.28753993610223644,0.4696485623003195,0.9824281150159745,0.01757188498402556
2929,335,213,122,291,44,0.6358208955223881,0.3641791044776119,0.8686567164179104,0.13134328358208955,656,109,219,328,540,116,0.16615853658536586,0.33384146341463417,0.5,0.823170731707317,0.17682926829268292
2930,771,536,235,597,174,0.695201037613489,0.30479896238651105,0.77431906614786,0.22568093385214008,806,111,293,402,737,69,0.13771712158808933,0.36352357320099254,0.4987593052109181,0.9143920595533499,0.08560794044665013
2931,5999,5355,644,5143,856,0.8926487747957993,0.1073512252042007,0.857309551591932,0.14269044840806802,1741,187,514,1040,1586,155,0.1074095347501436,0.2952326249282022,0.5973578403216542,0.9109707064905227,0.08902929350947732
2932,1291,998,293,1082,209,0.7730441518202944,0.22695584817970565,0.8381099922540666,0.16189000774593337,1172,102,231,839,894,278,0.08703071672354949,0.197098976109215,0.7158703071672355,0.7627986348122867,0.23720136518771331
2933,368,236,132,319,49,0.6413043478260869,0.358695652173913,0.8668478260869565,0.1331521739130435,638,129,194,315,584,54,0.20219435736677116,0.30407523510971785,0.493730407523511,0.9153605015673981,0.08463949843260188
2934,1167,878,289,912,255,0.7523564695801199,0.24764353041988005,0.781491002570694,0.2185089974293059,1165,102,232,831,887,278,0.08755364806866953,0.19914163090128756,0.7133047210300429,0.76137339055794,0.23862660944206007
2935,1268,1045,223,1111,157,0.8241324921135647,0.17586750788643532,0.8761829652996845,0.12381703470031545,1076,156,280,640,854,222,0.1449814126394052,0.26022304832713755,0.5947955390334573,0.7936802973977695,0.20631970260223048
2936,588,398,190,481,107,0.6768707482993197,0.3231292517006803,0.8180272108843537,0.18197278911564627,1203,298,336,569,1073,130,0.24771404821280132,0.2793017456359102,0.47298420615128844,0.8919368246051538,0.10806317539484622
2937,567,379,188,468,99,0.6684303350970018,0.3315696649029982,0.8253968253968254,0.1746031746031746,1064,245,269,550,996,68,0.23026315789473684,0.25281954887218044,0.5169172932330827,0.9360902255639098,0.06390977443609022
2938,5744,5038,706,4853,891,0.8770891364902507,0.12291086350974931,0.8448816155988857,0.1551183844011142,2383,229,613,1541,1900,483,0.0960973562736047,0.25723877465379774,0.6466638690725975,0.7973143096936635,0.20268569030633654
2939,1289,998,291,1080,209,0.7742435996896819,0.22575640031031807,0.8378588052754073,0.1621411947245927,1171,102,231,838,893,278,0.08710503842869342,0.19726729291204098,0.7156276686592656,0.762596071733561,0.23740392826643894
2940,1503,1253,250,1288,215,0.833666001330672,0.16633399866932802,0.8569527611443779,0.1430472388556221,1206,181,330,695,980,226,0.15008291873963517,0.2736318407960199,0.5762852404643449,0.8126036484245439,0.18739635157545606
2941,571,397,174,470,101,0.6952714535901926,0.30472854640980734,0.8231173380035026,0.17688266199649738,1293,267,303,723,1059,234,0.20649651972157773,0.23433874709976799,0.5591647331786543,0.8190255220417634,0.18097447795823665
2942,1519,1270,249,1301,218,0.8360763660302831,0.16392363396971693,0.8564845292955892,0.14351547070441079,1187,172,323,692,962,225,0.14490311710193765,0.2721145745577085,0.5829823083403538,0.81044650379107,0.18955349620893008
2943,1256,1035,221,1098,158,0.8240445859872612,0.17595541401273884,0.8742038216560509,0.12579617834394904,1077,155,284,638,855,222,0.14391829155060354,0.26369545032497677,0.5923862581244197,0.7938718662952646,0.20612813370473537
2944,857,640,217,765,92,0.7467911318553092,0.2532088681446908,0.8926487747957993,0.1073512252042007,969,136,248,585,768,201,0.14035087719298245,0.25593395252837975,0.6037151702786377,0.7925696594427245,0.20743034055727555
2945,420,236,184,325,95,0.5619047619047619,0.4380952380952381,0.7738095238095238,0.2261904761904762,652,125,167,360,586,66,0.19171779141104295,0.2561349693251534,0.5521472392638037,0.8987730061349694,0.10122699386503067
2946,486,280,206,385,101,0.5761316872427984,0.42386831275720166,0.7921810699588477,0.20781893004115226,506,108,158,240,490,16,0.2134387351778656,0.31225296442687744,0.4743083003952569,0.9683794466403162,0.03162055335968379
2947,308,141,167,256,52,0.4577922077922078,0.5422077922077922,0.8311688311688312,0.16883116883116883,727,83,152,492,657,70,0.11416781292984869,0.20907840440165062,0.6767537826685007,0.9037138927097662,0.09628610729023383
2948,1246,1031,215,1089,157,0.8274478330658106,0.1725521669341894,0.8739967897271268,0.1260032102728732,1053,149,274,630,832,221,0.14150047483380818,0.26020892687559355,0.5982905982905983,0.7901234567901234,0.20987654320987653
2949,1243,880,363,985,258,0.7079646017699115,0.2920353982300885,0.7924376508447305,0.2075623491552695,1228,102,250,876,950,278,0.08306188925081433,0.20358306188925082,0.7133550488599348,0.7736156351791531,0.2263843648208469
2950,1240,950,290,1018,222,0.7661290322580645,0.23387096774193547,0.8209677419354838,0.17903225806451614,1257,279,443,535,1124,133,0.22195704057279236,0.3524264120922832,0.42561654733492443,0.8941925218774861,0.10580747812251393
2951,469,276,193,386,83,0.5884861407249466,0.4115138592750533,0.8230277185501066,0.17697228144989338,856,110,245,501,784,72,0.12850467289719625,0.286214953271028,0.5852803738317757,0.9158878504672897,0.08411214953271028
2952,1259,1035,224,1101,158,0.8220810166799047,0.17791898332009531,0.8745035742652899,0.1254964257347101,1069,149,283,637,847,222,0.13938260056127222,0.264733395696913,0.5958840037418148,0.7923292797006548,0.2076707202993452
2953,689,457,232,542,147,0.6632801161103048,0.3367198838896952,0.7866473149492017,0.21335268505079827,1251,310,336,605,1119,132,0.2478017585931255,0.2685851318944844,0.48361310951239006,0.894484412470024,0.10551558752997602
2954,1057,750,307,826,231,0.7095553453169348,0.2904446546830653,0.7814569536423841,0.2185430463576159,1326,252,395,679,1094,232,0.19004524886877827,0.29788838612368024,0.5120663650075414,0.8250377073906485,0.17496229260935142
2955,818,579,239,661,157,0.7078239608801956,0.2921760391198044,0.8080684596577017,0.19193154034229828,1099,101,209,789,872,227,0.09190172884440401,0.19017288444040037,0.7179253867151957,0.7934485896269335,0.20655141037306643
2956,491,320,171,419,72,0.6517311608961304,0.34826883910386963,0.8533604887983707,0.14663951120162932,466,34,109,323,459,7,0.07296137339055794,0.23390557939914164,0.6931330472103004,0.9849785407725322,0.015021459227467811
2957,1248,1033,215,1092,156,0.8277243589743589,0.17227564102564102,0.875,0.125,1082,156,290,636,858,224,0.14417744916820702,0.2680221811460259,0.5878003696857671,0.7929759704251387,0.20702402957486138
2958,635,431,204,506,129,0.6787401574803149,0.32125984251968503,0.7968503937007874,0.2031496062992126,799,93,325,381,732,67,0.11639549436795996,0.4067584480600751,0.47684605757196497,0.9161451814768461,0.08385481852315395
2959,348,224,124,288,60,0.6436781609195402,0.3563218390804598,0.8275862068965517,0.1724137931034483,560,196,199,165,553,7,0.35,0.35535714285714287,0.29464285714285715,0.9875,0.0125
2960,238,114,124,209,29,0.4789915966386555,0.5210084033613446,0.8781512605042017,0.12184873949579832,626,78,123,425,426,200,0.12460063897763578,0.1964856230031949,0.6789137380191693,0.6805111821086262,0.3194888178913738
2961,371,195,176,286,85,0.5256064690026954,0.4743935309973046,0.77088948787062,0.22911051212938005,596,103,150,343,530,66,0.17281879194630873,0.2516778523489933,0.575503355704698,0.889261744966443,0.11073825503355705
2962,410,226,184,335,75,0.551219512195122,0.44878048780487806,0.8170731707317073,0.18292682926829268,609,98,154,357,542,67,0.16091954022988506,0.25287356321839083,0.5862068965517241,0.8899835796387521,0.11001642036124795
2963,1131,839,292,903,228,0.7418213969938108,0.2581786030061892,0.7984084880636605,0.20159151193633953,1449,333,449,667,1225,224,0.22981366459627328,0.30986887508626637,0.4603174603174603,0.8454106280193237,0.15458937198067632
2964,1245,1031,214,1088,157,0.8281124497991967,0.1718875502008032,0.8738955823293173,0.12610441767068273,1053,149,270,634,832,221,0.14150047483380818,0.2564102564102564,0.6020892687559354,0.7901234567901234,0.20987654320987653
2965,1164,877,287,909,255,0.7534364261168385,0.24656357388316152,0.7809278350515464,0.2190721649484536,1170,102,236,832,892,278,0.08717948717948718,0.20170940170940171,0.7111111111111111,0.7623931623931623,0.2376068376068376
2966,3225,2781,444,2616,609,0.8623255813953489,0.13767441860465116,0.8111627906976744,0.1888372093023256,1845,169,348,1328,1386,459,0.0915989159891599,0.1886178861788618,0.7197831978319783,0.751219512195122,0.24878048780487805
2967,543,366,177,443,100,0.6740331491712708,0.3259668508287293,0.8158379373848987,0.1841620626151013,921,186,216,519,855,66,0.20195439739413681,0.23452768729641693,0.5635179153094463,0.9283387622149837,0.07166123778501629
2968,336,205,131,293,43,0.6101190476190477,0.3898809523809524,0.8720238095238095,0.12797619047619047,614,118,187,309,559,55,0.19218241042345277,0.30456026058631924,0.503257328990228,0.9104234527687296,0.08957654723127036
2969,548,333,215,432,116,0.6076642335766423,0.39233576642335766,0.7883211678832117,0.2116788321167883,791,123,252,416,718,73,0.1554993678887484,0.3185840707964602,0.5259165613147914,0.9077117572692794,0.0922882427307206
2970,423,249,174,307,116,0.5886524822695035,0.41134751773049644,0.7257683215130024,0.27423167848699764,697,205,201,291,687,10,0.29411764705882354,0.2883787661406026,0.41750358680057387,0.9856527977044476,0.014347202295552367
2971,321,197,124,278,43,0.6137071651090342,0.3862928348909657,0.8660436137071651,0.13395638629283488,609,155,202,252,557,52,0.2545155993431856,0.33169129720853857,0.41379310344827586,0.9146141215106732,0.08538587848932677
2972,799,540,259,627,172,0.6758448060075094,0.3241551939924906,0.7847309136420526,0.21526908635794745,945,130,331,484,814,131,0.13756613756613756,0.3502645502645503,0.5121693121693122,0.8613756613756614,0.13862433862433862
2973,369,227,142,291,78,0.6151761517615176,0.38482384823848237,0.7886178861788617,0.21138211382113822,651,181,181,289,640,11,0.2780337941628264,0.2780337941628264,0.44393241167434716,0.9831029185867896,0.016897081413210446
2974,335,211,124,291,44,0.6298507462686567,0.3701492537313433,0.8686567164179104,0.13134328358208955,684,129,228,327,567,117,0.18859649122807018,0.3333333333333333,0.4780701754385965,0.8289473684210527,0.17105263157894737
2975,331,153,178,276,55,0.4622356495468278,0.5377643504531722,0.8338368580060423,0.1661631419939577,736,94,188,454,668,68,0.12771739130434784,0.2554347826086957,0.6168478260869565,0.907608695652174,0.09239130434782608
2976,404,215,189,304,100,0.5321782178217822,0.46782178217821785,0.7524752475247525,0.24752475247524752,641,105,172,364,574,67,0.16380655226209048,0.26833073322932915,0.5678627145085804,0.8954758190327613,0.10452418096723869
2977,1248,1031,217,1091,157,0.8261217948717948,0.17387820512820512,0.874198717948718,0.12580128205128205,1069,149,290,630,848,221,0.13938260056127222,0.27128157156220767,0.5893358278765201,0.7932647333956969,0.20673526660430308
2978,1246,1031,215,1090,156,0.8274478330658106,0.1725521669341894,0.8747993579454254,0.12520064205457465,1073,155,287,631,852,221,0.14445479962721341,0.2674743709226468,0.5880708294501398,0.7940354147250699,0.2059645852749301
2979,543,369,174,450,93,0.6795580110497238,0.32044198895027626,0.8287292817679558,0.1712707182320442,942,224,255,463,877,65,0.23779193205944799,0.27070063694267515,0.49150743099787686,0.9309978768577495,0.06900212314225053
2980,568,390,178,474,94,0.6866197183098591,0.31338028169014087,0.8345070422535211,0.16549295774647887,1277,311,368,598,1148,129,0.24353954581049334,0.28817541111981204,0.4682850430696946,0.898981989036805,0.10101801096319499
2981,443,282,161,362,81,0.636568848758465,0.36343115124153497,0.8171557562076749,0.18284424379232506,750,105,189,456,679,71,0.14,0.252,0.608,0.9053333333333333,0.09466666666666666
2982,337,223,114,287,50,0.6617210682492581,0.33827893175074186,0.8516320474777448,0.14836795252225518,598,149,160,289,587,11,0.2491638795986622,0.26755852842809363,0.48327759197324416,0.9816053511705686,0.01839464882943144
2983,658,455,203,526,132,0.6914893617021277,0.30851063829787234,0.7993920972644377,0.2006079027355623,846,117,328,401,778,68,0.13829787234042554,0.3877068557919622,0.4739952718676123,0.9196217494089834,0.08037825059101655
2984,1273,1001,272,1072,201,0.786331500392773,0.21366849960722703,0.8421052631578947,0.15789473684210525,1164,238,396,530,1034,130,0.20446735395189003,0.3402061855670103,0.45532646048109965,0.8883161512027491,0.11168384879725086
2985,1283,998,285,1074,209,0.7778643803585347,0.2221356196414653,0.8371005455962588,0.16289945440374123,1168,102,231,835,890,278,0.08732876712328767,0.19777397260273974,0.7148972602739726,0.761986301369863,0.238013698630137
2986,829,625,204,740,89,0.7539203860072377,0.24607961399276237,0.8926417370325693,0.10735826296743065,965,142,239,584,764,201,0.14715025906735751,0.24766839378238342,0.6051813471502591,0.7917098445595855,0.20829015544041452
2987,575,368,207,455,120,0.64,0.36,0.7913043478260869,0.20869565217391303,928,129,233,566,816,112,0.13900862068965517,0.2510775862068966,0.6099137931034483,0.8793103448275862,0.1206896551724138
2988,572,389,183,464,108,0.6800699300699301,0.31993006993006995,0.8111888111888111,0.1888111888111888,1129,308,288,533,1063,66,0.2728077945084145,0.2550930026572188,0.4720992028343667,0.941541186891054,0.05845881310894597
2989,392,205,187,298,94,0.5229591836734694,0.4770408163265306,0.7602040816326531,0.23979591836734693,610,103,160,347,544,66,0.16885245901639345,0.26229508196721313,0.5688524590163935,0.8918032786885246,0.10819672131147541
2990,1291,998,293,1082,209,0.7730441518202944,0.22695584817970565,0.8381099922540666,0.16189000774593337,1173,102,231,840,895,278,0.08695652173913043,0.1969309462915601,0.7161125319693095,0.763000852514919,0.236999147485081
2991,349,231,118,286,63,0.66189111747851,0.33810888252148996,0.8194842406876791,0.18051575931232092,554,141,156,257,545,9,0.2545126353790614,0.2815884476534296,0.463898916967509,0.983754512635379,0.016245487364620937
2992,331,206,125,289,42,0.622356495468278,0.3776435045317221,0.8731117824773413,0.1268882175226586,689,133,238,318,573,116,0.193033381712627,0.3454281567489115,0.46153846153846156,0.8316400580551524,0.1683599419448476
2993,318,187,131,276,42,0.5880503144654088,0.4119496855345912,0.8679245283018868,0.1320754716981132,769,136,216,417,710,59,0.17685305591677503,0.2808842652795839,0.5422626788036411,0.9232769830949284,0.07672301690507152
2994,619,380,239,488,131,0.6138933764135702,0.3861066235864297,0.7883683360258481,0.21163166397415187,766,109,251,406,692,74,0.1422976501305483,0.3276762402088773,0.5300261096605744,0.9033942558746736,0.09660574412532637
2995,346,215,131,302,44,0.6213872832369942,0.3786127167630058,0.8728323699421965,0.12716763005780346,700,121,227,352,583,117,0.17285714285714285,0.3242857142857143,0.5028571428571429,0.8328571428571429,0.16714285714285715
2996,1290,998,292,1081,209,0.7736434108527132,0.22635658914728682,0.837984496124031,0.162015503875969,1173,102,232,839,895,278,0.08695652173913043,0.1977834612105712,0.7152600170502984,0.763000852514919,0.236999147485081
2997,841,624,217,752,89,0.7419738406658739,0.25802615933412604,0.8941736028537456,0.10582639714625446,979,143,254,582,779,200,0.14606741573033707,0.25944841675178754,0.5944841675178754,0.7957099080694586,0.20429009193054137
2998,302,185,117,261,41,0.6125827814569537,0.38741721854304634,0.8642384105960265,0.1357615894039735,680,129,175,376,623,57,0.18970588235294117,0.25735294117647056,0.5529411764705883,0.9161764705882353,0.0838235294117647
2999,1255,1034,221,1095,160,0.8239043824701195,0.17609561752988048,0.8725099601593626,0.12749003984063745,1052,149,278,625,831,221,0.14163498098859315,0.26425855513307983,0.594106463878327,0.7899239543726235,0.21007604562737642
3000,1501,1256,245,1285,216,0.8367754830113258,0.1632245169886742,0.8560959360426382,0.14390406395736177,1200,181,325,694,974,226,0.15083333333333335,0.2708333333333333,0.5783333333333334,0.8116666666666666,0.18833333333333332
3001,619,378,241,469,150,0.6106623586429726,0.3893376413570275,0.7576736672051696,0.24232633279483037,833,147,225,461,769,64,0.17647058823529413,0.27010804321728693,0.553421368547419,0.9231692677070829,0.07683073229291716
3002,1263,1031,232,1106,157,0.8163103721298496,0.18368962787015045,0.8756927949326999,0.12430720506730007,1072,149,287,636,851,221,0.13899253731343283,0.2677238805970149,0.5932835820895522,0.7938432835820896,0.20615671641791045
3003,1162,880,282,904,258,0.7573149741824441,0.24268502581755594,0.7779690189328744,0.22203098106712565,1156,102,230,824,878,278,0.08823529411764706,0.19896193771626297,0.71280276816609,0.759515570934256,0.24048442906574394
3004,1162,880,282,904,258,0.7573149741824441,0.24268502581755594,0.7779690189328744,0.22203098106712565,1156,102,230,824,878,278,0.08823529411764706,0.19896193771626297,0.71280276816609,0.759515570934256,0.24048442906574394
3005,343,216,127,302,41,0.6297376093294461,0.37026239067055394,0.880466472303207,0.119533527696793,689,200,227,262,637,52,0.29027576197387517,0.32946298984034833,0.3802612481857765,0.9245283018867925,0.07547169811320754
3006,1283,998,285,1074,209,0.7778643803585347,0.2221356196414653,0.8371005455962588,0.16289945440374123,1165,102,229,834,887,278,0.08755364806866953,0.1965665236051502,0.7158798283261802,0.76137339055794,0.23862660944206007
3007,1161,879,282,903,258,0.7571059431524548,0.24289405684754523,0.7777777777777778,0.2222222222222222,1156,102,230,824,878,278,0.08823529411764706,0.19896193771626297,0.71280276816609,0.759515570934256,0.24048442906574394
3008,423,211,212,331,92,0.4988179669030733,0.5011820330969267,0.7825059101654847,0.21749408983451538,742,111,215,416,673,69,0.1495956873315364,0.28975741239892183,0.5606469002695418,0.9070080862533693,0.09299191374663072
3009,1262,1033,229,1106,156,0.8185419968304279,0.1814580031695721,0.8763866877971473,0.12361331220285261,1101,155,304,642,879,222,0.1407811080835604,0.2761126248864669,0.5831062670299727,0.7983651226158038,0.2016348773841962
3010,424,288,136,371,53,0.6792452830188679,0.32075471698113206,0.875,0.125,661,186,208,267,609,52,0.2813918305597579,0.3146747352496218,0.4039334341906203,0.9213313161875946,0.07866868381240545
3011,582,362,220,453,129,0.6219931271477663,0.37800687285223367,0.7783505154639175,0.22164948453608246,768,112,232,424,695,73,0.14583333333333334,0.3020833333333333,0.5520833333333334,0.9049479166666666,0.09505208333333333
3012,603,372,231,472,131,0.6169154228855721,0.38308457711442784,0.7827529021558872,0.21724709784411278,798,116,252,430,725,73,0.14536340852130325,0.3157894736842105,0.5388471177944862,0.9085213032581454,0.09147869674185463
3013,368,188,180,282,86,0.5108695652173914,0.4891304347826087,0.7663043478260869,0.23369565217391305,577,93,147,337,511,66,0.1611785095320624,0.25476603119584057,0.584055459272097,0.8856152512998267,0.11438474870017332
3014,861,599,262,696,165,0.6957026713124274,0.3042973286875726,0.8083623693379791,0.1916376306620209,1312,264,400,648,1084,228,0.20121951219512196,0.3048780487804878,0.49390243902439024,0.8262195121951219,0.17378048780487804
3015,1496,1250,246,1280,216,0.8355614973262032,0.16443850267379678,0.8556149732620321,0.1443850267379679,1188,175,323,690,963,225,0.1473063973063973,0.2718855218855219,0.5808080808080808,0.8106060606060606,0.1893939393939394
3016,1327,1050,277,1109,218,0.7912584777694047,0.20874152223059533,0.8357196684250189,0.16428033157498115,1291,252,429,610,1100,191,0.19519752130131682,0.33230054221533695,0.47250193648334626,0.8520526723470179,0.14794732765298219
3017,1295,998,297,1086,209,0.7706563706563706,0.22934362934362934,0.8386100386100386,0.1613899613899614,1187,102,237,848,909,278,0.08593091828138164,0.1996630160067397,0.7144060657118787,0.7657961246840775,0.2342038753159225
3018,1359,1044,315,1079,280,0.7682119205298014,0.23178807947019867,0.7939661515820456,0.20603384841795438,1264,155,367,742,966,298,0.12262658227848101,0.2903481012658228,0.5870253164556962,0.7642405063291139,0.23575949367088608
3019,3071,2600,471,2531,540,0.8466297622924129,0.1533702377075871,0.8241615109084989,0.17583848909150113,1595,270,469,856,1387,208,0.16927899686520376,0.2940438871473354,0.5366771159874608,0.8695924764890283,0.1304075235109718
3020,1290,998,292,1081,209,0.7736434108527132,0.22635658914728682,0.837984496124031,0.162015503875969,1176,102,234,840,898,278,0.08673469387755102,0.1989795918367347,0.7142857142857143,0.7636054421768708,0.23639455782312926
3021,336,220,116,294,42,0.6547619047619048,0.34523809523809523,0.875,0.125,1002,131,217,654,828,174,0.13073852295409183,0.21656686626746507,0.6526946107784432,0.8263473053892215,0.17365269461077845
3022,594,415,179,491,103,0.6986531986531986,0.30134680134680136,0.8265993265993266,0.1734006734006734,1074,211,309,554,945,129,0.19646182495344505,0.2877094972067039,0.515828677839851,0.8798882681564246,0.12011173184357542
3023,472,293,179,389,83,0.6207627118644068,0.3792372881355932,0.8241525423728814,0.17584745762711865,806,96,194,516,734,72,0.11910669975186104,0.24069478908188585,0.6401985111662531,0.9106699751861043,0.08933002481389578
3024,114,46,68,49,65,0.40350877192982454,0.5964912280701754,0.4298245614035088,0.5701754385964912,542,145,160,237,484,58,0.26752767527675275,0.2952029520295203,0.43726937269372695,0.8929889298892989,0.1070110701107011
3025,324,207,117,281,43,0.6388888888888888,0.3611111111111111,0.8672839506172839,0.13271604938271606,807,131,215,461,683,124,0.1623296158612144,0.2664188351920694,0.5712515489467163,0.8463444857496902,0.1536555142503098
3026,4595,4038,557,3896,699,0.8787812840043525,0.12121871599564744,0.8478781284004353,0.15212187159956475,2102,231,551,1320,1693,409,0.109895337773549,0.2621313035204567,0.6279733587059942,0.8054234062797336,0.19457659372026642
3027,575,401,174,476,99,0.697391304347826,0.3026086956521739,0.8278260869565217,0.17217391304347826,1144,200,265,679,919,225,0.17482517482517482,0.23164335664335664,0.5935314685314685,0.8033216783216783,0.19667832167832167
3028,1496,1251,245,1281,215,0.8362299465240641,0.16377005347593582,0.8562834224598931,0.14371657754010694,1176,175,318,683,951,225,0.1488095238095238,0.27040816326530615,0.58078231292517,0.8086734693877551,0.1913265306122449
3029,1506,1258,248,1291,215,0.8353253652058433,0.1646746347941567,0.8572377158034529,0.14276228419654716,1199,181,331,687,973,226,0.15095913261050875,0.27606338615512926,0.572977481234362,0.8115095913261051,0.1884904086738949
3030,1171,880,291,913,258,0.7514944491887275,0.24850555081127243,0.7796754910333049,0.22032450896669514,1157,102,228,827,879,278,0.0881590319792567,0.19706136560069146,0.7147796024200519,0.759723422644771,0.24027657735522903
3031,871,662,209,777,94,0.7600459242250287,0.2399540757749713,0.8920780711825488,0.1079219288174512,975,136,245,594,773,202,0.13948717948717948,0.2512820512820513,0.6092307692307692,0.7928205128205128,0.20717948717948717
3032,1240,880,360,982,258,0.7096774193548387,0.2903225806451613,0.7919354838709678,0.20806451612903226,1228,102,251,875,950,278,0.08306188925081433,0.20439739413680783,0.7125407166123778,0.7736156351791531,0.2263843648208469
3033,1162,880,282,904,258,0.7573149741824441,0.24268502581755594,0.7779690189328744,0.22203098106712565,1156,102,230,824,878,278,0.08823529411764706,0.19896193771626297,0.71280276816609,0.759515570934256,0.24048442906574394
3034,350,222,128,307,43,0.6342857142857142,0.3657142857142857,0.8771428571428571,0.12285714285714286,834,115,239,480,712,122,0.13788968824940048,0.2865707434052758,0.5755395683453237,0.8537170263788969,0.14628297362110312
3035,414,204,210,319,95,0.4927536231884058,0.5072463768115942,0.7705314009661836,0.22946859903381642,676,103,182,391,607,69,0.15236686390532544,0.2692307692307692,0.5784023668639053,0.8979289940828402,0.10207100591715976
3036,805,559,246,657,148,0.6944099378881987,0.30559006211180123,0.8161490683229814,0.18385093167701863,1080,99,214,767,853,227,0.09166666666666666,0.19814814814814816,0.7101851851851851,0.7898148148148149,0.2101851851851852
3037,614,368,246,492,122,0.5993485342019544,0.4006514657980456,0.8013029315960912,0.1986970684039088,840,124,270,446,767,73,0.14761904761904762,0.32142857142857145,0.530952380952381,0.9130952380952381,0.0869047619047619
3038,1891,1597,294,1542,349,0.8445267054468535,0.15547329455314648,0.8154415653093601,0.18455843469063987,1283,163,366,754,989,294,0.1270459859703819,0.2852689010132502,0.5876851130163678,0.7708495713172252,0.22915042868277474
3039,1233,880,353,975,258,0.7137064071370641,0.28629359286293593,0.7907542579075426,0.20924574209245742,1223,102,250,871,945,278,0.08340147179067865,0.2044153720359771,0.7121831561733443,0.7726901062959934,0.22730989370400653
3040,1290,998,292,1081,209,0.7736434108527132,0.22635658914728682,0.837984496124031,0.162015503875969,1178,102,234,842,900,278,0.0865874363327674,0.19864176570458403,0.7147707979626485,0.7640067911714771,0.23599320882852293
3041,325,199,126,282,43,0.6123076923076923,0.38769230769230767,0.8676923076923077,0.13230769230769232,584,131,194,259,532,52,0.2243150684931507,0.3321917808219178,0.4434931506849315,0.910958904109589,0.08904109589041095
3042,319,203,116,277,42,0.6363636363636364,0.36363636363636365,0.8683385579937304,0.13166144200626959,639,145,187,307,583,56,0.2269170579029734,0.29264475743348983,0.48043818466353677,0.9123630672926447,0.08763693270735524
3043,163,106,57,69,94,0.6503067484662577,0.3496932515337423,0.4233128834355828,0.5766871165644172,71,0,55,16,71,0,0.0,0.7746478873239436,0.22535211267605634,1.0,0.0
3044,333,196,137,292,41,0.5885885885885885,0.4114114114114114,0.8768768768768769,0.12312312312312312,633,137,205,291,580,53,0.21642969984202212,0.32385466034755134,0.4597156398104265,0.9162717219589257,0.08372827804107424
3045,451,280,171,371,80,0.6208425720620843,0.37915742793791574,0.8226164079822617,0.17738359201773837,798,95,200,503,724,74,0.11904761904761904,0.2506265664160401,0.6303258145363408,0.9072681704260651,0.09273182957393483
3046,462,281,181,382,80,0.6082251082251082,0.3917748917748918,0.8268398268398268,0.17316017316017315,802,95,199,508,730,72,0.11845386533665836,0.24812967581047382,0.6334164588528678,0.9102244389027432,0.08977556109725686
3047,467,290,177,386,81,0.6209850107066381,0.37901498929336186,0.8265524625267666,0.1734475374732334,747,95,200,452,676,71,0.12717536813922356,0.2677376171352075,0.6050870147255689,0.9049531459170014,0.09504685408299866
3048,1168,879,289,910,258,0.752568493150685,0.24743150684931506,0.7791095890410958,0.2208904109589041,1159,102,230,827,881,278,0.08800690250215704,0.1984469370146678,0.7135461604831751,0.7601380500431406,0.23986194995685936
3049,1366,1003,363,1085,281,0.7342606149341142,0.2657393850658858,0.794289897510981,0.20571010248901903,1224,102,248,874,946,278,0.08333333333333333,0.20261437908496732,0.7140522875816994,0.7728758169934641,0.22712418300653595
3050,1075,814,261,876,199,0.7572093023255814,0.2427906976744186,0.8148837209302325,0.18511627906976744,1253,258,453,542,1122,131,0.20590582601755786,0.36153232242617717,0.432561851556265,0.8954509177972865,0.10454908220271349
3051,1248,1031,217,1091,157,0.8261217948717948,0.17387820512820512,0.874198717948718,0.12580128205128205,1047,149,273,625,826,221,0.14231136580706782,0.2607449856733524,0.5969436485195797,0.7889207258834766,0.2110792741165234
3052,189,58,131,159,30,0.30687830687830686,0.6931216931216931,0.8412698412698413,0.15873015873015872,667,124,164,379,615,52,0.18590704647676162,0.24587706146926536,0.568215892053973,0.9220389805097451,0.07796101949025487
3053,1520,1269,251,1303,217,0.8348684210526316,0.16513157894736843,0.8572368421052632,0.14276315789473684,1212,181,332,699,986,226,0.14933993399339934,0.2739273927392739,0.5767326732673267,0.8135313531353136,0.18646864686468648
3054,330,207,123,287,43,0.6272727272727273,0.37272727272727274,0.8696969696969697,0.1303030303030303,893,150,238,505,770,123,0.167973124300112,0.26651735722284436,0.5655095184770437,0.8622620380739082,0.13773796192609183
3055,335,219,116,287,48,0.6537313432835821,0.34626865671641793,0.8567164179104477,0.14328358208955225,852,137,225,490,731,121,0.1607981220657277,0.2640845070422535,0.5751173708920188,0.857981220657277,0.142018779342723
3056,482,297,185,398,84,0.6161825726141079,0.38381742738589214,0.8257261410788381,0.17427385892116182,820,95,222,503,748,72,0.11585365853658537,0.2707317073170732,0.6134146341463415,0.9121951219512195,0.08780487804878048
3057,346,216,130,299,47,0.6242774566473989,0.37572254335260113,0.8641618497109826,0.13583815028901733,907,137,253,517,783,124,0.15104740904079383,0.278941565600882,0.5700110253583242,0.8632855567805954,0.13671444321940462
3058,576,401,175,474,102,0.6961805555555556,0.3038194444444444,0.8229166666666666,0.17708333333333334,1100,233,279,588,968,132,0.21181818181818182,0.25363636363636366,0.5345454545454545,0.88,0.12
3059,316,196,120,277,39,0.620253164556962,0.379746835443038,0.8765822784810127,0.12341772151898735,543,118,180,245,491,52,0.21731123388581952,0.3314917127071823,0.45119705340699817,0.9042357274401474,0.09576427255985268
3060,325,187,138,284,41,0.5753846153846154,0.4246153846153846,0.8738461538461538,0.12615384615384614,616,115,198,303,561,55,0.18668831168831168,0.32142857142857145,0.49188311688311687,0.9107142857142857,0.08928571428571429
3061,562,390,172,474,88,0.693950177935943,0.30604982206405695,0.8434163701067615,0.15658362989323843,1159,219,283,657,934,225,0.18895599654874892,0.2441760138050043,0.5668679896462467,0.8058671268334772,0.19413287316652286
3062,686,456,230,537,149,0.6647230320699709,0.33527696793002915,0.782798833819242,0.21720116618075802,1100,301,294,505,1036,64,0.2736363636363636,0.2672727272727273,0.4590909090909091,0.9418181818181818,0.05818181818181818
3063,949,699,250,763,186,0.7365648050579557,0.26343519494204426,0.804004214963119,0.19599578503688092,1070,104,203,763,843,227,0.09719626168224299,0.1897196261682243,0.7130841121495327,0.7878504672897196,0.21214953271028036
3064,202,116,86,76,126,0.5742574257425742,0.42574257425742573,0.37623762376237624,0.6237623762376238,389,187,162,40,389,0,0.480719794344473,0.41645244215938304,0.10282776349614396,1.0,0.0
3065,352,221,131,308,44,0.6278409090909091,0.3721590909090909,0.875,0.125,698,115,235,348,581,117,0.16475644699140402,0.336676217765043,0.498567335243553,0.832378223495702,0.167621776504298
3066,352,211,141,309,43,0.5994318181818182,0.4005681818181818,0.8778409090909091,0.12215909090909091,861,136,262,463,739,122,0.15795586527293845,0.3042973286875726,0.537746806039489,0.8583042973286876,0.14169570267131243
3067,381,245,136,329,52,0.6430446194225722,0.3569553805774278,0.863517060367454,0.13648293963254593,749,145,251,353,632,117,0.19359145527369825,0.33511348464619495,0.4712950600801068,0.8437917222963952,0.15620827770360482
3068,1292,998,294,1083,209,0.7724458204334366,0.22755417956656346,0.8382352941176471,0.16176470588235295,1179,102,234,843,901,278,0.08651399491094147,0.1984732824427481,0.7150127226463104,0.7642069550466497,0.2357930449533503
3069,575,398,177,466,109,0.6921739130434783,0.30782608695652175,0.8104347826086956,0.18956521739130436,1334,286,305,743,1107,227,0.2143928035982009,0.22863568215892055,0.5569715142428786,0.8298350824587706,0.1701649175412294
3070,1257,1033,224,1101,156,0.8217979315831344,0.17820206841686556,0.8758949880668258,0.12410501193317422,1082,155,292,635,860,222,0.14325323475046212,0.2698706099815157,0.5868761552680222,0.7948243992606284,0.20517560073937152
3071,323,207,116,281,42,0.6408668730650154,0.3591331269349845,0.8699690402476781,0.13003095975232198,851,155,232,464,729,122,0.18213866039952997,0.27262044653349,0.54524089306698,0.8566392479435958,0.14336075205640422
3072,564,347,217,442,122,0.6152482269503546,0.38475177304964536,0.7836879432624113,0.21631205673758866,867,112,242,513,701,166,0.12918108419838523,0.279123414071511,0.5916955017301038,0.8085351787773933,0.1914648212226067
3073,1256,1034,222,1099,157,0.8232484076433121,0.1767515923566879,0.875,0.125,1068,150,285,633,847,221,0.1404494382022472,0.26685393258426965,0.5926966292134831,0.7930711610486891,0.20692883895131087
3074,440,279,161,360,80,0.634090909090909,0.3659090909090909,0.8181818181818182,0.18181818181818182,784,106,191,487,712,72,0.13520408163265307,0.24362244897959184,0.6211734693877551,0.9081632653061225,0.09183673469387756
3075,1118,828,290,898,220,0.740608228980322,0.259391771019678,0.8032200357781754,0.1967799642218247,1326,270,427,629,1101,225,0.20361990950226244,0.3220211161387632,0.47435897435897434,0.830316742081448,0.16968325791855204
3076,4246,3717,529,3493,753,0.8754121526142251,0.12458784738577484,0.8226566179934055,0.17734338200659444,1803,198,539,1066,1359,444,0.10981697171381032,0.29894620077648365,0.5912368275097061,0.7537437603993344,0.24625623960066556
3077,304,185,119,263,41,0.6085526315789473,0.39144736842105265,0.8651315789473685,0.13486842105263158,579,140,183,256,522,57,0.24179620034542315,0.3160621761658031,0.4421416234887737,0.9015544041450777,0.09844559585492228
3078,521,332,189,419,102,0.6372360844529751,0.362763915547025,0.8042226487523992,0.19577735124760076,1225,318,307,600,1149,76,0.2595918367346939,0.2506122448979592,0.4897959183673469,0.9379591836734694,0.062040816326530614
3079,458,281,177,375,83,0.6135371179039302,0.3864628820960699,0.8187772925764192,0.1812227074235808,815,115,208,492,741,74,0.1411042944785276,0.2552147239263804,0.603680981595092,0.90920245398773,0.09079754601226994
3080,587,360,227,462,125,0.6132879045996593,0.38671209540034074,0.787052810902896,0.21294718909710392,778,106,240,432,701,77,0.13624678663239073,0.30848329048843187,0.5552699228791774,0.9010282776349614,0.09897172236503857
3081,571,388,183,466,105,0.6795096322241682,0.3204903677758319,0.8161120840630472,0.18388791593695272,1344,304,342,698,1120,224,0.2261904761904762,0.2544642857142857,0.5193452380952381,0.8333333333333334,0.16666666666666666
3082,451,280,171,368,83,0.6208425720620843,0.37915742793791574,0.8159645232815964,0.18403547671840353,744,95,187,462,672,72,0.12768817204301075,0.2513440860215054,0.6209677419354839,0.9032258064516129,0.0967741935483871
3083,475,289,186,393,82,0.608421052631579,0.391578947368421,0.8273684210526315,0.1726315789473684,801,106,212,483,730,71,0.132334581772784,0.264669163545568,0.602996254681648,0.9113607990012484,0.08863920099875156
3084,1290,998,292,1081,209,0.7736434108527132,0.22635658914728682,0.837984496124031,0.162015503875969,1175,102,232,841,897,278,0.08680851063829788,0.1974468085106383,0.7157446808510638,0.7634042553191489,0.23659574468085107
3085,1240,1032,208,1083,157,0.832258064516129,0.16774193548387098,0.8733870967741936,0.12661290322580646,1052,149,272,631,830,222,0.14163498098859315,0.2585551330798479,0.5998098859315589,0.7889733840304183,0.21102661596958175
3086,1537,1283,254,1318,219,0.8347430058555628,0.1652569941444372,0.8575146389069617,0.1424853610930384,1206,181,331,694,980,226,0.15008291873963517,0.2744610281923715,0.5754560530679934,0.8126036484245439,0.18739635157545606
3087,347,221,126,303,44,0.6368876080691642,0.3631123919308357,0.8731988472622478,0.12680115273775217,742,143,240,359,623,119,0.192722371967655,0.32345013477088946,0.4838274932614555,0.839622641509434,0.16037735849056603
3088,370,191,179,283,87,0.5162162162162162,0.4837837837837838,0.7648648648648648,0.23513513513513515,561,90,142,329,495,66,0.16042780748663102,0.2531194295900178,0.5864527629233511,0.8823529411764706,0.11764705882352941
3089,1295,1072,223,1129,166,0.8277992277992278,0.1722007722007722,0.8718146718146718,0.12818532818532818,1066,149,290,627,845,221,0.1397748592870544,0.27204502814258913,0.5881801125703565,0.7926829268292683,0.2073170731707317
3090,347,219,128,304,43,0.6311239193083573,0.3688760806916426,0.8760806916426513,0.1239193083573487,672,179,219,274,620,52,0.2663690476190476,0.32589285714285715,0.40773809523809523,0.9226190476190477,0.07738095238095238
3091,313,190,123,273,40,0.6070287539936102,0.3929712460063898,0.8722044728434505,0.12779552715654952,723,120,192,411,667,56,0.16597510373443983,0.26556016597510373,0.5684647302904564,0.9225449515905948,0.07745504840940526
3092,1231,879,352,972,259,0.7140536149471974,0.2859463850528026,0.7896019496344435,0.21039805036555645,1215,102,245,868,937,278,0.08395061728395062,0.20164609053497942,0.7144032921810699,0.77119341563786,0.2288065843621399
3093,1266,985,281,1054,212,0.778041074249605,0.22195892575039494,0.8325434439178515,0.1674565560821485,1162,173,379,610,936,226,0.14888123924268504,0.3261617900172117,0.5249569707401033,0.8055077452667814,0.1944922547332186
3094,682,488,194,545,137,0.7155425219941349,0.2844574780058651,0.7991202346041055,0.20087976539589442,842,123,316,403,767,75,0.14608076009501186,0.3752969121140142,0.47862232779097386,0.9109263657957245,0.08907363420427554
3095,344,224,120,300,44,0.6511627906976745,0.3488372093023256,0.872093023255814,0.12790697674418605,847,134,231,482,726,121,0.15820543093270367,0.2727272727272727,0.5690672963400236,0.8571428571428571,0.14285714285714285
3096,740,537,203,589,151,0.7256756756756757,0.2743243243243243,0.7959459459459459,0.20405405405405405,780,86,323,371,714,66,0.11025641025641025,0.41410256410256413,0.4756410256410256,0.9153846153846154,0.08461538461538462
3097,1249,1031,218,1092,157,0.8254603682946358,0.1745396317053643,0.8742994395516414,0.1257005604483587,1059,150,278,631,838,221,0.141643059490085,0.26251180358829085,0.5958451369216242,0.7913125590179415,0.20868744098205855
3098,1244,1032,212,1087,157,0.8295819935691319,0.17041800643086816,0.8737942122186495,0.12620578778135047,1046,149,264,633,824,222,0.14244741873804972,0.25239005736137665,0.6051625239005736,0.7877629063097514,0.21223709369024857
3099,227,130,97,98,129,0.5726872246696035,0.42731277533039647,0.43171806167400884,0.5682819383259912,336,138,153,45,336,0,0.4107142857142857,0.45535714285714285,0.13392857142857142,1.0,0.0
3100,337,224,113,283,54,0.6646884272997032,0.3353115727002967,0.8397626112759644,0.16023738872403562,467,149,172,146,459,8,0.31905781584582443,0.3683083511777302,0.31263383297644537,0.9828693790149893,0.017130620985010708
3101,584,366,218,451,133,0.6267123287671232,0.3732876712328767,0.7722602739726028,0.22773972602739725,969,168,220,581,897,72,0.17337461300309598,0.22703818369453044,0.5995872033023736,0.9256965944272446,0.07430340557275542
3102,1172,880,292,914,258,0.7508532423208191,0.24914675767918087,0.7798634812286689,0.22013651877133106,1168,102,233,833,890,278,0.08732876712328767,0.199486301369863,0.7131849315068494,0.761986301369863,0.238013698630137
3103,1239,1031,208,1082,157,0.8321226795803067,0.1678773204196933,0.8732849071832123,0.12671509281678772,1034,149,260,625,813,221,0.14410058027079303,0.2514506769825919,0.6044487427466151,0.7862669245647969,0.2137330754352031
3104,1511,1261,250,1294,217,0.8345466578424884,0.1654533421575116,0.8563864990072799,0.14361350099272005,1166,166,315,685,942,224,0.1423670668953688,0.2701543739279588,0.5874785591766724,0.8078902229845626,0.19210977701543738
3105,681,416,265,529,152,0.6108663729809104,0.3891336270190896,0.7767988252569751,0.22320117474302498,851,125,268,458,776,75,0.14688601645123384,0.31492361927144535,0.5381903642773208,0.9118683901292597,0.0881316098707403
3106,594,380,214,455,139,0.6397306397306397,0.3602693602693603,0.765993265993266,0.234006734006734,1102,153,250,699,873,229,0.13883847549909256,0.22686025408348456,0.6343012704174229,0.7921960072595281,0.20780399274047187
3107,315,188,127,275,40,0.5968253968253968,0.4031746031746032,0.873015873015873,0.12698412698412698,735,126,201,408,677,58,0.17142857142857143,0.27346938775510204,0.5551020408163265,0.9210884353741496,0.07891156462585033
3108,335,209,126,292,43,0.6238805970149254,0.3761194029850746,0.8716417910447761,0.12835820895522387,845,128,236,481,728,117,0.1514792899408284,0.27928994082840236,0.5692307692307692,0.8615384615384616,0.13846153846153847
3109,841,628,213,746,95,0.746730083234245,0.25326991676575505,0.8870392390011891,0.11296076099881094,960,136,236,588,758,202,0.14166666666666666,0.24583333333333332,0.6125,0.7895833333333333,0.21041666666666667
3110,1253,1031,222,1096,157,0.8228252194732641,0.17717478052673583,0.8747007182761373,0.12529928172386273,1059,149,281,629,838,221,0.14069877242681775,0.26534466477809254,0.5939565627950897,0.7913125590179415,0.20868744098205855
3111,311,182,129,269,42,0.5852090032154341,0.41479099678456594,0.864951768488746,0.13504823151125403,595,139,194,262,542,53,0.23361344537815126,0.32605042016806723,0.4403361344537815,0.9109243697478991,0.08907563025210084
3112,583,409,174,484,99,0.7015437392795884,0.29845626072041165,0.8301886792452831,0.16981132075471697,1025,190,252,583,895,130,0.18536585365853658,0.24585365853658536,0.568780487804878,0.8731707317073171,0.12682926829268293
3113,491,339,152,426,65,0.6904276985743381,0.3095723014256619,0.8676171079429735,0.13238289205702647,959,197,285,477,837,122,0.205422314911366,0.29718456725756,0.49739311783107404,0.872784150156413,0.12721584984358708
3114,1171,880,291,913,258,0.7514944491887275,0.24850555081127243,0.7796754910333049,0.22032450896669514,1159,102,228,829,881,278,0.08800690250215704,0.19672131147540983,0.7152717860224331,0.7601380500431406,0.23986194995685936
3115,1259,1035,224,1099,160,0.8220810166799047,0.17791898332009531,0.8729150119142176,0.12708498808578236,1059,150,276,633,837,222,0.141643059490085,0.26062322946175637,0.5977337110481586,0.7903682719546742,0.2096317280453258
3116,1167,878,289,912,255,0.7523564695801199,0.24764353041988005,0.781491002570694,0.2185089974293059,1165,102,232,831,887,278,0.08755364806866953,0.19914163090128756,0.7133047210300429,0.76137339055794,0.23862660944206007
3117,328,201,127,285,43,0.6128048780487805,0.3871951219512195,0.8689024390243902,0.13109756097560976,661,161,209,291,609,52,0.24357034795763993,0.3161875945537065,0.4402420574886536,0.9213313161875946,0.07866868381240545
3118,378,97,281,292,86,0.2566137566137566,0.7433862433862434,0.7724867724867724,0.2275132275132275,496,0,266,230,496,0,0.0,0.5362903225806451,0.4637096774193548,1.0,0.0
3119,735,541,194,612,123,0.7360544217687075,0.2639455782312925,0.8326530612244898,0.1673469387755102,1055,158,323,574,829,226,0.14976303317535544,0.3061611374407583,0.5440758293838862,0.785781990521327,0.21421800947867298
3120,336,205,131,294,42,0.6101190476190477,0.3898809523809524,0.875,0.125,646,168,214,264,594,52,0.26006191950464397,0.33126934984520123,0.4086687306501548,0.9195046439628483,0.0804953560371517
3121,308,183,125,268,40,0.5941558441558441,0.40584415584415584,0.8701298701298701,0.12987012987012986,621,145,218,258,568,53,0.23349436392914655,0.35104669887278583,0.41545893719806765,0.9146537842190016,0.0853462157809984
3122,3876,3500,376,3292,584,0.9029927760577915,0.09700722394220847,0.849329205366357,0.15067079463364294,1903,239,536,1128,1566,337,0.1255911718339464,0.2816605359957961,0.5927482921702575,0.8229111928533894,0.17708880714661063
3123,460,277,183,380,80,0.6021739130434782,0.3978260869565217,0.8260869565217391,0.17391304347826086,944,100,229,615,776,168,0.1059322033898305,0.24258474576271186,0.6514830508474576,0.8220338983050848,0.17796610169491525
3124,1296,998,298,1087,209,0.7700617283950617,0.22993827160493827,0.8387345679012346,0.16126543209876543,1179,102,234,843,901,278,0.08651399491094147,0.1984732824427481,0.7150127226463104,0.7642069550466497,0.2357930449533503
3125,563,352,211,444,119,0.6252220248667851,0.3747779751332149,0.7886323268206039,0.2113676731793961,777,129,222,426,704,73,0.16602316602316602,0.2857142857142857,0.5482625482625483,0.9060489060489061,0.09395109395109395
3126,651,450,201,533,118,0.6912442396313364,0.3087557603686636,0.8187403993855606,0.18125960061443933,1107,278,308,521,1041,66,0.25112917795844625,0.27822944896115626,0.4706413730803975,0.940379403794038,0.05962059620596206
3127,350,221,129,306,44,0.6314285714285715,0.36857142857142855,0.8742857142857143,0.12571428571428572,919,164,250,505,796,123,0.17845484221980412,0.2720348204570185,0.5495103373231773,0.8661588683351469,0.1338411316648531
3128,318,187,131,276,42,0.5880503144654088,0.4119496855345912,0.8679245283018868,0.1320754716981132,617,144,207,266,565,52,0.233387358184765,0.3354943273905997,0.43111831442463533,0.9157212317666127,0.08427876823338736
3129,1161,879,282,903,258,0.7571059431524548,0.24289405684754523,0.7777777777777778,0.2222222222222222,1157,102,230,825,878,279,0.0881590319792567,0.19878997407087295,0.7130509939498704,0.7588591184096802,0.2411408815903198
3130,665,477,188,536,129,0.7172932330827068,0.28270676691729324,0.806015037593985,0.19398496240601504,805,113,313,379,737,68,0.14037267080745341,0.38881987577639754,0.47080745341614905,0.915527950310559,0.084472049689441
3131,1506,1258,248,1290,216,0.8353253652058433,0.1646746347941567,0.8565737051792829,0.14342629482071714,1214,181,334,699,987,227,0.14909390444810544,0.2751235584843493,0.5757825370675453,0.8130148270181219,0.18698517298187808
3132,335,157,178,252,83,0.46865671641791046,0.5313432835820896,0.7522388059701492,0.24776119402985075,582,94,157,331,515,67,0.16151202749140894,0.2697594501718213,0.5687285223367697,0.8848797250859106,0.11512027491408934
3133,727,516,211,588,139,0.7097661623108665,0.2902338376891334,0.8088033012379643,0.19119669876203577,1215,273,406,536,1087,128,0.22469135802469137,0.33415637860082303,0.4411522633744856,0.8946502057613168,0.10534979423868313
3134,1234,975,259,1000,234,0.7901134521880064,0.2098865478119935,0.8103727714748784,0.18962722852512157,1389,242,410,737,1086,303,0.1742260619150468,0.29517638588912887,0.5305975521958244,0.7818574514038877,0.21814254859611232
3135,593,365,228,472,121,0.6155143338954469,0.3844856661045531,0.7959527824620574,0.20404721753794267,856,99,227,530,781,75,0.11565420560747663,0.2651869158878505,0.6191588785046729,0.9123831775700935,0.08761682242990654
3136,1028,748,280,827,201,0.7276264591439688,0.2723735408560311,0.8044747081712063,0.19552529182879377,1467,346,445,676,1239,228,0.23585548738922973,0.30334014996591685,0.4608043626448534,0.8445807770961146,0.1554192229038855
3137,1270,1047,223,1112,158,0.8244094488188977,0.17559055118110237,0.8755905511811024,0.12440944881889764,1060,155,276,629,839,221,0.14622641509433962,0.26037735849056604,0.5933962264150944,0.7915094339622641,0.20849056603773586
3138,1500,1251,249,1283,217,0.834,0.166,0.8553333333333333,0.14466666666666667,1193,172,327,694,968,225,0.14417435037720033,0.2740989103101425,0.5817267393126572,0.8113998323554066,0.18860016764459347
3139,466,280,186,386,80,0.6008583690987125,0.39914163090128757,0.8283261802575107,0.17167381974248927,905,94,208,603,737,168,0.10386740331491713,0.22983425414364642,0.6662983425414365,0.8143646408839779,0.1856353591160221
3140,495,305,190,412,83,0.6161616161616161,0.3838383838383838,0.8323232323232324,0.16767676767676767,956,103,234,619,788,168,0.10774058577405858,0.24476987447698745,0.647489539748954,0.8242677824267782,0.17573221757322174
3141,1231,880,351,973,258,0.7148659626320065,0.2851340373679935,0.7904142973192526,0.20958570268074736,1210,102,242,866,932,278,0.08429752066115702,0.2,0.715702479338843,0.7702479338842976,0.22975206611570248
3142,580,387,193,466,114,0.6672413793103448,0.33275862068965517,0.803448275862069,0.19655172413793104,1151,284,270,597,1077,74,0.2467419635099913,0.23457862728062553,0.5186794092093832,0.9357080799304952,0.06429192006950478
3143,465,280,185,383,82,0.6021505376344086,0.3978494623655914,0.8236559139784946,0.17634408602150536,896,93,208,595,728,168,0.10379464285714286,0.23214285714285715,0.6640625,0.8125,0.1875
3144,1162,880,282,904,258,0.7573149741824441,0.24268502581755594,0.7779690189328744,0.22203098106712565,1156,102,230,824,878,278,0.08823529411764706,0.19896193771626297,0.71280276816609,0.759515570934256,0.24048442906574394
3145,1496,1248,248,1280,216,0.8342245989304813,0.1657754010695187,0.8556149732620321,0.1443850267379679,1141,160,315,666,916,225,0.14022787028921999,0.27607361963190186,0.5836985100788782,0.8028045574057844,0.1971954425942156
3146,370,196,174,287,83,0.5297297297297298,0.4702702702702703,0.7756756756756756,0.22432432432432434,624,113,165,346,557,67,0.18108974358974358,0.2644230769230769,0.5544871794871795,0.8926282051282052,0.10737179487179487
3147,155,99,56,56,99,0.6387096774193548,0.36129032258064514,0.36129032258064514,0.6387096774193548,65,0,48,17,64,1,0.0,0.7384615384615385,0.26153846153846155,0.9846153846153847,0.015384615384615385
3148,1598,1332,266,1367,231,0.8335419274092616,0.16645807259073842,0.8554443053817271,0.14455569461827283,1168,163,311,694,943,225,0.13955479452054795,0.2662671232876712,0.5941780821917808,0.8073630136986302,0.19263698630136986
3149,582,388,194,466,116,0.6666666666666666,0.3333333333333333,0.8006872852233677,0.19931271477663232,929,202,242,485,863,66,0.21743810548977396,0.2604951560818084,0.5220667384284177,0.9289558665231432,0.07104413347685684
3150,585,372,213,460,125,0.6358974358974359,0.3641025641025641,0.7863247863247863,0.21367521367521367,803,123,252,428,729,74,0.15317559153175592,0.3138231631382316,0.5330012453300125,0.9078455790784558,0.0921544209215442
3151,856,625,231,679,177,0.7301401869158879,0.26985981308411217,0.7932242990654206,0.20677570093457945,874,113,366,395,804,70,0.12929061784897025,0.41876430205949655,0.45194508009153317,0.919908466819222,0.08009153318077804
3152,1287,998,289,1078,209,0.7754467754467754,0.22455322455322455,0.8376068376068376,0.1623931623931624,1167,102,229,836,889,278,0.08740359897172237,0.19622964867180806,0.7163667523564696,0.7617823479005998,0.23821765209940018
3153,580,363,217,462,118,0.6258620689655172,0.3741379310344828,0.7965517241379311,0.20344827586206896,826,127,259,440,752,74,0.15375302663438256,0.3135593220338983,0.5326876513317191,0.910411622276029,0.08958837772397095
3154,512,291,221,405,107,0.568359375,0.431640625,0.791015625,0.208984375,882,96,254,532,786,96,0.10884353741496598,0.28798185941043086,0.6031746031746031,0.891156462585034,0.10884353741496598
3155,1499,1250,249,1282,217,0.8338892595063375,0.16611074049366245,0.8552368245496998,0.1447631754503002,1137,157,316,664,913,224,0.13808267370272648,0.27792436235708,0.5839929639401935,0.802990325417766,0.19700967458223395
3156,337,219,118,294,43,0.6498516320474778,0.35014836795252224,0.8724035608308606,0.12759643916913946,548,128,170,250,496,52,0.23357664233576642,0.3102189781021898,0.4562043795620438,0.9051094890510949,0.0948905109489051
3157,1248,1031,217,1092,156,0.8261217948717948,0.17387820512820512,0.875,0.125,1072,155,290,627,851,221,0.14458955223880596,0.27052238805970147,0.5848880597014925,0.7938432835820896,0.20615671641791045
3158,379,238,141,326,53,0.6279683377308707,0.3720316622691293,0.8601583113456465,0.13984168865435356,641,159,218,264,589,52,0.24804992199687986,0.34009360374414976,0.4118564742589704,0.9188767550702028,0.0811232449297972
3159,1283,998,285,1074,209,0.7778643803585347,0.2221356196414653,0.8371005455962588,0.16289945440374123,1165,102,229,834,887,278,0.08755364806866953,0.1965665236051502,0.7158798283261802,0.76137339055794,0.23862660944206007
3160,374,190,184,283,91,0.5080213903743316,0.4919786096256685,0.7566844919786097,0.24331550802139038,259,0,40,219,194,65,0.0,0.15444015444015444,0.8455598455598455,0.749034749034749,0.25096525096525096
3161,699,496,203,567,132,0.709585121602289,0.290414878397711,0.8111587982832618,0.1888412017167382,831,101,343,387,763,68,0.12154031287605295,0.4127557160048135,0.4657039711191336,0.9181708784596871,0.08182912154031288
3162,409,272,137,310,99,0.6650366748166259,0.33496332518337407,0.7579462102689487,0.24205378973105135,583,173,187,223,574,9,0.2967409948542024,0.32075471698113206,0.38250428816466553,0.9845626072041166,0.015437392795883362
3163,1498,1248,250,1282,216,0.8331108144192256,0.16688918558077437,0.855807743658211,0.14419225634178906,1155,166,312,677,929,226,0.14372294372294372,0.2701298701298701,0.5861471861471862,0.8043290043290043,0.19567099567099566
3164,382,202,180,288,94,0.5287958115183246,0.4712041884816754,0.7539267015706806,0.24607329842931938,599,104,152,343,531,68,0.17362270450751252,0.25375626043405675,0.5726210350584308,0.8864774624373957,0.11352253756260434
3165,589,358,231,460,129,0.6078098471986417,0.3921901528013582,0.7809847198641766,0.21901528013582344,752,99,257,396,683,69,0.13164893617021275,0.34175531914893614,0.526595744680851,0.9082446808510638,0.09175531914893617
3166,1247,1031,216,1091,156,0.8267842822774659,0.17321571772253408,0.8748997594226142,0.12510024057738572,1065,156,283,626,844,221,0.14647887323943662,0.26572769953051645,0.5877934272300469,0.7924882629107981,0.20751173708920187
3167,1262,1033,229,1106,156,0.8185419968304279,0.1814580031695721,0.8763866877971473,0.12361331220285261,1098,155,304,639,876,222,0.14116575591985428,0.2768670309653916,0.5819672131147541,0.7978142076502732,0.20218579234972678
3168,896,655,241,745,151,0.7310267857142857,0.2689732142857143,0.8314732142857143,0.16852678571428573,1316,302,452,562,1182,134,0.22948328267477203,0.3434650455927052,0.4270516717325228,0.898176291793313,0.10182370820668693
3169,1134,831,303,914,220,0.7328042328042328,0.2671957671957672,0.8059964726631393,0.19400352733686066,1069,158,366,545,935,134,0.14780168381665107,0.3423760523854069,0.509822263797942,0.8746492048643593,0.1253507951356408
3170,490,291,199,404,86,0.5938775510204082,0.4061224489795918,0.8244897959183674,0.17551020408163265,865,106,247,512,794,71,0.12254335260115606,0.2855491329479769,0.5919075144508671,0.9179190751445087,0.08208092485549133
3171,585,397,188,478,107,0.6786324786324787,0.3213675213675214,0.8170940170940171,0.1829059829059829,1154,278,280,596,996,158,0.24090121317157712,0.24263431542461006,0.5164644714038128,0.8630849220103987,0.1369150779896014
3172,668,471,197,539,129,0.7050898203592815,0.2949101796407186,0.8068862275449101,0.19311377245508982,841,124,320,397,771,70,0.14744351961950058,0.380499405469679,0.47205707491082044,0.9167657550535078,0.08323424494649227
3173,1502,1258,244,1286,216,0.8375499334221038,0.16245006657789615,0.8561917443408789,0.14380825565912117,1170,175,315,680,946,224,0.14957264957264957,0.2692307692307692,0.5811965811965812,0.8085470085470086,0.19145299145299147
3174,62,21,41,33,29,0.3387096774193548,0.6612903225806451,0.532258064516129,0.46774193548387094,530,138,107,285,509,21,0.26037735849056604,0.2018867924528302,0.5377358490566038,0.960377358490566,0.03962264150943396
3175,381,247,134,308,73,0.6482939632545932,0.35170603674540685,0.8083989501312336,0.19160104986876642,645,178,172,295,636,9,0.27596899224806204,0.26666666666666666,0.4573643410852713,0.986046511627907,0.013953488372093023
3176,836,623,213,746,90,0.7452153110047847,0.25478468899521534,0.8923444976076556,0.1076555023923445,959,136,239,584,759,200,0.14181438998957246,0.2492179353493222,0.6089676746611054,0.7914494264859229,0.20855057351407716
3177,962,660,302,741,221,0.6860706860706861,0.31392931392931395,0.7702702702702703,0.22972972972972974,1037,171,345,521,903,134,0.16489874638379942,0.3326904532304725,0.502410800385728,0.8707810993249759,0.12921890067502412
3178,348,213,135,303,45,0.6120689655172413,0.3879310344827586,0.8706896551724138,0.12931034482758622,763,156,257,350,647,116,0.20445609436435125,0.33682830930537355,0.45871559633027525,0.8479685452162516,0.15203145478374835
3179,1250,1031,219,1093,157,0.8248,0.1752,0.8744,0.1256,1069,149,286,634,848,221,0.13938260056127222,0.2675397567820393,0.5930776426566885,0.7932647333956969,0.20673526660430308
3180,1713,1465,248,1472,241,0.8552247518972563,0.14477524810274373,0.8593111500291886,0.14068884997081144,1203,181,330,692,978,225,0.15045719035743974,0.2743142144638404,0.5752285951787198,0.8129675810473815,0.18703241895261846
3181,956,704,252,769,187,0.7364016736401674,0.26359832635983266,0.8043933054393305,0.19560669456066945,1328,249,396,683,1096,232,0.1875,0.29819277108433734,0.5143072289156626,0.8253012048192772,0.1746987951807229
3182,1293,998,295,1084,209,0.7718484145398299,0.22815158546017014,0.8383604021655066,0.16163959783449341,1181,102,235,844,903,278,0.0863674851820491,0.19898391193903472,0.7146486028789162,0.7646062658763759,0.23539373412362405
3183,313,182,131,273,40,0.5814696485623003,0.4185303514376997,0.8722044728434505,0.12779552715654952,624,145,209,270,572,52,0.23237179487179488,0.3349358974358974,0.4326923076923077,0.9166666666666666,0.08333333333333333
3184,153,48,105,145,8,0.3137254901960784,0.6862745098039216,0.9477124183006536,0.05228758169934641,636,128,138,370,582,54,0.20125786163522014,0.2169811320754717,0.5817610062893082,0.9150943396226415,0.08490566037735849
3185,355,221,134,309,46,0.6225352112676056,0.37746478873239436,0.8704225352112676,0.1295774647887324,943,138,254,551,806,137,0.14634146341463414,0.26935312831389185,0.584305408271474,0.8547189819724285,0.14528101802757157
3186,1240,879,361,982,258,0.7088709677419355,0.2911290322580645,0.7919354838709678,0.20806451612903226,1221,102,246,873,943,278,0.08353808353808354,0.20147420147420148,0.714987714987715,0.7723177723177723,0.22768222768222768
3187,1292,998,294,1083,209,0.7724458204334366,0.22755417956656346,0.8382352941176471,0.16176470588235295,1173,102,230,841,895,278,0.08695652173913043,0.19607843137254902,0.7169650468883205,0.763000852514919,0.236999147485081
3188,858,627,231,693,165,0.7307692307692307,0.2692307692307692,0.8076923076923077,0.19230769230769232,827,105,331,391,760,67,0.12696493349455865,0.40024183796856105,0.4727932285368803,0.9189842805320435,0.08101571946795647
3189,1254,1031,223,1097,157,0.8221690590111643,0.17783094098883573,0.8748006379585327,0.1251993620414673,1067,149,282,636,845,222,0.13964386129334583,0.2642924086223055,0.5960637300843487,0.7919400187441424,0.20805998125585753
3190,514,323,191,426,88,0.6284046692607004,0.3715953307392996,0.8287937743190662,0.17120622568093385,973,117,232,624,804,169,0.12024665981500514,0.23843782117163412,0.6413155190133607,0.8263103802672148,0.1736896197327852
3191,1182,898,284,969,213,0.7597292724196277,0.24027072758037224,0.8197969543147208,0.1802030456852792,1225,254,390,581,1055,170,0.2073469387755102,0.3183673469387755,0.4742857142857143,0.8612244897959184,0.13877551020408163
3192,541,370,171,451,90,0.6839186691312384,0.31608133086876156,0.833641404805915,0.16635859519408502,1058,289,280,489,992,66,0.2731568998109641,0.2646502835538752,0.4621928166351607,0.9376181474480151,0.062381852551984876
3193,1261,1031,230,1104,157,0.8176050753370341,0.1823949246629659,0.8754956383822363,0.12450436161776368,1099,149,317,633,878,221,0.13557779799818018,0.28844404003639673,0.5759781619654231,0.7989080982711556,0.2010919017288444
3194,805,560,245,655,150,0.6956521739130435,0.30434782608695654,0.8136645962732919,0.18633540372670807,1074,98,211,765,847,227,0.09124767225325885,0.19646182495344505,0.7122905027932961,0.7886405959031657,0.21135940409683426
3195,711,432,279,504,207,0.6075949367088608,0.3924050632911392,0.7088607594936709,0.2911392405063291,1157,163,237,757,928,229,0.14088159031979255,0.2048401037165082,0.6542783059636992,0.8020743301642178,0.1979256698357822
3196,593,405,188,482,111,0.6829679595278246,0.31703204047217537,0.8128161888701517,0.18718381112984822,1222,277,331,614,1092,130,0.22667757774140754,0.27086743044189854,0.502454991816694,0.8936170212765957,0.10638297872340426
3197,345,224,121,283,62,0.6492753623188405,0.3507246376811594,0.8202898550724638,0.17971014492753623,527,160,175,192,519,8,0.3036053130929791,0.33206831119544594,0.36432637571157495,0.9848197343453511,0.015180265654648957
3198,611,386,225,476,135,0.6317512274959084,0.36824877250409166,0.779050736497545,0.220949263502455,731,106,212,413,659,72,0.14500683994528044,0.29001367989056087,0.5649794801641587,0.9015047879616963,0.09849521203830369
3199,530,356,174,438,92,0.6716981132075471,0.3283018867924528,0.8264150943396227,0.17358490566037735,1074,210,243,621,912,162,0.19553072625698323,0.22625698324022347,0.5782122905027933,0.8491620111731844,0.15083798882681565
3200,304,187,117,263,41,0.6151315789473685,0.3848684210526316,0.8651315789473685,0.13486842105263158,889,153,217,519,800,89,0.172103487064117,0.2440944881889764,0.5838020247469067,0.8998875140607424,0.10011248593925759
3201,1295,998,297,1086,209,0.7706563706563706,0.22934362934362934,0.8386100386100386,0.1613899613899614,1183,102,237,844,905,278,0.08622147083685545,0.2003381234150465,0.7134404057480981,0.7650042265426881,0.23499577345731193
3202,583,401,182,484,99,0.6878216123499142,0.31217838765008576,0.8301886792452831,0.16981132075471697,1192,242,314,636,1058,134,0.20302013422818793,0.2634228187919463,0.5335570469798657,0.8875838926174496,0.11241610738255034
3203,469,302,167,388,81,0.6439232409381663,0.35607675906183367,0.8272921108742004,0.17270788912579957,890,101,186,603,719,171,0.11348314606741573,0.20898876404494382,0.6775280898876405,0.8078651685393259,0.19213483146067414
3204,421,317,104,361,60,0.7529691211401425,0.24703087885985747,0.8574821852731591,0.14251781472684086,420,83,156,181,403,17,0.1976190476190476,0.37142857142857144,0.430952380952381,0.9595238095238096,0.04047619047619048
3205,514,348,166,427,87,0.6770428015564203,0.3229571984435798,0.830739299610895,0.16926070038910507,964,196,229,539,804,160,0.2033195020746888,0.237551867219917,0.5591286307053942,0.8340248962655602,0.16597510373443983
3206,2775,2370,405,2272,503,0.8540540540540541,0.14594594594594595,0.8187387387387387,0.18126126126126127,1521,236,468,817,1193,328,0.15516107823800132,0.3076923076923077,0.537146614069691,0.7843523997370151,0.21564760026298488
3207,338,203,135,298,40,0.6005917159763313,0.3994082840236686,0.8816568047337278,0.11834319526627218,606,131,211,264,554,52,0.21617161716171618,0.3481848184818482,0.43564356435643564,0.9141914191419142,0.0858085808580858
3208,364,236,128,292,72,0.6483516483516484,0.3516483516483517,0.8021978021978022,0.1978021978021978,648,161,166,321,636,12,0.24845679012345678,0.25617283950617287,0.49537037037037035,0.9814814814814815,0.018518518518518517
3209,367,232,135,323,44,0.6321525885558583,0.3678474114441417,0.8801089918256131,0.11989100817438691,797,168,263,366,680,117,0.2107904642409034,0.3299874529485571,0.4592220828105395,0.8531994981179423,0.1468005018820577
3210,838,624,214,749,89,0.7446300715990454,0.2553699284009546,0.8937947494033412,0.10620525059665871,988,142,255,591,787,201,0.1437246963562753,0.25809716599190285,0.5981781376518218,0.7965587044534413,0.2034412955465587
3211,494,321,173,409,85,0.6497975708502024,0.35020242914979755,0.8279352226720648,0.1720647773279352,781,107,200,474,709,72,0.13700384122919335,0.2560819462227913,0.6069142125480154,0.9078104993597952,0.09218950064020487
3212,346,216,130,302,44,0.6242774566473989,0.37572254335260113,0.8728323699421965,0.12716763005780346,709,138,247,324,593,116,0.19464033850493653,0.34837799717912554,0.45698166431593795,0.8363892806770099,0.16361071932299012
3213,483,308,175,400,83,0.6376811594202898,0.36231884057971014,0.8281573498964804,0.17184265010351968,812,117,205,490,741,71,0.1440886699507389,0.2524630541871921,0.603448275862069,0.9125615763546798,0.0874384236453202
3214,1292,998,294,1083,209,0.7724458204334366,0.22755417956656346,0.8382352941176471,0.16176470588235295,1177,102,234,841,899,278,0.08666100254885302,0.1988105352591334,0.7145284621920136,0.7638062871707731,0.23619371282922685
3215,1523,1275,248,1306,217,0.8371634931057124,0.16283650689428758,0.8575180564674983,0.14248194353250165,1159,163,313,683,933,226,0.14063848144952545,0.270060396893874,0.5893011216566005,0.8050043140638481,0.19499568593615185
3216,1505,1256,249,1288,217,0.8345514950166113,0.1654485049833887,0.8558139534883721,0.14418604651162792,1181,175,317,689,956,225,0.14817950889077053,0.26841659610499574,0.5834038950042337,0.8094834885690093,0.1905165114309907
3217,1336,1033,303,1091,245,0.7732035928143712,0.22679640718562874,0.8166167664670658,0.18338323353293412,1010,129,340,541,874,136,0.12772277227722773,0.33663366336633666,0.5356435643564357,0.8653465346534653,0.13465346534653466
3218,1332,1001,331,1054,278,0.7515015015015015,0.2484984984984985,0.7912912912912913,0.2087087087087087,1203,102,244,857,925,278,0.08478802992518704,0.2028262676641729,0.71238570241064,0.7689110556940981,0.2310889443059019
3219,1551,1300,251,1331,220,0.8381689232753062,0.16183107672469374,0.8581560283687943,0.14184397163120568,1150,160,316,674,924,226,0.1391304347826087,0.2747826086956522,0.5860869565217391,0.8034782608695652,0.19652173913043477
3220,1529,1228,301,1309,220,0.8031393067364291,0.19686069326357097,0.8561151079136691,0.14388489208633093,1279,259,449,571,1143,136,0.20250195465207194,0.35105551211884284,0.4464425332290852,0.893666927286943,0.10633307271305707
3221,547,388,159,452,95,0.7093235831809872,0.2906764168190128,0.8263254113345521,0.1736745886654479,841,138,195,508,774,67,0.16409036860879905,0.2318668252080856,0.6040428061831153,0.920332936979786,0.07966706302021404
3222,456,271,185,372,84,0.5942982456140351,0.4057017543859649,0.8157894736842105,0.18421052631578946,636,101,164,371,570,66,0.15880503144654087,0.2578616352201258,0.5833333333333334,0.8962264150943396,0.10377358490566038
3223,410,199,211,322,88,0.4853658536585366,0.5146341463414634,0.7853658536585366,0.2146341463414634,689,98,203,388,622,67,0.14223512336719885,0.2946298984034833,0.5631349782293179,0.9027576197387518,0.09724238026124818
3224,777,539,238,629,148,0.6936936936936937,0.3063063063063063,0.8095238095238095,0.19047619047619047,1074,98,206,770,846,228,0.09124767225325885,0.19180633147113593,0.7169459962756052,0.7877094972067039,0.2122905027932961
3225,324,197,127,284,40,0.6080246913580247,0.39197530864197533,0.8765432098765432,0.12345679012345678,618,152,206,260,566,52,0.2459546925566343,0.3333333333333333,0.42071197411003236,0.9158576051779935,0.08414239482200647
3226,365,225,140,318,47,0.6164383561643836,0.3835616438356164,0.8712328767123287,0.12876712328767123,635,154,215,266,583,52,0.24251968503937008,0.33858267716535434,0.4188976377952756,0.9181102362204724,0.08188976377952756
3227,451,267,184,369,82,0.5920177383592018,0.4079822616407982,0.8181818181818182,0.18181818181818182,620,99,155,366,552,68,0.1596774193548387,0.25,0.5903225806451613,0.8903225806451613,0.10967741935483871
3228,1098,849,249,910,188,0.773224043715847,0.226775956284153,0.8287795992714025,0.17122040072859745,1314,310,444,560,1171,143,0.2359208523592085,0.3378995433789954,0.426179604261796,0.89117199391172,0.10882800608828005
3229,1241,1032,209,1084,157,0.8315874294923449,0.16841257050765512,0.8734891216760677,0.12651087832393232,1054,149,276,629,832,222,0.1413662239089184,0.2618595825426945,0.5967741935483871,0.7893738140417458,0.21062618595825428
3230,318,193,125,271,47,0.6069182389937107,0.39308176100628933,0.8522012578616353,0.14779874213836477,672,113,179,380,615,57,0.16815476190476192,0.2663690476190476,0.5654761904761905,0.9151785714285714,0.08482142857142858
3231,576,359,217,453,123,0.6232638888888888,0.3767361111111111,0.7864583333333334,0.21354166666666666,802,125,245,432,728,74,0.15586034912718205,0.3054862842892768,0.5386533665835411,0.9077306733167082,0.09226932668329177
3232,397,198,199,310,87,0.4987405541561713,0.5012594458438288,0.7808564231738035,0.21914357682619648,719,114,202,403,648,71,0.15855354659248957,0.2809457579972184,0.5605006954102921,0.9012517385257302,0.09874826147426982
3233,763,553,210,612,151,0.7247706422018348,0.27522935779816515,0.8020969855832241,0.19790301441677588,851,95,365,391,782,69,0.11163337250293771,0.4289071680376028,0.4594594594594595,0.918918918918919,0.08108108108108109
3234,606,377,229,476,130,0.6221122112211221,0.3778877887788779,0.7854785478547854,0.2145214521452145,772,114,242,416,698,74,0.14766839378238342,0.3134715025906736,0.538860103626943,0.9041450777202072,0.09585492227979274
3235,829,331,498,535,294,0.39927623642943305,0.6007237635705669,0.6453558504221955,0.3546441495778046,342,51,112,179,335,7,0.14912280701754385,0.32748538011695905,0.5233918128654971,0.97953216374269,0.02046783625730994
3236,1503,1256,247,1287,216,0.8356620093147039,0.1643379906852961,0.8562874251497006,0.1437125748502994,1151,163,315,673,927,224,0.1416159860990443,0.2736750651607298,0.5847089487402259,0.8053866203301477,0.19461337966985232
3237,579,399,180,483,96,0.689119170984456,0.31088082901554404,0.8341968911917098,0.16580310880829016,1278,274,302,702,1110,168,0.21439749608763695,0.23630672926447574,0.5492957746478874,0.8685446009389671,0.13145539906103287
3238,4235,3730,505,3576,659,0.8807556080283353,0.1192443919716647,0.8443919716646989,0.15560802833530107,2028,242,522,1264,1623,405,0.11932938856015779,0.257396449704142,0.6232741617357002,0.8002958579881657,0.1997041420118343
3239,583,397,186,483,100,0.6809605488850772,0.3190394511149228,0.8284734133790738,0.17152658662092624,1244,289,322,633,1108,136,0.23231511254019294,0.25884244372990356,0.5088424437299035,0.8906752411575563,0.10932475884244373
3240,462,145,317,291,171,0.31385281385281383,0.6861471861471862,0.6298701298701299,0.37012987012987014,132,3,49,80,131,1,0.022727272727272728,0.3712121212121212,0.6060606060606061,0.9924242424242424,0.007575757575757576
3241,576,384,192,473,103,0.6666666666666666,0.3333333333333333,0.8211805555555556,0.17881944444444445,731,117,212,402,657,74,0.1600547195622435,0.29001367989056087,0.5499316005471956,0.8987688098495212,0.1012311901504788
3242,668,476,192,537,131,0.7125748502994012,0.2874251497005988,0.8038922155688623,0.19610778443113772,852,142,322,388,783,69,0.16666666666666666,0.3779342723004695,0.45539906103286387,0.9190140845070423,0.08098591549295775
3243,1252,1032,220,1095,157,0.8242811501597445,0.1757188498402556,0.8746006389776357,0.1253993610223642,1062,149,270,643,840,222,0.14030131826741996,0.2542372881355932,0.6054613935969868,0.7909604519774012,0.20903954802259886
3244,338,222,116,295,43,0.6568047337278107,0.3431952662721893,0.8727810650887574,0.12721893491124261,835,140,214,481,714,121,0.16766467065868262,0.2562874251497006,0.5760479041916168,0.8550898203592814,0.14491017964071856
3245,343,213,130,299,44,0.6209912536443148,0.37900874635568516,0.8717201166180758,0.1282798833819242,841,118,227,496,719,122,0.1403091557669441,0.2699167657550535,0.5897740784780023,0.8549346016646849,0.1450653983353151
3246,1246,1031,215,1089,157,0.8274478330658106,0.1725521669341894,0.8739967897271268,0.1260032102728732,1055,149,279,627,833,222,0.14123222748815165,0.26445497630331755,0.5943127962085308,0.7895734597156399,0.2104265402843602
3247,1261,1051,210,1103,158,0.8334655035685964,0.16653449643140364,0.8747026169706582,0.1252973830293418,1071,155,270,646,849,222,0.14472455648926238,0.25210084033613445,0.6031746031746031,0.7927170868347339,0.20728291316526612
3248,1845,1520,325,1534,311,0.8238482384823849,0.17615176151761516,0.8314363143631436,0.16856368563685636,1229,211,431,587,1078,151,0.17168429617575265,0.3506916192026037,0.47762408462164363,0.8771358828315704,0.12286411716842961
3249,1440,1198,242,1232,208,0.8319444444444445,0.16805555555555557,0.8555555555555555,0.14444444444444443,1144,163,311,670,918,226,0.14248251748251747,0.2718531468531469,0.5856643356643356,0.8024475524475524,0.19755244755244755
3250,1247,1033,214,1091,156,0.8283881315156375,0.17161186848436247,0.8748997594226142,0.12510024057738572,1066,155,275,636,844,222,0.14540337711069418,0.2579737335834897,0.5966228893058161,0.7917448405253283,0.20825515947467166
3251,597,417,180,499,98,0.6984924623115578,0.3015075376884422,0.8358458961474037,0.16415410385259632,1439,269,323,847,1185,254,0.18693537178596248,0.22446143154968728,0.5886031966643502,0.8234885337039611,0.17651146629603892
3252,1434,1110,324,1199,235,0.7740585774058577,0.22594142259414227,0.8361227336122734,0.16387726638772665,1195,93,237,865,910,285,0.07782426778242678,0.198326359832636,0.7238493723849372,0.7615062761506276,0.2384937238493724
3253,525,360,165,430,95,0.6857142857142857,0.3142857142857143,0.819047619047619,0.18095238095238095,947,244,250,453,881,66,0.2576557550158395,0.26399155227032733,0.4783526927138332,0.9303062302006336,0.06969376979936642
3254,405,257,148,358,47,0.6345679012345679,0.3654320987654321,0.8839506172839506,0.11604938271604938,855,168,292,395,736,119,0.19649122807017544,0.34152046783625734,0.4619883040935672,0.8608187134502924,0.1391812865497076
3255,565,351,214,449,116,0.6212389380530974,0.3787610619469027,0.7946902654867256,0.20530973451327433,791,123,249,419,718,73,0.1554993678887484,0.3147914032869785,0.5297092288242731,0.9077117572692794,0.0922882427307206
3256,1293,998,295,1084,209,0.7718484145398299,0.22815158546017014,0.8383604021655066,0.16163959783449341,1181,102,235,844,903,278,0.0863674851820491,0.19898391193903472,0.7146486028789162,0.7646062658763759,0.23539373412362405
3257,1244,1031,213,1087,157,0.8287781350482315,0.1712218649517685,0.8737942122186495,0.12620578778135047,1044,149,265,630,823,221,0.14272030651340997,0.25383141762452105,0.603448275862069,0.7883141762452107,0.21168582375478928
3258,1286,998,288,1077,209,0.776049766718507,0.223950233281493,0.8374805598755832,0.1625194401244168,1170,102,230,838,892,278,0.08717948717948718,0.19658119658119658,0.7162393162393162,0.7623931623931623,0.2376068376068376
3259,1110,857,253,916,194,0.7720720720720721,0.22792792792792793,0.8252252252252252,0.17477477477477477,799,102,298,399,731,68,0.1276595744680851,0.37296620775969963,0.49937421777221525,0.9148936170212766,0.0851063829787234
3260,553,374,179,448,105,0.6763110307414105,0.32368896925858953,0.810126582278481,0.189873417721519,939,224,241,474,875,64,0.23855165069222578,0.2566560170394036,0.5047923322683706,0.9318423855165069,0.06815761448349308
3261,1106,865,241,932,174,0.7820976491862568,0.2179023508137432,0.8426763110307414,0.15732368896925858,1123,229,404,490,980,143,0.20391807658058772,0.3597506678539626,0.4363312555654497,0.8726625111308994,0.12733748886910062
3262,326,200,126,285,41,0.6134969325153374,0.38650306748466257,0.8742331288343558,0.12576687116564417,782,151,217,414,726,56,0.19309462915601022,0.2774936061381074,0.5294117647058824,0.928388746803069,0.07161125319693094
3263,1289,1001,288,1078,211,0.7765709852598914,0.22342901474010862,0.8363072148952676,0.16369278510473234,1172,102,233,837,894,278,0.08703071672354949,0.19880546075085323,0.7141638225255973,0.7627986348122867,0.23720136518771331
3264,633,404,229,552,81,0.6382306477093207,0.3617693522906793,0.8720379146919431,0.12796208530805686,962,77,159,726,735,227,0.08004158004158005,0.1652806652806653,0.7546777546777547,0.764033264033264,0.23596673596673598
3265,585,403,182,486,99,0.6888888888888889,0.3111111111111111,0.8307692307692308,0.16923076923076924,1073,249,276,548,1005,68,0.2320596458527493,0.2572227399813607,0.51071761416589,0.9366262814538676,0.06337371854613234
3266,141,86,55,54,87,0.6099290780141844,0.3900709219858156,0.3829787234042553,0.6170212765957447,44,0,26,18,43,1,0.0,0.5909090909090909,0.4090909090909091,0.9772727272727273,0.022727272727272728
3267,1509,1268,241,1295,214,0.8402915838303512,0.1597084161696488,0.8581842279655401,0.1418157720344599,1197,181,324,692,971,226,0.15121136173767752,0.2706766917293233,0.5781119465329991,0.8111946532999165,0.18880534670008353
3268,308,183,125,266,42,0.5941558441558441,0.40584415584415584,0.8636363636363636,0.13636363636363635,589,130,190,269,535,54,0.22071307300509338,0.3225806451612903,0.4567062818336163,0.9083191850594228,0.09168081494057725
3269,1241,1032,209,1084,157,0.8315874294923449,0.16841257050765512,0.8734891216760677,0.12651087832393232,1040,149,265,626,818,222,0.14326923076923076,0.2548076923076923,0.6019230769230769,0.7865384615384615,0.21346153846153845
3270,359,242,117,302,57,0.6740947075208914,0.32590529247910865,0.841225626740947,0.15877437325905291,509,149,179,181,501,8,0.29273084479371314,0.3516699410609037,0.3555992141453831,0.9842829076620825,0.015717092337917484
3271,1519,1269,250,1302,217,0.8354180381830152,0.16458196181698487,0.8571428571428571,0.14285714285714285,1181,172,321,688,957,224,0.14563928873835733,0.2718035563082134,0.5825571549534293,0.8103302286198137,0.1896697713801863
3272,375,231,144,327,48,0.616,0.384,0.872,0.128,774,133,257,384,656,118,0.17183462532299743,0.33204134366925064,0.49612403100775193,0.8475452196382429,0.1524547803617571
3273,567,346,221,448,119,0.6102292768959435,0.3897707231040564,0.7901234567901234,0.20987654320987653,792,113,242,437,721,71,0.14267676767676768,0.3055555555555556,0.5517676767676768,0.9103535353535354,0.08964646464646464
3274,517,332,185,427,90,0.6421663442940039,0.3578336557059961,0.8259187620889749,0.17408123791102514,781,105,202,474,710,71,0.13444302176696543,0.2586427656850192,0.6069142125480154,0.9090909090909091,0.09090909090909091
3275,139,72,67,47,92,0.5179856115107914,0.48201438848920863,0.3381294964028777,0.6618705035971223,381,184,152,45,381,0,0.48293963254593175,0.3989501312335958,0.11811023622047244,1.0,0.0
3276,326,203,123,286,40,0.6226993865030674,0.3773006134969325,0.8773006134969326,0.12269938650306748,587,135,190,262,534,53,0.22998296422487224,0.32367972742759793,0.4463373083475298,0.909710391822828,0.09028960817717206
3277,2751,2330,421,2227,524,0.8469647400945111,0.1530352599054889,0.8095238095238095,0.19047619047619047,1418,252,464,702,1222,196,0.1777150916784203,0.32722143864598024,0.49506346967559944,0.8617771509167842,0.1382228490832158
3278,436,242,194,333,103,0.555045871559633,0.44495412844036697,0.7637614678899083,0.23623853211009174,608,103,161,344,541,67,0.16940789473684212,0.26480263157894735,0.5657894736842105,0.8898026315789473,0.11019736842105263
3279,824,625,199,735,89,0.758495145631068,0.24150485436893204,0.8919902912621359,0.10800970873786407,966,142,239,585,765,201,0.14699792960662525,0.2474120082815735,0.6055900621118012,0.7919254658385093,0.2080745341614907
3280,462,283,179,382,80,0.6125541125541125,0.3874458874458874,0.8268398268398268,0.17316017316017315,848,117,205,526,775,73,0.13797169811320756,0.2417452830188679,0.6202830188679245,0.9139150943396226,0.08608490566037735
3281,343,209,134,300,43,0.60932944606414,0.39067055393586003,0.8746355685131195,0.12536443148688048,656,168,225,263,604,52,0.25609756097560976,0.3429878048780488,0.4009146341463415,0.9207317073170732,0.07926829268292683
3282,1593,1279,314,1334,259,0.802887633396108,0.19711236660389203,0.837413684871312,0.162586315128688,1258,242,436,580,1110,148,0.19236883942766295,0.3465818759936407,0.4610492845786963,0.8823529411764706,0.11764705882352941
3283,601,402,199,480,121,0.6688851913477537,0.33111480865224624,0.7986688851913477,0.20133111480865223,1180,332,294,554,1112,68,0.28135593220338984,0.24915254237288137,0.4694915254237288,0.9423728813559322,0.0576271186440678
3284,1227,900,327,988,239,0.7334963325183375,0.2665036674816626,0.8052159739201304,0.1947840260798696,1176,101,244,831,902,274,0.0858843537414966,0.20748299319727892,0.7066326530612245,0.7670068027210885,0.23299319727891157
3285,464,290,174,384,80,0.625,0.375,0.8275862068965517,0.1724137931034483,750,95,204,451,680,70,0.12666666666666668,0.272,0.6013333333333334,0.9066666666666666,0.09333333333333334
3286,891,638,253,729,162,0.7160493827160493,0.2839506172839506,0.8181818181818182,0.18181818181818182,1154,209,401,544,1015,139,0.18110918544194107,0.34748700173310226,0.4714038128249567,0.8795493934142115,0.12045060658578856
3287,307,186,121,267,40,0.6058631921824105,0.3941368078175896,0.8697068403908795,0.13029315960912052,609,144,202,263,556,53,0.23645320197044334,0.33169129720853857,0.4318555008210181,0.9129720853858785,0.08702791461412152
3288,177,91,86,71,106,0.5141242937853108,0.4858757062146893,0.4011299435028249,0.5988700564971752,473,227,204,42,473,0,0.4799154334038055,0.4312896405919662,0.08879492600422834,1.0,0.0
3289,457,282,175,376,81,0.6170678336980306,0.38293216630196936,0.8227571115973742,0.1772428884026258,824,119,233,472,752,72,0.14441747572815533,0.2827669902912621,0.5728155339805825,0.912621359223301,0.08737864077669903
3290,335,218,117,286,49,0.6507462686567164,0.3492537313432836,0.8537313432835821,0.14626865671641792,886,142,238,506,763,123,0.16027088036117382,0.2686230248306998,0.5711060948081265,0.8611738148984198,0.13882618510158012
3291,1509,1262,247,1293,216,0.8363154406891982,0.16368455931080186,0.856858846918489,0.14314115308151093,1195,181,328,686,969,226,0.1514644351464435,0.2744769874476987,0.5740585774058578,0.8108786610878661,0.1891213389121339
3292,1283,998,285,1074,209,0.7778643803585347,0.2221356196414653,0.8371005455962588,0.16289945440374123,1165,102,229,834,887,278,0.08755364806866953,0.1965665236051502,0.7158798283261802,0.76137339055794,0.23862660944206007
3293,641,441,200,504,137,0.6879875195007801,0.31201248049922,0.7862714508580343,0.21372854914196568,800,105,321,374,733,67,0.13125,0.40125,0.4675,0.91625,0.08375
3294,773,522,251,612,161,0.6752910737386805,0.32470892626131953,0.7917205692108668,0.20827943078913325,765,106,224,435,692,73,0.13856209150326798,0.2928104575163399,0.5686274509803921,0.9045751633986928,0.09542483660130718
3295,340,213,127,296,44,0.6264705882352941,0.3735294117647059,0.8705882352941177,0.12941176470588237,668,108,224,336,550,118,0.16167664670658682,0.33532934131736525,0.5029940119760479,0.8233532934131736,0.17664670658682635
3296,492,315,177,409,83,0.6402439024390244,0.3597560975609756,0.8313008130081301,0.16869918699186992,827,95,207,525,752,75,0.11487303506650544,0.2503022974607013,0.6348246674727932,0.909310761789601,0.09068923821039904
3297,322,195,127,281,41,0.6055900621118012,0.3944099378881988,0.8726708074534162,0.12732919254658384,594,133,198,263,541,53,0.2239057239057239,0.3333333333333333,0.44276094276094274,0.9107744107744108,0.08922558922558922
3298,840,574,266,677,163,0.6833333333333333,0.31666666666666665,0.805952380952381,0.19404761904761905,1082,103,207,772,855,227,0.09519408502772643,0.1913123844731978,0.7134935304990758,0.7902033271719039,0.2097966728280961
3299,1287,998,289,1078,209,0.7754467754467754,0.22455322455322455,0.8376068376068376,0.1623931623931624,1167,102,229,836,889,278,0.08740359897172237,0.19622964867180806,0.7163667523564696,0.7617823479005998,0.23821765209940018
3300,1315,1040,275,1079,236,0.7908745247148289,0.20912547528517111,0.820532319391635,0.17946768060836502,1216,171,355,690,955,261,0.140625,0.29194078947368424,0.5674342105263158,0.7853618421052632,0.21463815789473684
3301,577,89,488,275,302,0.15424610051993068,0.8457538994800693,0.47660311958405543,0.5233968804159446,470,0,243,227,470,0,0.0,0.5170212765957447,0.4829787234042553,1.0,0.0
3302,771,543,228,621,150,0.7042801556420234,0.29571984435797666,0.8054474708171206,0.19455252918287938,1146,214,374,558,1009,137,0.18673647469458987,0.3263525305410122,0.4869109947643979,0.8804537521815009,0.11954624781849912
3303,1237,880,357,979,258,0.7113985448666128,0.28860145513338725,0.7914308811641068,0.2085691188358933,1222,102,248,872,944,278,0.08346972176759411,0.20294599018003273,0.7135842880523732,0.7725040916530278,0.22749590834697217
3304,340,210,130,296,44,0.6176470588235294,0.38235294117647056,0.8705882352941177,0.12941176470588237,721,144,235,342,605,116,0.19972260748959778,0.3259361997226075,0.47434119278779474,0.8391123439667129,0.1608876560332871
3305,1300,1001,299,1089,211,0.77,0.23,0.8376923076923077,0.16230769230769232,1188,102,238,848,910,278,0.08585858585858586,0.20033670033670034,0.7138047138047138,0.765993265993266,0.234006734006734
3306,453,285,168,371,82,0.6291390728476821,0.3708609271523179,0.8189845474613686,0.18101545253863136,814,104,199,511,740,74,0.12776412776412777,0.24447174447174447,0.6277641277641277,0.9090909090909091,0.09090909090909091
3307,474,296,178,389,85,0.6244725738396625,0.3755274261603376,0.820675105485232,0.17932489451476794,815,103,194,518,741,74,0.1263803680981595,0.23803680981595093,0.6355828220858896,0.90920245398773,0.09079754601226994
3308,1521,1275,246,1305,216,0.8382642998027613,0.16173570019723865,0.8579881656804734,0.14201183431952663,1209,181,331,697,983,226,0.14971050454921422,0.2737799834574028,0.576509511993383,0.8130686517783292,0.1869313482216708
3309,432,249,183,355,77,0.5763888888888888,0.4236111111111111,0.8217592592592593,0.17824074074074073,603,92,155,356,536,67,0.15257048092868988,0.2570480928689884,0.5903814262023217,0.8888888888888888,0.1111111111111111
3310,565,365,200,445,120,0.6460176991150443,0.35398230088495575,0.7876106194690266,0.21238938053097345,771,119,232,420,698,73,0.1543450064850843,0.3009079118028534,0.5447470817120622,0.9053177691309987,0.0946822308690013
3311,1253,1035,218,1096,157,0.8260175578611333,0.1739824421388667,0.8747007182761373,0.12529928172386273,1043,149,267,627,821,222,0.14285714285714285,0.25599232981783315,0.6011505273250239,0.7871524448705657,0.21284755512943432
3312,319,195,124,277,42,0.6112852664576802,0.3887147335423197,0.8683385579937304,0.13166144200626959,579,135,196,248,526,53,0.23316062176165803,0.3385146804835924,0.4283246977547496,0.9084628670120898,0.09153713298791019
3313,379,258,121,329,50,0.6807387862796834,0.31926121372031663,0.8680738786279684,0.13192612137203166,837,149,237,451,716,121,0.17801672640382318,0.2831541218637993,0.5388291517323776,0.8554360812425329,0.14456391875746716
3314,321,203,118,280,41,0.632398753894081,0.367601246105919,0.8722741433021807,0.1277258566978193,661,192,218,251,609,52,0.29046898638426627,0.329803328290469,0.37972768532526474,0.9213313161875946,0.07866868381240545
3315,315,184,131,269,46,0.5841269841269842,0.4158730158730159,0.8539682539682539,0.14603174603174604,695,122,181,392,638,57,0.17553956834532375,0.260431654676259,0.5640287769784172,0.9179856115107914,0.08201438848920864
3316,1450,1118,332,1181,269,0.7710344827586207,0.2289655172413793,0.8144827586206896,0.18551724137931033,1116,129,348,639,880,236,0.11559139784946236,0.3118279569892473,0.5725806451612904,0.7885304659498208,0.2114695340501792
3317,415,231,184,319,96,0.5566265060240964,0.4433734939759036,0.7686746987951807,0.23132530120481928,663,123,180,360,595,68,0.18552036199095023,0.27149321266968324,0.5429864253393665,0.8974358974358975,0.10256410256410256
3318,559,379,180,470,89,0.6779964221824687,0.3220035778175313,0.8407871198568873,0.1592128801431127,1180,288,341,551,1052,128,0.2440677966101695,0.2889830508474576,0.4669491525423729,0.8915254237288136,0.10847457627118644
3319,339,225,114,296,43,0.6637168141592921,0.336283185840708,0.8731563421828908,0.12684365781710916,701,151,237,313,585,116,0.21540656205420827,0.33808844507845937,0.44650499286733236,0.8345221112696148,0.16547788873038516
3320,468,260,208,351,117,0.5555555555555556,0.4444444444444444,0.75,0.25,640,116,157,367,572,68,0.18125,0.2453125,0.5734375,0.89375,0.10625
3321,222,95,127,193,29,0.42792792792792794,0.5720720720720721,0.8693693693693694,0.13063063063063063,593,76,129,388,408,185,0.1281618887015177,0.2175379426644182,0.654300168634064,0.688026981450253,0.31197301854974707
3322,551,379,172,451,100,0.6878402903811253,0.3121597096188748,0.8185117967332124,0.18148820326678766,1105,262,300,543,977,128,0.23710407239819004,0.27149321266968324,0.49140271493212667,0.8841628959276018,0.1158371040723982
3323,502,332,170,413,89,0.6613545816733067,0.3386454183266932,0.8227091633466136,0.17729083665338646,778,95,175,508,705,73,0.12210796915167095,0.2249357326478149,0.6529562982005142,0.9061696658097687,0.09383033419023136
3324,396,209,187,300,96,0.5277777777777778,0.4722222222222222,0.7575757575757576,0.24242424242424243,571,89,142,340,504,67,0.15586690017513136,0.2486865148861646,0.5954465849387041,0.882661996497373,0.11733800350262696
3325,457,279,178,376,81,0.6105032822757112,0.38949671772428884,0.8227571115973742,0.1772428884026258,915,112,228,575,748,167,0.12240437158469945,0.24918032786885247,0.6284153005464481,0.8174863387978142,0.1825136612021858
3326,370,230,140,313,57,0.6216216216216216,0.3783783783783784,0.845945945945946,0.15405405405405406,708,129,254,325,592,116,0.18220338983050846,0.3587570621468927,0.4590395480225989,0.8361581920903954,0.1638418079096045
3327,1608,1344,264,1381,227,0.835820895522388,0.16417910447761194,0.8588308457711443,0.14116915422885573,1164,167,316,681,939,225,0.14347079037800686,0.27147766323024053,0.5850515463917526,0.8067010309278351,0.19329896907216496
3328,1161,879,282,903,258,0.7571059431524548,0.24289405684754523,0.7777777777777778,0.2222222222222222,1156,102,230,824,878,278,0.08823529411764706,0.19896193771626297,0.71280276816609,0.759515570934256,0.24048442906574394
3329,569,407,162,475,94,0.7152899824253075,0.28471001757469244,0.8347978910369068,0.16520210896309315,1318,317,320,681,1087,231,0.24051593323216997,0.24279210925644917,0.5166919575113809,0.8247344461305007,0.17526555386949924
3330,652,452,200,526,126,0.6932515337423313,0.3067484662576687,0.8067484662576687,0.19325153374233128,1281,247,291,743,1052,229,0.19281811085089773,0.22716627634660422,0.580015612802498,0.8212334113973458,0.17876658860265418
3331,380,236,144,318,62,0.6210526315789474,0.37894736842105264,0.8368421052631579,0.1631578947368421,1020,209,285,526,898,122,0.20490196078431372,0.27941176470588236,0.515686274509804,0.8803921568627451,0.11960784313725491
3332,1268,1053,215,1110,158,0.830441640378549,0.1695583596214511,0.8753943217665615,0.12460567823343849,1060,155,269,636,838,222,0.14622641509433962,0.2537735849056604,0.6,0.7905660377358491,0.20943396226415095
3333,346,218,128,302,44,0.630057803468208,0.3699421965317919,0.8728323699421965,0.12716763005780346,698,135,235,328,582,116,0.19340974212034384,0.336676217765043,0.4699140401146132,0.833810888252149,0.166189111747851
3334,1261,1022,239,1027,234,0.8104678826328311,0.1895321173671689,0.8144329896907216,0.18556701030927836,1274,219,396,659,1023,251,0.17189952904238617,0.3108320251177394,0.5172684458398744,0.8029827315541601,0.1970172684458399
3335,1237,921,316,1001,236,0.7445432497978981,0.25545675020210185,0.809215844785772,0.19078415521422798,1486,318,465,703,1251,235,0.21399730820995963,0.31292059219380886,0.4730820995962315,0.84185733512786,0.15814266487213996
3336,449,249,200,341,108,0.5545657015590201,0.44543429844098,0.7594654788418709,0.24053452115812918,628,110,159,359,561,67,0.1751592356687898,0.2531847133757962,0.571656050955414,0.893312101910828,0.10668789808917198
3337,390,203,187,297,93,0.5205128205128206,0.4794871794871795,0.7615384615384615,0.23846153846153847,589,95,156,338,522,67,0.16129032258064516,0.26485568760611206,0.5738539898132428,0.8862478777589134,0.11375212224108659
3338,340,213,127,296,44,0.6264705882352941,0.3735294117647059,0.8705882352941177,0.12941176470588237,931,148,249,534,802,129,0.158968850698174,0.26745435016111707,0.5735767991407089,0.8614393125671321,0.1385606874328679
3339,329,194,135,288,41,0.5896656534954408,0.41033434650455924,0.8753799392097265,0.12462006079027356,659,151,236,272,607,52,0.2291350531107739,0.3581183611532625,0.41274658573596357,0.921092564491654,0.07890743550834597
3340,1234,1032,202,1077,157,0.8363047001620746,0.16369529983792544,0.8727714748784441,0.1272285251215559,1026,149,246,631,804,222,0.145224171539961,0.23976608187134502,0.615009746588694,0.783625730994152,0.21637426900584794
3341,406,226,180,332,74,0.5566502463054187,0.4433497536945813,0.8177339901477833,0.18226600985221675,645,117,164,364,577,68,0.1813953488372093,0.25426356589147286,0.5643410852713179,0.8945736434108527,0.10542635658914729
3342,469,297,172,388,81,0.6332622601279317,0.36673773987206826,0.8272921108742004,0.17270788912579957,872,92,207,573,705,167,0.10550458715596331,0.23738532110091742,0.6571100917431193,0.8084862385321101,0.1915137614678899
3343,607,380,227,472,135,0.6260296540362438,0.37397034596375617,0.7775947281713345,0.22240527182866557,796,123,265,408,725,71,0.15452261306532664,0.33291457286432163,0.5125628140703518,0.9108040201005025,0.08919597989949749
3344,1263,1031,232,1106,157,0.8163103721298496,0.18368962787015045,0.8756927949326999,0.12430720506730007,1065,149,282,634,844,221,0.13990610328638498,0.2647887323943662,0.5953051643192488,0.7924882629107981,0.20751173708920187
3345,401,222,179,315,86,0.5536159600997507,0.4463840399002494,0.7855361596009975,0.2144638403990025,598,93,162,343,530,68,0.15551839464882944,0.2709030100334448,0.5735785953177257,0.8862876254180602,0.11371237458193979
3346,986,714,272,794,192,0.7241379310344828,0.27586206896551724,0.8052738336713996,0.1947261663286004,1528,359,483,686,1288,240,0.2349476439790576,0.3160994764397906,0.4489528795811518,0.8429319371727748,0.15706806282722513
3347,346,207,139,299,47,0.5982658959537572,0.40173410404624277,0.8641618497109826,0.13583815028901733,854,130,258,466,733,121,0.1522248243559719,0.30210772833723654,0.5456674473067916,0.8583138173302107,0.14168618266978922
3348,1249,1033,216,1093,156,0.8270616493194556,0.17293835068054444,0.8751000800640513,0.12489991993594876,1071,156,288,627,849,222,0.14565826330532214,0.2689075630252101,0.5854341736694678,0.7927170868347339,0.20728291316526612
3349,1519,1270,249,1302,217,0.8360763660302831,0.16392363396971693,0.8571428571428571,0.14285714285714285,1207,181,330,696,981,226,0.1499585749792875,0.27340513670256833,0.5766362883181442,0.8127589063794531,0.1872410936205468
3350,347,220,127,297,50,0.6340057636887608,0.3659942363112392,0.8559077809798271,0.1440922190201729,694,131,224,339,577,117,0.18876080691642652,0.3227665706051873,0.4884726224783862,0.8314121037463977,0.1685878962536023
3351,1315,1083,232,1148,167,0.823574144486692,0.17642585551330797,0.8730038022813689,0.1269961977186312,1070,149,293,628,849,221,0.13925233644859814,0.2738317757009346,0.5869158878504673,0.7934579439252336,0.20654205607476636
3352,1443,1082,361,1135,308,0.7498267498267498,0.25017325017325015,0.7865557865557865,0.21344421344421344,1402,277,449,676,1179,223,0.19757489300998574,0.3202567760342368,0.48216833095577744,0.8409415121255349,0.15905848787446505
3353,1275,1046,229,1117,158,0.8203921568627451,0.1796078431372549,0.876078431372549,0.12392156862745098,1090,149,299,642,868,222,0.13669724770642203,0.2743119266055046,0.5889908256880734,0.7963302752293578,0.2036697247706422
3354,1031,756,275,824,207,0.7332686711930165,0.2667313288069835,0.7992240543161979,0.20077594568380214,1343,243,436,664,1106,237,0.18093819806403574,0.3246463142218913,0.49441548771407295,0.8235294117647058,0.17647058823529413
3355,1578,1299,279,1323,255,0.8231939163498099,0.17680608365019013,0.8384030418250951,0.16159695817490494,1107,228,304,575,959,148,0.20596205962059622,0.27461607949412825,0.5194218608852755,0.8663053297199639,0.13369467028003612
3356,1251,1033,218,1095,156,0.8257394084732215,0.17426059152677859,0.8752997601918465,0.12470023980815348,1082,155,283,644,860,222,0.14325323475046212,0.26155268022181144,0.5951940850277264,0.7948243992606284,0.20517560073937152
3357,295,180,115,256,39,0.6101694915254238,0.3898305084745763,0.8677966101694915,0.13220338983050847,745,143,181,421,687,58,0.1919463087248322,0.24295302013422818,0.5651006711409396,0.9221476510067114,0.07785234899328859
3358,1349,1095,254,1133,216,0.8117123795404003,0.1882876204595997,0.8398813936249073,0.16011860637509265,1313,258,432,623,1082,231,0.1964965727341965,0.32901751713632904,0.4744859101294745,0.824067022086824,0.17593297791317594
3359,309,183,126,269,40,0.5922330097087378,0.4077669902912621,0.8705501618122977,0.12944983818770225,611,147,200,264,558,53,0.24058919803600654,0.32733224222585927,0.4320785597381342,0.9132569558101473,0.0867430441898527
3360,528,347,181,440,88,0.6571969696969697,0.3428030303030303,0.8333333333333334,0.16666666666666666,802,104,204,494,727,75,0.12967581047381546,0.2543640897755611,0.6159600997506235,0.9064837905236908,0.09351620947630923
3361,389,208,181,313,76,0.5347043701799485,0.4652956298200514,0.8046272493573264,0.1953727506426735,643,112,164,367,576,67,0.17418351477449456,0.25505443234836706,0.5707620528771384,0.895800933125972,0.104199066874028
3362,1258,1158,100,1087,171,0.9205087440381559,0.0794912559618442,0.8640699523052464,0.1359300476947536,1046,156,247,643,824,222,0.1491395793499044,0.2361376673040153,0.6147227533460803,0.7877629063097514,0.21223709369024857
3363,1265,1032,233,1107,158,0.8158102766798419,0.1841897233201581,0.8750988142292491,0.12490118577075099,1077,149,288,640,856,221,0.13834726090993502,0.26740947075208915,0.5942432683379758,0.7948003714020427,0.2051996285979573
3364,401,208,193,304,97,0.5187032418952618,0.48129675810473815,0.7581047381546134,0.24189526184538654,563,86,146,331,496,67,0.152753108348135,0.25932504440497334,0.5879218472468917,0.8809946714031972,0.11900532859680284
3365,886,633,253,722,164,0.7144469525959368,0.28555304740406323,0.8148984198645598,0.18510158013544017,1201,235,407,559,1062,139,0.19567027477102414,0.3388842631140716,0.46544546211490423,0.884263114071607,0.115736885928393
3366,815,585,230,654,161,0.7177914110429447,0.2822085889570552,0.8024539877300614,0.19754601226993865,842,124,305,413,774,68,0.14726840855106887,0.36223277909738716,0.49049881235154397,0.9192399049881235,0.08076009501187649
3367,1166,877,289,911,255,0.7521440823327615,0.2478559176672384,0.7813036020583191,0.21869639794168097,1163,102,232,829,885,278,0.08770421324161651,0.1994840928632846,0.7128116938950989,0.7609630266552021,0.23903697334479793
3368,400,263,137,349,51,0.6575,0.3425,0.8725,0.1275,786,169,251,366,668,118,0.21501272264631044,0.3193384223918575,0.46564885496183206,0.8498727735368957,0.15012722646310434
3369,177,102,75,60,117,0.576271186440678,0.423728813559322,0.3389830508474576,0.6610169491525424,52,0,28,24,50,2,0.0,0.5384615384615384,0.46153846153846156,0.9615384615384616,0.038461538461538464
3370,1506,1254,252,1290,216,0.8326693227091634,0.16733067729083664,0.8565737051792829,0.14342629482071714,1179,169,322,688,954,225,0.1433418150975403,0.2731128074639525,0.5835453774385072,0.8091603053435115,0.19083969465648856
3371,1291,998,293,1082,209,0.7730441518202944,0.22695584817970565,0.8381099922540666,0.16189000774593337,1178,102,233,843,900,278,0.0865874363327674,0.19779286926994907,0.7156196943972836,0.7640067911714771,0.23599320882852293
3372,365,232,133,291,74,0.6356164383561644,0.3643835616438356,0.7972602739726027,0.20273972602739726,560,178,192,190,551,9,0.31785714285714284,0.34285714285714286,0.3392857142857143,0.9839285714285714,0.01607142857142857
3373,1295,998,297,1086,209,0.7706563706563706,0.22934362934362934,0.8386100386100386,0.1613899613899614,1183,102,237,844,905,278,0.08622147083685545,0.2003381234150465,0.7134404057480981,0.7650042265426881,0.23499577345731193
3374,747,493,254,567,180,0.6599732262382865,0.34002677376171353,0.7590361445783133,0.24096385542168675,1338,339,340,659,1203,135,0.2533632286995516,0.25411061285500747,0.49252615844544095,0.899103139013453,0.10089686098654709
3375,804,570,234,647,157,0.7089552238805971,0.291044776119403,0.804726368159204,0.19527363184079602,778,130,218,430,704,74,0.16709511568123395,0.2802056555269923,0.5526992287917738,0.9048843187660668,0.09511568123393316
3376,335,208,127,293,42,0.6208955223880597,0.37910447761194027,0.8746268656716418,0.1253731343283582,754,150,217,387,697,57,0.1989389920424403,0.28779840848806365,0.513262599469496,0.9244031830238727,0.07559681697612732
3377,1419,1177,242,1211,208,0.8294573643410853,0.17054263565891473,0.8534178999295279,0.14658210007047218,1140,155,309,676,915,225,0.13596491228070176,0.2710526315789474,0.5929824561403508,0.8026315789473685,0.19736842105263158
3378,501,317,184,418,83,0.6327345309381237,0.36726546906187624,0.8343313373253493,0.1656686626746507,457,33,92,332,449,8,0.07221006564551423,0.2013129102844639,0.7264770240700219,0.9824945295404814,0.0175054704595186
3379,308,187,121,266,42,0.6071428571428571,0.39285714285714285,0.8636363636363636,0.13636363636363635,715,138,185,392,659,56,0.193006993006993,0.25874125874125875,0.5482517482517483,0.9216783216783216,0.07832167832167833
3380,1955,1605,350,1646,309,0.8209718670076727,0.17902813299232737,0.8419437340153453,0.15805626598465472,1609,263,397,949,1306,303,0.163455562461156,0.24673710379117464,0.5898073337476694,0.8116842759477937,0.18831572405220634
3381,1325,1028,297,1104,221,0.7758490566037736,0.2241509433962264,0.8332075471698113,0.16679245283018868,1177,222,402,553,1034,143,0.18861512319456245,0.3415463041631266,0.46983857264231094,0.8785046728971962,0.12149532710280374
3382,382,198,184,286,96,0.518324607329843,0.4816753926701571,0.7486910994764397,0.2513089005235602,611,103,162,346,544,67,0.1685761047463175,0.265139116202946,0.5662847790507365,0.8903436988543372,0.10965630114566285
3383,446,281,165,366,80,0.6300448430493274,0.36995515695067266,0.820627802690583,0.17937219730941703,896,114,200,582,728,168,0.12723214285714285,0.22321428571428573,0.6495535714285714,0.8125,0.1875
3384,498,318,180,415,83,0.6385542168674698,0.3614457831325301,0.8333333333333334,0.16666666666666666,934,109,216,609,765,169,0.11670235546038545,0.23126338329764454,0.6520342612419701,0.8190578158458244,0.1809421841541756
3385,337,224,113,282,55,0.6646884272997032,0.3353115727002967,0.8367952522255193,0.1632047477744807,620,171,183,266,610,10,0.27580645161290324,0.29516129032258065,0.4290322580645161,0.9838709677419355,0.016129032258064516
3386,461,276,185,380,81,0.5986984815618221,0.40130151843817785,0.824295010845987,0.175704989154013,930,93,221,616,762,168,0.1,0.23763440860215054,0.6623655913978495,0.8193548387096774,0.18064516129032257
3387,375,239,136,296,79,0.6373333333333333,0.3626666666666667,0.7893333333333333,0.21066666666666667,486,157,169,160,478,8,0.3230452674897119,0.3477366255144033,0.3292181069958848,0.9835390946502057,0.01646090534979424
3388,372,238,134,327,45,0.6397849462365591,0.3602150537634409,0.8790322580645161,0.12096774193548387,825,199,270,356,709,116,0.2412121212121212,0.32727272727272727,0.4315151515151515,0.8593939393939394,0.1406060606060606
3389,454,282,172,373,81,0.6211453744493393,0.3788546255506608,0.8215859030837004,0.17841409691629956,892,102,193,597,723,169,0.11434977578475336,0.2163677130044843,0.6692825112107623,0.8105381165919282,0.18946188340807174
3390,1505,1257,248,1288,217,0.8352159468438538,0.1647840531561462,0.8558139534883721,0.14418604651162792,1190,176,322,692,965,225,0.14789915966386555,0.27058823529411763,0.5815126050420169,0.8109243697478992,0.18907563025210083
3391,853,618,235,688,165,0.7245017584994138,0.27549824150058616,0.8065650644783119,0.19343493552168817,1183,220,365,598,960,223,0.18596787827557057,0.30853761622992393,0.5054945054945055,0.8114961961115807,0.18850380388841928
3392,399,280,119,332,67,0.7017543859649122,0.2982456140350877,0.8320802005012531,0.16791979949874686,1990,125,187,1678,1683,307,0.06281407035175879,0.09396984924623115,0.84321608040201,0.8457286432160804,0.1542713567839196
3393,1250,1036,214,1092,158,0.8288,0.1712,0.8736,0.1264,1052,149,275,628,831,221,0.14163498098859315,0.26140684410646386,0.596958174904943,0.7899239543726235,0.21007604562737642
3394,401,220,181,325,76,0.5486284289276808,0.4513715710723192,0.8104738154613467,0.18952618453865336,601,92,151,358,533,68,0.15307820299500832,0.2512479201331115,0.5956738768718802,0.8868552412645591,0.11314475873544093
3395,2920,2445,475,2446,474,0.8373287671232876,0.16267123287671234,0.8376712328767123,0.16232876712328767,1797,222,435,1140,1403,394,0.12353923205342238,0.24207011686143573,0.6343906510851419,0.7807456872565387,0.21925431274346133
3396,470,282,188,390,80,0.6,0.4,0.8297872340425532,0.1702127659574468,846,120,225,501,775,71,0.14184397163120568,0.26595744680851063,0.5921985815602837,0.9160756501182034,0.08392434988179669
3397,1511,1261,250,1295,216,0.8345466578424884,0.1654533421575116,0.85704831237591,0.14295168762409,1178,175,324,679,953,225,0.14855687606112053,0.27504244482173174,0.5764006791171478,0.8089983022071308,0.19100169779286927
3398,320,186,134,280,40,0.58125,0.41875,0.875,0.125,599,114,192,293,546,53,0.19031719532554256,0.32053422370617696,0.48914858096828046,0.9115191986644408,0.08848080133555926
3399,1507,1260,247,1292,215,0.836098208360982,0.1639017916390179,0.8573324485733245,0.1426675514266755,1177,169,320,688,951,226,0.14358538657604078,0.27187765505522515,0.5845369583687341,0.8079864061172473,0.19201359388275277
3400,1289,998,291,1080,209,0.7742435996896819,0.22575640031031807,0.8378588052754073,0.1621411947245927,1174,102,233,839,896,278,0.0868824531516184,0.19846678023850084,0.7146507666098807,0.7632027257240205,0.23679727427597955
3401,646,441,205,517,129,0.6826625386996904,0.3173374613003096,0.8003095975232198,0.1996904024767802,1506,354,371,781,1269,237,0.2350597609561753,0.24634794156706508,0.5185922974767596,0.8426294820717132,0.15737051792828685
3402,346,211,135,302,44,0.6098265895953757,0.3901734104046243,0.8728323699421965,0.12716763005780346,749,149,268,332,633,116,0.19893190921228304,0.35781041388518026,0.4432576769025367,0.8451268357810414,0.1548731642189586
3403,576,380,196,451,125,0.6597222222222222,0.3402777777777778,0.7829861111111112,0.2170138888888889,673,99,187,387,605,68,0.14710252600297177,0.27786032689450224,0.575037147102526,0.8989598811292719,0.10104011887072809
3404,549,334,215,430,119,0.6083788706739527,0.39162112932604737,0.7832422586520947,0.2167577413479053,765,113,226,426,691,74,0.1477124183006536,0.2954248366013072,0.5568627450980392,0.9032679738562092,0.09673202614379085
3405,319,191,128,278,41,0.5987460815047022,0.4012539184952978,0.8714733542319749,0.12852664576802508,608,134,206,268,556,52,0.22039473684210525,0.33881578947368424,0.4407894736842105,0.9144736842105263,0.08552631578947369
3406,350,219,131,305,45,0.6257142857142857,0.3742857142857143,0.8714285714285714,0.12857142857142856,903,149,249,505,778,125,0.16500553709856036,0.2757475083056478,0.5592469545957918,0.8615725359911407,0.13842746400885936
3407,834,625,209,745,89,0.749400479616307,0.25059952038369304,0.8932853717026379,0.10671462829736211,975,142,240,593,774,201,0.14564102564102563,0.24615384615384617,0.6082051282051282,0.7938461538461539,0.20615384615384616
3408,713,489,224,565,148,0.6858345021037868,0.3141654978962132,0.7924263674614306,0.20757363253856942,1276,240,409,627,1052,224,0.18808777429467086,0.32053291536050155,0.49137931034482757,0.8244514106583072,0.1755485893416928
3409,1726,1409,317,1446,280,0.8163383545770567,0.18366164542294322,0.8377752027809965,0.16222479721900349,1249,186,402,661,1076,173,0.1489191353082466,0.32185748598879105,0.5292233787029623,0.8614891913530824,0.13851080864691753
3410,603,320,283,437,166,0.5306799336650083,0.4693200663349917,0.724709784411277,0.2752902155887231,310,51,111,148,303,7,0.16451612903225807,0.3580645161290323,0.4774193548387097,0.9774193548387097,0.02258064516129032
3411,363,237,126,318,45,0.6528925619834711,0.34710743801652894,0.8760330578512396,0.12396694214876033,896,167,250,479,776,120,0.18638392857142858,0.27901785714285715,0.5345982142857143,0.8660714285714286,0.13392857142857142
3412,1250,1031,219,1093,157,0.8248,0.1752,0.8744,0.1256,1059,149,281,629,838,221,0.14069877242681775,0.26534466477809254,0.5939565627950897,0.7913125590179415,0.20868744098205855
3413,1075,811,264,880,195,0.7544186046511628,0.24558139534883722,0.8186046511627907,0.1813953488372093,1071,174,372,525,939,132,0.16246498599439776,0.3473389355742297,0.49019607843137253,0.876750700280112,0.12324929971988796
3414,595,424,171,505,90,0.7126050420168067,0.28739495798319326,0.8487394957983193,0.15126050420168066,1268,291,336,641,1131,137,0.22949526813880125,0.26498422712933756,0.5055205047318612,0.8919558359621451,0.10804416403785488
3415,1514,1266,248,1297,217,0.8361955085865258,0.16380449141347425,0.8566710700132101,0.14332892998678995,1202,181,329,692,976,226,0.15058236272878536,0.2737104825291181,0.5757071547420965,0.8119800332778702,0.18801996672212978
3416,310,182,128,269,41,0.5870967741935483,0.4129032258064516,0.867741935483871,0.13225806451612904,564,119,191,254,512,52,0.21099290780141844,0.33865248226950356,0.450354609929078,0.9078014184397163,0.09219858156028368
3417,564,336,228,441,123,0.5957446808510638,0.40425531914893614,0.7819148936170213,0.21808510638297873,761,109,250,402,692,69,0.14323258869908015,0.328515111695138,0.5282522996057819,0.9093298291721419,0.09067017082785808
3418,397,277,120,326,71,0.6977329974811083,0.3022670025188917,0.8211586901763224,0.17884130982367757,1186,140,231,815,962,224,0.11804384485666104,0.19477234401349072,0.6871838111298483,0.8111298482293423,0.18887015177065766
3419,1547,1287,260,1322,225,0.8319327731092437,0.16806722689075632,0.8545572074983839,0.14544279250161604,1167,169,317,681,942,225,0.14481576692373607,0.27163667523564694,0.583547557840617,0.8071979434447301,0.1928020565552699
3420,583,366,217,459,124,0.62778730703259,0.37221269296740994,0.7873070325900514,0.21269296740994853,767,113,222,432,687,80,0.14732724902216426,0.2894393741851369,0.5632333767926988,0.8956975228161669,0.10430247718383312
3421,1504,1255,249,1287,217,0.8344414893617021,0.16555851063829788,0.855718085106383,0.14428191489361702,1170,166,322,682,945,225,0.14188034188034188,0.27521367521367524,0.582905982905983,0.8076923076923077,0.19230769230769232
3422,334,196,138,290,44,0.5868263473053892,0.41317365269461076,0.8682634730538922,0.1317365269461078,741,132,216,393,684,57,0.17813765182186234,0.291497975708502,0.5303643724696356,0.9230769230769231,0.07692307692307693
3423,524,352,172,432,92,0.6717557251908397,0.3282442748091603,0.8244274809160306,0.17557251908396945,1142,235,254,653,978,164,0.20577933450087565,0.2224168126094571,0.5718038528896673,0.8563922942206655,0.1436077057793345
3424,558,338,220,440,118,0.6057347670250897,0.3942652329749104,0.7885304659498208,0.2114695340501792,783,115,245,423,709,74,0.14687100893997446,0.3128991060025543,0.5402298850574713,0.9054916985951469,0.09450830140485313
3425,1260,1033,227,1104,156,0.8198412698412698,0.18015873015873016,0.8761904761904762,0.12380952380952381,1078,156,283,639,857,221,0.14471243042671614,0.2625231910946197,0.5927643784786641,0.7949907235621522,0.20500927643784786
3426,686,425,261,504,182,0.619533527696793,0.380466472303207,0.7346938775510204,0.2653061224489796,1096,183,275,638,966,130,0.16697080291970803,0.2509124087591241,0.5821167883211679,0.8813868613138686,0.11861313868613138
3427,150,43,107,142,8,0.2866666666666667,0.7133333333333334,0.9466666666666667,0.05333333333333334,499,128,145,226,448,51,0.2565130260521042,0.2905811623246493,0.4529058116232465,0.8977955911823647,0.10220440881763528
3428,704,509,195,574,130,0.7230113636363636,0.27698863636363635,0.8153409090909091,0.1846590909090909,825,114,325,386,758,67,0.13818181818181818,0.3939393939393939,0.4678787878787879,0.9187878787878788,0.08121212121212121
3429,1272,1053,219,1112,160,0.8278301886792453,0.1721698113207547,0.8742138364779874,0.12578616352201258,1063,149,280,634,841,222,0.14016933207902163,0.2634054562558796,0.5964252116650988,0.7911571025399812,0.20884289746001883
3430,1293,998,295,1084,209,0.7718484145398299,0.22815158546017014,0.8383604021655066,0.16163959783449341,1178,102,233,843,900,278,0.0865874363327674,0.19779286926994907,0.7156196943972836,0.7640067911714771,0.23599320882852293
3431,370,235,135,323,47,0.6351351351351351,0.36486486486486486,0.8729729729729729,0.12702702702702703,699,123,241,335,583,116,0.1759656652360515,0.3447782546494993,0.4792560801144492,0.8340486409155937,0.1659513590844063
3432,578,384,194,451,127,0.6643598615916955,0.3356401384083045,0.7802768166089965,0.21972318339100347,683,109,185,389,616,67,0.1595900439238653,0.2708638360175695,0.5695461200585652,0.9019033674963397,0.09809663250366032
3433,641,419,222,494,147,0.6536661466458659,0.3463338533541342,0.7706708268330733,0.22932917316692666,1057,232,262,563,991,66,0.2194891201513718,0.2478713339640492,0.532639545884579,0.9375591296121097,0.06244087038789026
3434,533,358,175,437,96,0.6716697936210131,0.32833020637898686,0.8198874296435272,0.1801125703564728,1031,218,280,533,964,67,0.21144519883608148,0.27158098933074687,0.5169738118331717,0.9350145489815713,0.06498545101842872
3435,361,232,129,317,44,0.6426592797783933,0.3573407202216066,0.8781163434903048,0.12188365650969529,747,159,256,332,630,117,0.21285140562248997,0.3427041499330656,0.4444444444444444,0.8433734939759037,0.1566265060240964
3436,338,201,137,292,46,0.5946745562130178,0.40532544378698226,0.863905325443787,0.13609467455621302,641,165,209,267,589,52,0.2574102964118565,0.32605304212168484,0.4165366614664587,0.9188767550702028,0.0811232449297972
3437,385,198,187,293,92,0.5142857142857142,0.4857142857142857,0.7610389610389611,0.23896103896103896,615,93,149,373,548,67,0.15121951219512195,0.24227642276422764,0.6065040650406504,0.8910569105691057,0.10894308943089431
3438,679,438,241,520,159,0.6450662739322534,0.3549337260677467,0.7658321060382917,0.2341678939617084,1213,243,268,702,1044,169,0.20032976092333057,0.22093981863149217,0.5787304204451772,0.8606760098928277,0.1393239901071723
3439,335,202,133,290,45,0.6029850746268657,0.3970149253731343,0.8656716417910447,0.13432835820895522,567,120,187,260,515,52,0.21164021164021163,0.3298059964726631,0.4585537918871252,0.908289241622575,0.09171075837742504
3440,1630,1293,337,1361,269,0.7932515337423313,0.2067484662576687,0.8349693251533742,0.16503067484662576,1247,214,421,612,1090,157,0.17161186848436247,0.3376102646351243,0.4907778668805132,0.8740978348035284,0.12590216519647154
3441,532,358,174,442,90,0.6729323308270677,0.32706766917293234,0.8308270676691729,0.16917293233082706,1061,261,277,523,990,71,0.24599434495758718,0.26107445805843543,0.49293119698397736,0.9330819981149858,0.06691800188501414
3442,331,212,119,288,43,0.6404833836858006,0.3595166163141994,0.8700906344410876,0.1299093655589124,646,113,216,317,530,116,0.17492260061919504,0.33436532507739936,0.4907120743034056,0.8204334365325078,0.17956656346749225
3443,340,214,126,296,44,0.6294117647058823,0.37058823529411766,0.8705882352941177,0.12941176470588237,713,141,249,323,597,116,0.19775596072931276,0.3492286115007013,0.453015427769986,0.8373071528751753,0.16269284712482468
3444,387,203,184,294,93,0.524547803617571,0.4754521963824289,0.7596899224806202,0.24031007751937986,595,96,156,343,529,66,0.16134453781512606,0.26218487394957984,0.5764705882352941,0.8890756302521008,0.11092436974789915
3445,468,281,187,372,96,0.6004273504273504,0.3995726495726496,0.7948717948717948,0.20512820512820512,807,106,196,505,731,76,0.13135068153655513,0.24287484510532836,0.6257744733581165,0.9058240396530359,0.09417596034696406
3446,317,193,124,276,41,0.6088328075709779,0.3911671924290221,0.8706624605678234,0.12933753943217666,779,153,228,398,720,59,0.196405648267009,0.2926829268292683,0.5109114249037228,0.9242618741976893,0.07573812580231065
3447,651,444,207,526,125,0.6820276497695853,0.31797235023041476,0.8079877112135176,0.19201228878648233,1322,241,310,771,1095,227,0.18229954614220878,0.2344931921331316,0.5832072617246596,0.8282904689863843,0.17170953101361575
3448,462,277,185,382,80,0.5995670995670995,0.4004329004329004,0.8268398268398268,0.17316017316017315,863,104,227,532,788,75,0.1205098493626883,0.2630359212050985,0.6164542294322132,0.9130938586326767,0.08690614136732329
3449,346,221,125,303,43,0.638728323699422,0.36127167630057805,0.8757225433526011,0.12427745664739884,731,136,224,371,613,118,0.18604651162790697,0.3064295485636115,0.5075239398084815,0.8385772913816689,0.16142270861833105
3450,618,425,193,506,112,0.6877022653721683,0.3122977346278317,0.8187702265372169,0.18122977346278318,1302,349,388,565,1175,127,0.26804915514592936,0.2980030721966206,0.4339477726574501,0.9024577572964669,0.09754224270353302
3451,808,585,223,670,138,0.724009900990099,0.275990099009901,0.8292079207920792,0.1707920792079208,1288,252,405,631,1053,235,0.1956521739130435,0.3144409937888199,0.48990683229813664,0.8175465838509317,0.18245341614906832
3452,1173,858,315,926,247,0.731457800511509,0.26854219948849106,0.7894288150042625,0.21057118499573743,1046,161,363,522,912,134,0.15391969407265774,0.34703632887189295,0.49904397705544934,0.8718929254302104,0.12810707456978968
3453,392,206,186,297,95,0.5255102040816326,0.4744897959183674,0.7576530612244898,0.2423469387755102,595,97,157,341,529,66,0.16302521008403362,0.2638655462184874,0.573109243697479,0.8890756302521008,0.11092436974789915
3454,407,232,175,337,70,0.5700245700245701,0.42997542997543,0.828009828009828,0.171990171990172,1140,240,237,663,978,162,0.21052631578947367,0.20789473684210527,0.5815789473684211,0.8578947368421053,0.14210526315789473
3455,582,402,180,481,101,0.6907216494845361,0.30927835051546393,0.8264604810996563,0.17353951890034364,1257,235,311,711,1028,229,0.1869530628480509,0.24741447891805887,0.5656324582338902,0.8178202068416865,0.18217979315831345
3456,314,194,120,267,47,0.6178343949044586,0.3821656050955414,0.8503184713375797,0.14968152866242038,756,131,181,444,689,67,0.17328042328042328,0.23941798941798942,0.5873015873015873,0.9113756613756614,0.08862433862433862
3457,386,205,181,311,75,0.5310880829015544,0.4689119170984456,0.805699481865285,0.19430051813471502,615,95,157,363,548,67,0.15447154471544716,0.2552845528455285,0.5902439024390244,0.8910569105691057,0.10894308943089431
3458,353,235,118,288,65,0.6657223796033994,0.3342776203966006,0.8158640226628895,0.18413597733711048,625,184,195,246,614,11,0.2944,0.312,0.3936,0.9824,0.0176
3459,1242,1031,211,1086,156,0.8301127214170693,0.16988727858293076,0.8743961352657005,0.12560386473429952,1058,155,279,624,837,221,0.14650283553875237,0.2637051039697543,0.5897920604914934,0.7911153119092628,0.20888468809073724
3460,948,697,251,762,186,0.7352320675105485,0.26476793248945146,0.8037974683544303,0.1962025316455696,1068,103,203,762,841,227,0.09644194756554307,0.1900749063670412,0.7134831460674157,0.7874531835205992,0.21254681647940074
3461,314,181,133,274,40,0.5764331210191083,0.42356687898089174,0.8726114649681529,0.12738853503184713,594,128,198,268,542,52,0.21548821548821548,0.3333333333333333,0.4511784511784512,0.9124579124579124,0.08754208754208755
3462,337,224,113,281,56,0.6646884272997032,0.3353115727002967,0.8338278931750742,0.1661721068249258,557,137,173,247,547,10,0.2459605026929982,0.3105924596050269,0.44344703770197486,0.9820466786355476,0.017953321364452424
3463,343,211,132,300,43,0.6151603498542274,0.3848396501457726,0.8746355685131195,0.12536443148688048,743,152,253,338,626,117,0.20457604306864063,0.3405114401076716,0.4549125168236878,0.8425302826379543,0.15746971736204576
3464,345,215,130,303,42,0.6231884057971014,0.37681159420289856,0.8782608695652174,0.12173913043478261,821,132,237,452,700,121,0.1607795371498173,0.28867235079171744,0.5505481120584653,0.8526187576126675,0.14738124238733252
3465,824,575,249,661,163,0.6978155339805825,0.30218446601941745,0.8021844660194175,0.19781553398058252,1068,103,203,762,841,227,0.09644194756554307,0.1900749063670412,0.7134831460674157,0.7874531835205992,0.21254681647940074
3466,1252,1032,220,1095,157,0.8242811501597445,0.1757188498402556,0.8746006389776357,0.1253993610223642,1059,149,274,636,837,222,0.14069877242681775,0.2587346553352219,0.6005665722379604,0.7903682719546742,0.2096317280453258
3467,592,359,233,468,124,0.606418918918919,0.3935810810810811,0.7905405405405406,0.20945945945945946,844,124,279,441,772,72,0.14691943127962084,0.3305687203791469,0.5225118483412322,0.9146919431279621,0.08530805687203792
3468,1171,880,291,913,258,0.7514944491887275,0.24850555081127243,0.7796754910333049,0.22032450896669514,1157,102,228,827,879,278,0.0881590319792567,0.19706136560069146,0.7147796024200519,0.759723422644771,0.24027657735522903
3469,580,390,190,468,112,0.6724137931034483,0.3275862068965517,0.8068965517241379,0.19310344827586207,1119,282,277,560,1047,72,0.2520107238605898,0.24754244861483468,0.5004468275245755,0.935656836461126,0.064343163538874
3470,610,415,195,499,111,0.680327868852459,0.319672131147541,0.8180327868852459,0.1819672131147541,1258,335,371,552,1130,128,0.26629570747217807,0.294912559618442,0.43879173290937995,0.8982511923688394,0.10174880763116058
3471,781,301,480,488,293,0.3854033290653009,0.614596670934699,0.6248399487836107,0.37516005121638923,348,51,118,179,341,7,0.14655172413793102,0.3390804597701149,0.514367816091954,0.9798850574712644,0.020114942528735632
3472,1285,998,287,1076,209,0.7766536964980545,0.22334630350194554,0.8373540856031129,0.16264591439688716,1166,102,229,835,888,278,0.08747855917667238,0.19639794168096056,0.7161234991423671,0.7615780445969125,0.23842195540308747
3473,632,314,318,452,180,0.49683544303797467,0.5031645569620253,0.7151898734177216,0.2848101265822785,319,51,111,157,312,7,0.15987460815047022,0.34796238244514105,0.49216300940438873,0.9780564263322884,0.0219435736677116
3474,578,393,185,480,98,0.6799307958477508,0.32006920415224915,0.8304498269896193,0.1695501730103806,1236,299,357,580,1106,130,0.24190938511326862,0.28883495145631066,0.4692556634304207,0.8948220064724919,0.10517799352750809
3475,581,483,98,445,136,0.8313253012048193,0.1686746987951807,0.76592082616179,0.23407917383820998,660,130,263,267,642,18,0.19696969696969696,0.3984848484848485,0.40454545454545454,0.9727272727272728,0.02727272727272727
3476,1249,1034,215,1090,159,0.8278622898318655,0.1721377101681345,0.8726981585268214,0.12730184147317855,1064,155,285,624,842,222,0.14567669172932332,0.26785714285714285,0.5864661654135338,0.7913533834586466,0.20864661654135339
3477,521,303,218,391,130,0.581573896353167,0.418426103646833,0.7504798464491362,0.2495201535508637,656,101,162,393,589,67,0.15396341463414634,0.24695121951219512,0.5990853658536586,0.8978658536585366,0.10213414634146341
3478,335,208,127,293,42,0.6208955223880597,0.37910447761194027,0.8746268656716418,0.1253731343283582,666,178,232,256,614,52,0.2672672672672673,0.3483483483483483,0.3843843843843844,0.9219219219219219,0.07807807807807808
3479,2015,1870,145,1703,312,0.9280397022332506,0.07196029776674938,0.8451612903225807,0.15483870967741936,6,0,0,6,0,6,0.0,0.0,1.0,0.0,1.0
3480,1406,1101,305,1175,231,0.783072546230441,0.21692745376955902,0.8357041251778093,0.1642958748221906,1309,228,430,651,1079,230,0.17417876241405653,0.3284950343773873,0.49732620320855614,0.8242933537051184,0.17570664629488159
3481,379,199,180,292,87,0.525065963060686,0.47493403693931396,0.7704485488126649,0.22955145118733508,570,88,145,337,504,66,0.1543859649122807,0.2543859649122807,0.5912280701754385,0.8842105263157894,0.11578947368421053
3482,646,428,218,512,134,0.6625386996904025,0.33746130030959753,0.7925696594427245,0.20743034055727555,1380,296,343,741,1155,225,0.2144927536231884,0.24855072463768116,0.5369565217391304,0.8369565217391305,0.16304347826086957
3483,1457,1234,223,1276,181,0.846945778997941,0.15305422100205904,0.8757721345229924,0.12422786547700755,1073,155,294,624,852,221,0.14445479962721341,0.2739981360671016,0.581547064305685,0.7940354147250699,0.2059645852749301
3484,1284,998,286,1075,209,0.7772585669781932,0.22274143302180685,0.8372274143302181,0.16277258566978192,1169,102,230,837,891,278,0.0872540633019675,0.19674935842600513,0.7159965782720273,0.7621899059024807,0.23781009409751924
3485,805,559,246,657,148,0.6944099378881987,0.30559006211180123,0.8161490683229814,0.18385093167701863,1080,99,214,767,853,227,0.09166666666666666,0.19814814814814816,0.7101851851851851,0.7898148148148149,0.2101851851851852
3486,334,212,122,290,44,0.6347305389221557,0.3652694610778443,0.8682634730538922,0.1317365269461078,812,120,219,473,690,122,0.1477832512315271,0.2697044334975369,0.5825123152709359,0.8497536945812808,0.15024630541871922
3487,442,276,166,358,84,0.6244343891402715,0.3755656108597285,0.8099547511312217,0.19004524886877827,711,95,177,439,638,73,0.13361462728551335,0.2489451476793249,0.6174402250351617,0.8973277074542897,0.10267229254571027
3488,876,631,245,716,160,0.7203196347031964,0.2796803652968037,0.817351598173516,0.182648401826484,1124,202,371,551,979,145,0.1797153024911032,0.3300711743772242,0.4902135231316726,0.8709964412811388,0.1290035587188612
3489,409,281,128,321,88,0.687041564792176,0.31295843520782396,0.784841075794621,0.21515892420537897,546,154,178,214,538,8,0.28205128205128205,0.326007326007326,0.39194139194139194,0.9853479853479854,0.014652014652014652
3490,1290,998,292,1081,209,0.7736434108527132,0.22635658914728682,0.837984496124031,0.162015503875969,1167,102,228,837,889,278,0.08740359897172237,0.1953727506426735,0.7172236503856041,0.7617823479005998,0.23821765209940018
3491,433,254,179,356,77,0.5866050808314087,0.4133949191685912,0.8221709006928406,0.17782909930715934,617,101,159,357,550,67,0.16369529983792544,0.2576985413290113,0.5786061588330632,0.8914100486223663,0.1085899513776337
3492,318,188,130,277,41,0.5911949685534591,0.4088050314465409,0.8710691823899371,0.1289308176100629,634,140,200,294,580,54,0.22082018927444794,0.31545741324921134,0.4637223974763407,0.9148264984227129,0.08517350157728706
3493,454,282,172,371,83,0.6211453744493393,0.3788546255506608,0.8171806167400881,0.1828193832599119,804,104,204,496,728,76,0.12935323383084577,0.2537313432835821,0.6169154228855721,0.9054726368159204,0.0945273631840796
3494,4440,3937,503,3626,814,0.8867117117117117,0.11328828828828828,0.8166666666666667,0.18333333333333332,2059,286,540,1233,1652,407,0.1389023797960175,0.26226323457989315,0.5988343856240894,0.8023312287518213,0.19766877124817872
3495,558,364,194,433,125,0.6523297491039427,0.34767025089605735,0.7759856630824373,0.22401433691756273,672,106,183,383,605,67,0.15773809523809523,0.27232142857142855,0.5699404761904762,0.9002976190476191,0.09970238095238096
3496,1248,1036,212,1092,156,0.8301282051282052,0.16987179487179488,0.875,0.125,1063,156,274,633,841,222,0.14675446848541862,0.257761053621825,0.5954844778927564,0.7911571025399812,0.20884289746001883
3497,1235,880,355,977,258,0.7125506072874493,0.2874493927125506,0.7910931174089069,0.2089068825910931,1218,102,246,870,940,278,0.08374384236453201,0.2019704433497537,0.7142857142857143,0.7717569786535303,0.22824302134646962
3498,844,623,221,722,122,0.7381516587677726,0.2618483412322275,0.8554502369668247,0.14454976303317535,903,92,189,622,730,173,0.10188261351052048,0.20930232558139536,0.6888150609080842,0.8084163898117387,0.19158361018826134
3499,731,503,228,591,140,0.6880984952120383,0.3119015047879617,0.8084815321477428,0.19151846785225718,1051,184,351,516,923,128,0.17507136060894388,0.3339676498572788,0.49096098953377737,0.8782112274024738,0.12178877259752617
3500,506,318,188,422,84,0.6284584980237155,0.3715415019762846,0.83399209486166,0.16600790513833993,838,104,208,526,766,72,0.12410501193317422,0.24821002386634844,0.6276849642004774,0.9140811455847255,0.08591885441527446
3501,3753,3301,452,3133,620,0.8795630162536637,0.12043698374633627,0.834798827604583,0.165201172395417,1840,164,355,1321,1391,449,0.0891304347826087,0.19293478260869565,0.7179347826086957,0.7559782608695652,0.2440217391304348
3502,315,185,130,273,42,0.5873015873015873,0.4126984126984127,0.8666666666666667,0.13333333333333333,634,130,196,308,580,54,0.20504731861198738,0.30914826498422715,0.48580441640378547,0.9148264984227129,0.08517350157728706
3503,699,304,395,456,243,0.43490701001430615,0.5650929899856938,0.6523605150214592,0.34763948497854075,317,51,108,158,310,7,0.1608832807570978,0.34069400630914826,0.49842271293375395,0.9779179810725552,0.022082018927444796
3504,347,230,117,286,61,0.6628242074927954,0.3371757925072046,0.8242074927953891,0.17579250720461095,547,171,177,199,538,9,0.3126142595978062,0.3235831809872029,0.36380255941499084,0.9835466179159049,0.016453382084095063
3505,1262,1031,231,1106,156,0.8169572107765452,0.18304278922345482,0.8763866877971473,0.12361331220285261,1079,156,294,629,858,221,0.14457831325301204,0.27247451343836887,0.5829471733086191,0.7951807228915663,0.20481927710843373
3506,2976,2534,442,2550,426,0.8514784946236559,0.1485215053763441,0.8568548387096774,0.1431451612903226,1728,194,503,1031,1364,364,0.11226851851851852,0.29108796296296297,0.5966435185185185,0.7893518518518519,0.21064814814814814
3507,585,410,175,486,99,0.7008547008547008,0.29914529914529914,0.8307692307692308,0.16923076923076924,1131,238,303,590,1000,131,0.21043324491600354,0.26790450928381965,0.5216622458001768,0.8841732979664014,0.11582670203359859
3508,1289,998,291,1080,209,0.7742435996896819,0.22575640031031807,0.8378588052754073,0.1621411947245927,1166,102,227,837,888,278,0.08747855917667238,0.1946826758147513,0.7178387650085764,0.7615780445969125,0.23842195540308747
3509,1290,998,292,1081,209,0.7736434108527132,0.22635658914728682,0.837984496124031,0.162015503875969,1176,102,234,840,898,278,0.08673469387755102,0.1989795918367347,0.7142857142857143,0.7636054421768708,0.23639455782312926
3510,1987,1583,404,1703,284,0.7966784096628082,0.20332159033719174,0.8570709612481128,0.14292903875188726,1711,162,296,1253,1291,420,0.09468147282291058,0.17299824663939217,0.7323202805376973,0.7545295149035651,0.24547048509643482
3511,399,84,315,305,94,0.21052631578947367,0.7894736842105263,0.7644110275689223,0.23558897243107768,505,0,250,255,505,0,0.0,0.49504950495049505,0.504950495049505,1.0,0.0
3512,1505,1261,244,1290,215,0.837873754152824,0.16212624584717608,0.8571428571428571,0.14285714285714285,1144,160,313,671,919,225,0.13986013986013987,0.2736013986013986,0.5865384615384616,0.8033216783216783,0.19667832167832167
3513,1286,998,288,1077,209,0.776049766718507,0.223950233281493,0.8374805598755832,0.1625194401244168,1165,102,228,835,887,278,0.08755364806866953,0.19570815450643778,0.7167381974248928,0.76137339055794,0.23862660944206007
3514,1065,816,249,873,192,0.7661971830985915,0.23380281690140844,0.819718309859155,0.18028169014084508,1235,240,394,601,1009,226,0.19433198380566802,0.31902834008097164,0.48663967611336034,0.8170040485829959,0.18299595141700406
3515,572,393,179,467,105,0.6870629370629371,0.3129370629370629,0.8164335664335665,0.18356643356643357,1251,248,306,697,1024,227,0.1982414068745004,0.2446043165467626,0.5571542765787371,0.8185451638689049,0.18145483613109512
3516,370,196,174,287,83,0.5297297297297298,0.4702702702702703,0.7756756756756756,0.22432432432432434,642,119,170,353,574,68,0.1853582554517134,0.26479750778816197,0.5498442367601246,0.8940809968847352,0.1059190031152648
3517,1520,1268,252,1303,217,0.8342105263157895,0.16578947368421051,0.8572368421052632,0.14276315789473684,1186,175,327,684,961,225,0.1475548060708263,0.275716694772344,0.5767284991568297,0.8102866779089376,0.1897133220910624
3518,309,187,122,269,40,0.6051779935275081,0.3948220064724919,0.8705501618122977,0.12944983818770225,702,122,189,391,646,56,0.1737891737891738,0.2692307692307692,0.5569800569800569,0.9202279202279202,0.07977207977207977
3519,1293,998,295,1084,209,0.7718484145398299,0.22815158546017014,0.8383604021655066,0.16163959783449341,1179,102,235,842,901,278,0.08651399491094147,0.1993214588634436,0.714164546225615,0.7642069550466497,0.2357930449533503
3520,422,242,180,346,76,0.5734597156398105,0.4265402843601896,0.8199052132701422,0.18009478672985782,644,112,164,368,577,67,0.17391304347826086,0.2546583850931677,0.5714285714285714,0.8959627329192547,0.10403726708074534
3521,352,234,118,289,63,0.6647727272727273,0.3352272727272727,0.8210227272727273,0.17897727272727273,628,168,194,266,618,10,0.267515923566879,0.3089171974522293,0.42356687898089174,0.9840764331210191,0.01592356687898089
3522,1513,1263,250,1296,217,0.8347653668208856,0.16523463317911435,0.8565763384005287,0.14342366159947126,1154,166,318,670,930,224,0.1438474870017331,0.2755632582322357,0.5805892547660312,0.8058925476603119,0.19410745233968804
3523,1161,884,277,948,213,0.7614125753660638,0.23858742463393626,0.8165374677002584,0.1834625322997416,1321,264,416,641,1097,224,0.19984859954579864,0.31491294473883424,0.48523845571536717,0.8304314912944739,0.16956850870552612
3524,1287,976,311,1063,224,0.7583527583527584,0.24164724164724163,0.8259518259518259,0.17404817404817405,1251,183,394,674,1006,245,0.14628297362110312,0.3149480415667466,0.5387689848121503,0.8041566746602717,0.19584332533972823
3525,1294,1001,293,1083,211,0.7735703245749613,0.22642967542503864,0.8369397217928902,0.16306027820710975,1178,102,234,842,900,278,0.0865874363327674,0.19864176570458403,0.7147707979626485,0.7640067911714771,0.23599320882852293
3526,569,386,183,473,96,0.6783831282952548,0.3216168717047452,0.8312829525483304,0.1687170474516696,1100,211,290,599,966,134,0.1918181818181818,0.2636363636363636,0.5445454545454546,0.8781818181818182,0.12181818181818181
3527,1292,998,294,1083,209,0.7724458204334366,0.22755417956656346,0.8382352941176471,0.16176470588235295,1175,102,232,841,897,278,0.08680851063829788,0.1974468085106383,0.7157446808510638,0.7634042553191489,0.23659574468085107
3528,347,217,130,304,43,0.6253602305475504,0.3746397694524496,0.8760806916426513,0.1239193083573487,735,148,244,343,619,116,0.20136054421768707,0.33197278911564626,0.4666666666666667,0.8421768707482993,0.15782312925170067
3529,605,388,217,465,140,0.6413223140495867,0.3586776859504132,0.768595041322314,0.23140495867768596,707,97,210,400,634,73,0.1371994342291372,0.297029702970297,0.5657708628005658,0.8967468175388967,0.10325318246110325
3530,1290,998,292,1081,209,0.7736434108527132,0.22635658914728682,0.837984496124031,0.162015503875969,1175,102,232,841,897,278,0.08680851063829788,0.1974468085106383,0.7157446808510638,0.7634042553191489,0.23659574468085107
3531,323,200,123,283,40,0.6191950464396285,0.38080495356037153,0.8761609907120743,0.1238390092879257,607,146,196,265,554,53,0.24052718286655683,0.3228995057660626,0.43657331136738053,0.9126853377265239,0.08731466227347612
3532,344,224,120,291,53,0.6511627906976745,0.3488372093023256,0.8459302325581395,0.15406976744186046,659,200,204,255,651,8,0.30349013657056145,0.3095599393019727,0.38694992412746587,0.9878603945371776,0.012139605462822459
3533,342,204,138,300,42,0.5964912280701754,0.40350877192982454,0.8771929824561403,0.12280701754385964,748,121,201,426,691,57,0.16176470588235295,0.26871657754010697,0.56951871657754,0.9237967914438503,0.07620320855614973
3534,498,342,156,424,74,0.6867469879518072,0.3132530120481928,0.8514056224899599,0.14859437751004015,608,148,192,268,555,53,0.24342105263157895,0.3157894736842105,0.4407894736842105,0.912828947368421,0.08717105263157894
3535,1167,878,289,912,255,0.7523564695801199,0.24764353041988005,0.781491002570694,0.2185089974293059,1161,102,230,829,883,278,0.08785529715762273,0.19810508182601205,0.7140396210163652,0.7605512489233419,0.23944875107665806
3536,341,216,125,298,43,0.6334310850439883,0.36656891495601174,0.873900293255132,0.12609970674486803,729,152,251,326,613,116,0.2085048010973937,0.3443072702331962,0.44718792866941015,0.840877914951989,0.15912208504801098
3537,469,291,178,387,82,0.6204690831556503,0.3795309168443497,0.8251599147121536,0.17484008528784648,764,95,195,474,691,73,0.1243455497382199,0.25523560209424084,0.6204188481675392,0.9044502617801047,0.09554973821989529
3538,1070,808,262,877,193,0.7551401869158878,0.24485981308411214,0.819626168224299,0.18037383177570093,1124,216,376,532,991,133,0.19217081850533807,0.33451957295373663,0.47330960854092524,0.8816725978647687,0.11832740213523131
3539,1165,878,287,910,255,0.7536480686695279,0.2463519313304721,0.7811158798283262,0.21888412017167383,1165,102,234,829,887,278,0.08755364806866953,0.20085836909871244,0.711587982832618,0.76137339055794,0.23862660944206007
3540,1167,878,289,912,255,0.7523564695801199,0.24764353041988005,0.781491002570694,0.2185089974293059,1171,102,236,833,893,278,0.08710503842869342,0.20153714773697695,0.7113578138343296,0.762596071733561,0.23740392826643894
3541,379,255,124,331,48,0.6728232189973615,0.32717678100263853,0.8733509234828496,0.1266490765171504,707,137,224,346,589,118,0.19377652050919378,0.31683168316831684,0.4893917963224894,0.8330975954738331,0.1669024045261669
3542,284,132,152,110,174,0.4647887323943662,0.5352112676056338,0.3873239436619718,0.6126760563380281,386,192,154,40,386,0,0.49740932642487046,0.39896373056994816,0.10362694300518134,1.0,0.0
3543,358,230,128,289,69,0.6424581005586593,0.3575418994413408,0.8072625698324022,0.19273743016759776,627,164,189,274,617,10,0.26156299840510366,0.3014354066985646,0.4370015948963317,0.9840510366826156,0.01594896331738437
3544,411,229,182,314,97,0.5571776155717761,0.44282238442822386,0.7639902676399026,0.2360097323600973,602,101,154,347,534,68,0.16777408637873753,0.2558139534883721,0.5764119601328903,0.8870431893687708,0.11295681063122924
3545,1344,1107,237,1175,169,0.8236607142857143,0.17633928571428573,0.8742559523809523,0.12574404761904762,1107,155,307,645,884,223,0.14001806684733514,0.27732610659439927,0.5826558265582655,0.7985546522131888,0.2014453477868112
3546,824,575,249,661,163,0.6978155339805825,0.30218446601941745,0.8021844660194175,0.19781553398058252,1068,103,203,762,841,227,0.09644194756554307,0.1900749063670412,0.7134831460674157,0.7874531835205992,0.21254681647940074
3547,2794,2382,412,2509,285,0.8525411596277738,0.1474588403722262,0.8979957050823193,0.10200429491768075,3302,161,299,2842,2883,419,0.04875832828588734,0.09055118110236221,0.8606904906117504,0.8731072077528771,0.12689279224712297
3548,1508,1261,247,1292,216,0.8362068965517241,0.16379310344827586,0.8567639257294429,0.14323607427055704,1166,166,322,678,942,224,0.1423670668953688,0.27615780445969124,0.58147512864494,0.8078902229845626,0.19210977701543738
3549,342,211,131,299,43,0.6169590643274854,0.3830409356725146,0.8742690058479532,0.12573099415204678,715,145,244,326,598,117,0.20279720279720279,0.3412587412587413,0.45594405594405596,0.8363636363636363,0.16363636363636364
3550,1285,998,287,1076,209,0.7766536964980545,0.22334630350194554,0.8373540856031129,0.16264591439688716,1172,102,233,837,894,278,0.08703071672354949,0.19880546075085323,0.7141638225255973,0.7627986348122867,0.23720136518771331
3551,319,184,135,276,43,0.5768025078369906,0.4231974921630094,0.8652037617554859,0.13479623824451412,624,135,218,271,571,53,0.21634615384615385,0.34935897435897434,0.4342948717948718,0.9150641025641025,0.08493589743589744
3552,978,730,248,798,180,0.7464212678936605,0.25357873210633947,0.8159509202453987,0.18404907975460122,1102,100,204,798,871,231,0.09074410163339383,0.1851179673321234,0.7241379310344828,0.7903811252268602,0.20961887477313976
3553,1289,998,291,1080,209,0.7742435996896819,0.22575640031031807,0.8378588052754073,0.1621411947245927,1171,102,231,838,893,278,0.08710503842869342,0.19726729291204098,0.7156276686592656,0.762596071733561,0.23740392826643894
3554,489,308,181,406,83,0.6298568507157464,0.37014314928425357,0.8302658486707567,0.16973415132924335,832,95,200,537,759,73,0.1141826923076923,0.2403846153846154,0.6454326923076923,0.9122596153846154,0.08774038461538461
3555,1169,879,290,911,258,0.7519247219846023,0.24807527801539778,0.7792985457656116,0.22070145423438836,1163,102,231,830,885,278,0.08770421324161651,0.19862424763542563,0.7136715391229579,0.7609630266552021,0.23903697334479793
3556,302,180,122,262,40,0.5960264900662252,0.40397350993377484,0.8675496688741722,0.13245033112582782,569,130,183,256,517,52,0.22847100175746923,0.3216168717047452,0.44991212653778556,0.9086115992970123,0.0913884007029877
3557,310,191,119,267,43,0.6161290322580645,0.38387096774193546,0.8612903225806452,0.13870967741935483,659,112,179,368,602,57,0.16995447647951442,0.2716236722306525,0.5584218512898331,0.91350531107739,0.08649468892261002
3558,187,115,72,88,99,0.6149732620320856,0.3850267379679144,0.47058823529411764,0.5294117647058824,466,192,230,44,466,0,0.41201716738197425,0.49356223175965663,0.0944206008583691,1.0,0.0
3559,306,187,119,263,43,0.6111111111111112,0.3888888888888889,0.8594771241830066,0.14052287581699346,728,125,177,426,670,58,0.1717032967032967,0.24313186813186813,0.5851648351648352,0.9203296703296703,0.07967032967032966
3560,306,184,122,263,43,0.6013071895424836,0.39869281045751637,0.8594771241830066,0.14052287581699346,546,113,175,258,493,53,0.20695970695970695,0.32051282051282054,0.4725274725274725,0.9029304029304029,0.09706959706959707
3561,1286,998,288,1077,209,0.776049766718507,0.223950233281493,0.8374805598755832,0.1625194401244168,1165,102,228,835,887,278,0.08755364806866953,0.19570815450643778,0.7167381974248928,0.76137339055794,0.23862660944206007
3562,2750,2343,407,2346,404,0.852,0.148,0.8530909090909091,0.1469090909090909,1772,233,513,1026,1426,346,0.13148984198645597,0.2895033860045147,0.5790067720090294,0.8047404063205418,0.19525959367945825
3563,1161,879,282,903,258,0.7571059431524548,0.24289405684754523,0.7777777777777778,0.2222222222222222,1156,102,230,824,878,278,0.08823529411764706,0.19896193771626297,0.71280276816609,0.759515570934256,0.24048442906574394
3564,1637,1350,287,1377,260,0.8246792913866829,0.17532070861331706,0.8411728772144166,0.1588271227855834,1282,159,379,744,968,314,0.12402496099843993,0.2956318252730109,0.5803432137285491,0.7550702028081123,0.24492979719188768
3565,529,345,184,452,77,0.6521739130434783,0.34782608695652173,0.8544423440453687,0.14555765595463138,647,107,168,372,579,68,0.16537867078825347,0.2596599690880989,0.5749613601236476,0.8948995363214838,0.10510046367851623
3566,325,195,130,282,43,0.6,0.4,0.8676923076923077,0.13230769230769232,818,135,216,467,755,63,0.16503667481662593,0.26405867970660146,0.5709046454767727,0.9229828850855746,0.07701711491442542
3567,1816,1477,339,1444,372,0.8133259911894273,0.1866740088105727,0.7951541850220264,0.20484581497797358,1207,149,377,681,957,250,0.12344656172328086,0.3123446561723281,0.5642087821043911,0.7928748964374482,0.2071251035625518
3568,1252,1032,220,1095,157,0.8242811501597445,0.1757188498402556,0.8746006389776357,0.1253993610223642,1081,149,296,636,859,222,0.13783533765032377,0.2738205365402405,0.5883441258094357,0.7946345975948196,0.2053654024051804
3569,1252,1031,221,1095,157,0.8234824281150159,0.17651757188498401,0.8746006389776357,0.1253993610223642,1060,149,280,631,839,221,0.14056603773584905,0.2641509433962264,0.5952830188679246,0.7915094339622641,0.20849056603773586
3570,189,64,125,173,16,0.3386243386243386,0.6613756613756614,0.9153439153439153,0.08465608465608465,741,155,178,408,687,54,0.20917678812415655,0.24021592442645073,0.5506072874493927,0.9271255060728745,0.0728744939271255
3571,779,528,251,615,164,0.6777920410783055,0.32220795892169446,0.7894736842105263,0.21052631578947367,1149,296,334,519,1020,129,0.257615317667537,0.2906875543951262,0.4516971279373368,0.8877284595300261,0.1122715404699739
3572,373,219,154,316,57,0.5871313672922251,0.4128686327077748,0.8471849865951743,0.15281501340482573,918,178,186,554,764,154,0.19389978213507625,0.20261437908496732,0.6034858387799564,0.8322440087145969,0.16775599128540306
3573,391,228,163,326,65,0.5831202046035806,0.41687979539641945,0.8337595907928389,0.16624040920716113,1048,248,234,566,975,73,0.2366412213740458,0.22328244274809161,0.5400763358778626,0.9303435114503816,0.06965648854961833
3574,3226,2782,444,2617,609,0.8623682579045258,0.13763174209547427,0.8112213267203968,0.18877867327960324,1845,169,348,1328,1388,457,0.0915989159891599,0.1886178861788618,0.7197831978319783,0.7523035230352304,0.24769647696476965
3575,1301,1001,300,1090,211,0.7694081475787855,0.23059185242121444,0.8378170637970792,0.16218293620292082,1172,102,229,841,894,278,0.08703071672354949,0.19539249146757678,0.7175767918088737,0.7627986348122867,0.23720136518771331
3576,75,74,1,62,13,0.9866666666666667,0.013333333333333334,0.8266666666666667,0.17333333333333334,0,0,0,0,0,0,0.0,0.0,0.0,0.0,0.0
3577,1255,1032,223,1098,157,0.8223107569721115,0.17768924302788844,0.8749003984063745,0.1250996015936255,1099,150,309,640,877,222,0.1364877161055505,0.28116469517743403,0.5823475887170154,0.7979981801637852,0.20200181983621474
3578,1169,879,290,911,258,0.7519247219846023,0.24807527801539778,0.7792985457656116,0.22070145423438836,1158,102,229,827,880,278,0.08808290155440414,0.19775474956822106,0.7141623488773747,0.7599309153713298,0.24006908462867013
3579,1498,1250,248,1282,216,0.8344459279038718,0.16555407209612816,0.855807743658211,0.14419225634178906,1182,175,324,683,956,226,0.14805414551607446,0.27411167512690354,0.577834179357022,0.8087986463620981,0.19120135363790186
3580,1507,1261,246,1291,216,0.8367617783676178,0.16323822163238222,0.8566688785666888,0.14333112143331123,1172,166,323,683,946,226,0.1416382252559727,0.27559726962457337,0.5827645051194539,0.8071672354948806,0.19283276450511946
3581,889,597,292,666,223,0.671541057367829,0.32845894263217096,0.749156355455568,0.2508436445444319,1152,160,360,632,931,221,0.1388888888888889,0.3125,0.5486111111111112,0.8081597222222222,0.1918402777777778
3582,337,224,113,281,56,0.6646884272997032,0.3353115727002967,0.8338278931750742,0.1661721068249258,555,149,172,234,546,9,0.26846846846846845,0.3099099099099099,0.42162162162162165,0.9837837837837838,0.016216216216216217
3583,4235,3672,563,3655,580,0.867060212514758,0.13293978748524202,0.8630460448642266,0.13695395513577333,2030,259,554,1217,1576,454,0.12758620689655173,0.2729064039408867,0.5995073891625615,0.7763546798029557,0.22364532019704433
3584,1496,1249,247,1280,216,0.8348930481283422,0.16510695187165775,0.8556149732620321,0.1443850267379679,1183,178,323,682,958,225,0.15046491969568893,0.27303465765004226,0.5765004226542688,0.8098055790363483,0.19019442096365174
3585,387,254,133,336,51,0.6563307493540051,0.34366925064599485,0.8682170542635659,0.13178294573643412,844,139,241,464,724,120,0.1646919431279621,0.28554502369668244,0.5497630331753555,0.8578199052132701,0.14218009478672985
3586,557,392,165,458,99,0.703770197486535,0.296229802513465,0.822262118491921,0.17773788150807898,1130,231,302,597,999,131,0.20442477876106194,0.2672566371681416,0.5283185840707965,0.8840707964601769,0.11592920353982301
3587,824,575,249,661,163,0.6978155339805825,0.30218446601941745,0.8021844660194175,0.19781553398058252,1068,103,203,762,841,227,0.09644194756554307,0.1900749063670412,0.7134831460674157,0.7874531835205992,0.21254681647940074
3588,1491,1245,246,1275,216,0.8350100603621731,0.16498993963782696,0.8551307847082495,0.1448692152917505,1129,154,307,668,905,224,0.13640389725420726,0.27192205491585475,0.591674047829938,0.8015943312666076,0.19840566873339238
3589,1271,1053,218,1112,159,0.8284815106215578,0.17151848937844216,0.8749016522423289,0.12509834775767112,1044,149,265,630,823,221,0.14272030651340997,0.25383141762452105,0.603448275862069,0.7883141762452107,0.21168582375478928
3590,461,279,182,382,79,0.6052060737527115,0.3947939262472885,0.8286334056399133,0.17136659436008678,980,116,231,633,812,168,0.11836734693877551,0.2357142857142857,0.6459183673469387,0.8285714285714286,0.17142857142857143
3591,183,111,72,78,105,0.6065573770491803,0.39344262295081966,0.4262295081967213,0.5737704918032787,83,0,56,27,82,1,0.0,0.6746987951807228,0.3253012048192771,0.9879518072289156,0.012048192771084338
3592,1240,1030,210,1084,156,0.8306451612903226,0.1693548387096774,0.8741935483870967,0.12580645161290321,1057,156,265,636,836,221,0.14758751182592242,0.2507095553453169,0.6017029328287606,0.7909176915799432,0.20908230842005676
3593,1162,880,282,904,258,0.7573149741824441,0.24268502581755594,0.7779690189328744,0.22203098106712565,1156,102,230,824,878,278,0.08823529411764706,0.19896193771626297,0.71280276816609,0.759515570934256,0.24048442906574394
3594,1170,879,291,912,258,0.7512820512820513,0.24871794871794872,0.7794871794871795,0.2205128205128205,1162,102,230,830,884,278,0.08777969018932874,0.19793459552495696,0.7142857142857143,0.7607573149741824,0.23924268502581755
3595,1556,1293,263,1329,227,0.8309768637532133,0.16902313624678664,0.8541131105398457,0.14588688946015424,1222,181,339,702,996,226,0.14811783960720132,0.2774140752864157,0.574468085106383,0.8150572831423896,0.18494271685761046
3596,357,182,175,275,82,0.5098039215686274,0.49019607843137253,0.7703081232492998,0.22969187675070027,561,81,152,328,495,66,0.1443850267379679,0.2709447415329768,0.5846702317290553,0.8823529411764706,0.11764705882352941
3597,1289,998,291,1080,209,0.7742435996896819,0.22575640031031807,0.8378588052754073,0.1621411947245927,1166,102,227,837,888,278,0.08747855917667238,0.1946826758147513,0.7178387650085764,0.7615780445969125,0.23842195540308747
3598,1254,1032,222,1097,157,0.8229665071770335,0.17703349282296652,0.8748006379585327,0.1251993620414673,1071,150,288,633,849,222,0.1400560224089636,0.2689075630252101,0.5910364145658263,0.7927170868347339,0.20728291316526612
3599,457,281,176,374,83,0.6148796498905909,0.3851203501094092,0.8183807439824945,0.18161925601750548,768,103,195,470,696,72,0.13411458333333334,0.25390625,0.6119791666666666,0.90625,0.09375
3600,1470,1204,266,1210,260,0.819047619047619,0.18095238095238095,0.8231292517006803,0.17687074829931973,1245,220,435,590,1079,166,0.17670682730923695,0.3493975903614458,0.4738955823293173,0.8666666666666667,0.13333333333333333
3601,1446,1236,210,1265,181,0.8547717842323651,0.14522821576763487,0.8748271092669433,0.1251728907330567,1062,155,272,635,840,222,0.14595103578154425,0.256120527306968,0.5979284369114878,0.7909604519774012,0.20903954802259886
3602,667,461,206,539,128,0.6911544227886057,0.30884557721139433,0.808095952023988,0.191904047976012,1110,223,379,508,981,129,0.2009009009009009,0.34144144144144145,0.45765765765765765,0.8837837837837837,0.11621621621621622
3603,710,437,273,514,196,0.6154929577464788,0.3845070422535211,0.723943661971831,0.27605633802816903,1158,159,235,764,927,231,0.13730569948186527,0.20293609671848015,0.6597582037996546,0.8005181347150259,0.19948186528497408
3604,709,501,208,572,137,0.7066290550070522,0.2933709449929478,0.8067700987306065,0.19322990126939352,880,125,353,402,811,69,0.14204545454545456,0.4011363636363636,0.45681818181818185,0.9215909090909091,0.07840909090909091
3605,1586,1320,266,1359,227,0.832282471626734,0.1677175283732661,0.8568726355611601,0.14312736443883986,1140,157,311,672,916,224,0.13771929824561405,0.27280701754385966,0.5894736842105263,0.8035087719298246,0.19649122807017544
3606,313,190,123,272,41,0.6070287539936102,0.3929712460063898,0.8690095846645367,0.13099041533546327,588,131,201,256,536,52,0.2227891156462585,0.34183673469387754,0.43537414965986393,0.9115646258503401,0.08843537414965986
3607,1033,697,336,847,186,0.6747337850919651,0.32526621490803487,0.8199419167473379,0.18005808325266215,1145,103,225,817,918,227,0.08995633187772925,0.1965065502183406,0.7135371179039302,0.8017467248908297,0.19825327510917032
3608,1284,998,286,1075,209,0.7772585669781932,0.22274143302180685,0.8372274143302181,0.16277258566978192,1167,102,230,835,889,278,0.08740359897172237,0.19708654670094258,0.715509854327335,0.7617823479005998,0.23821765209940018
3609,549,347,202,430,119,0.6320582877959927,0.3679417122040073,0.7832422586520947,0.2167577413479053,720,115,219,386,650,70,0.1597222222222222,0.30416666666666664,0.5361111111111111,0.9027777777777778,0.09722222222222222
3610,1255,1039,216,1099,156,0.8278884462151395,0.17211155378486057,0.8756972111553785,0.12430278884462151,1055,155,273,627,834,221,0.14691943127962084,0.25876777251184835,0.5943127962085308,0.790521327014218,0.209478672985782
3611,1165,878,287,910,255,0.7536480686695279,0.2463519313304721,0.7811158798283262,0.21888412017167383,1162,102,232,828,884,278,0.08777969018932874,0.19965576592082615,0.7125645438898451,0.7607573149741824,0.23924268502581755
3612,1501,1256,245,1286,215,0.8367754830113258,0.1632245169886742,0.8567621585609594,0.14323784143904064,1185,175,322,688,958,227,0.14767932489451477,0.2717299578059072,0.580590717299578,0.8084388185654009,0.19156118143459916
3613,336,224,112,285,51,0.6666666666666666,0.3333333333333333,0.8482142857142857,0.15178571428571427,589,164,167,258,580,9,0.27843803056027167,0.2835314091680815,0.4380305602716469,0.9847198641765704,0.015280135823429542
3614,1513,1263,250,1296,217,0.8347653668208856,0.16523463317911435,0.8565763384005287,0.14342366159947126,1195,175,334,686,971,224,0.14644351464435146,0.2794979079497908,0.5740585774058578,0.8125523012552301,0.18744769874476988
3615,430,306,124,387,43,0.7116279069767442,0.28837209302325584,0.9,0.1,1059,167,271,621,908,151,0.15769593956562794,0.2559017941454202,0.5864022662889519,0.8574126534466477,0.14258734655335223
3616,473,297,176,389,84,0.627906976744186,0.37209302325581395,0.8224101479915433,0.17758985200845667,796,95,202,499,722,74,0.11934673366834171,0.2537688442211055,0.6268844221105527,0.907035175879397,0.09296482412060302
3617,320,184,136,276,44,0.575,0.425,0.8625,0.1375,759,116,198,445,699,60,0.152832674571805,0.2608695652173913,0.5862977602108037,0.9209486166007905,0.07905138339920949
3618,345,213,132,300,45,0.6173913043478261,0.3826086956521739,0.8695652173913043,0.13043478260869565,753,140,237,376,635,118,0.18592297476759628,0.3147410358565737,0.49933598937583,0.8432934926958832,0.15670650730411687
3619,1257,1046,211,1100,157,0.8321400159108989,0.16785998408910102,0.8750994431185362,0.1249005568814638,1077,155,287,635,855,222,0.14391829155060354,0.26648096564531104,0.5896007428040855,0.7938718662952646,0.20612813370473537
3620,3001,2556,445,2537,464,0.8517160946351217,0.14828390536487837,0.8453848717094302,0.1546151282905698,1748,193,521,1034,1380,368,0.11041189931350115,0.29805491990846683,0.5915331807780321,0.7894736842105263,0.21052631578947367
3621,1290,998,292,1081,209,0.7736434108527132,0.22635658914728682,0.837984496124031,0.162015503875969,1175,102,232,841,897,278,0.08680851063829788,0.1974468085106383,0.7157446808510638,0.7634042553191489,0.23659574468085107
3622,1244,986,258,1017,227,0.792604501607717,0.20739549839228297,0.817524115755627,0.182475884244373,1326,290,413,623,1156,170,0.2187028657616893,0.3114630467571644,0.4698340874811463,0.8717948717948718,0.1282051282051282
3623,1234,880,354,976,258,0.713128038897893,0.28687196110210694,0.7909238249594813,0.20907617504051865,1213,102,243,868,935,278,0.08408903544929926,0.20032976092333057,0.7155812036273702,0.7708161582852432,0.2291838417147568
3624,833,575,258,670,163,0.6902761104441777,0.3097238895558223,0.8043217286914766,0.19567827130852342,1083,103,209,771,856,227,0.0951061865189289,0.19298245614035087,0.7119113573407202,0.7903970452446907,0.20960295475530932
3625,626,401,225,477,149,0.6405750798722045,0.35942492012779553,0.7619808306709265,0.2380191693290735,969,159,259,551,841,128,0.16408668730650156,0.2672858617131063,0.5686274509803921,0.8679050567595459,0.13209494324045407
3626,569,386,183,462,107,0.6783831282952548,0.3216168717047452,0.81195079086116,0.18804920913884007,1175,285,303,587,1043,132,0.2425531914893617,0.2578723404255319,0.49957446808510636,0.8876595744680851,0.1123404255319149
3627,1502,1253,249,1286,216,0.8342210386151797,0.16577896138482023,0.8561917443408789,0.14380825565912117,1178,169,329,680,952,226,0.1434634974533107,0.27928692699490665,0.5772495755517827,0.8081494057724957,0.19185059422750425
3628,526,309,217,402,124,0.5874524714828897,0.41254752851711024,0.7642585551330798,0.23574144486692014,715,96,222,397,643,72,0.13426573426573427,0.3104895104895105,0.5552447552447553,0.8993006993006993,0.1006993006993007
3629,1294,1001,293,1083,211,0.7735703245749613,0.22642967542503864,0.8369397217928902,0.16306027820710975,1173,102,232,839,895,278,0.08695652173913043,0.1977834612105712,0.7152600170502984,0.763000852514919,0.236999147485081
3630,1609,1271,338,1374,235,0.7899316345556247,0.21006836544437538,0.8539465506525793,0.14605344934742076,1283,250,431,602,1142,141,0.19485580670303976,0.33593141075604055,0.4692127825409197,0.8901013250194856,0.10989867498051442
3631,1286,998,288,1077,209,0.776049766718507,0.223950233281493,0.8374805598755832,0.1625194401244168,1173,102,232,839,895,278,0.08695652173913043,0.1977834612105712,0.7152600170502984,0.763000852514919,0.236999147485081
3632,1987,1583,404,1703,284,0.7966784096628082,0.20332159033719174,0.8570709612481128,0.14292903875188726,1709,162,296,1251,1291,418,0.09479227618490345,0.17320070216500877,0.7320070216500878,0.7554125219426565,0.2445874780573435
3633,1296,998,298,1087,209,0.7700617283950617,0.22993827160493827,0.8387345679012346,0.16126543209876543,1176,102,232,842,898,278,0.08673469387755102,0.19727891156462585,0.7159863945578231,0.7636054421768708,0.23639455782312926
3634,1171,879,292,913,258,0.7506404782237404,0.2493595217762596,0.7796754910333049,0.22032450896669514,1173,102,237,834,895,278,0.08695652173913043,0.2020460358056266,0.710997442455243,0.763000852514919,0.236999147485081
3635,1199,891,308,968,231,0.7431192660550459,0.25688073394495414,0.8073394495412844,0.1926605504587156,1217,261,409,547,1086,131,0.21446179129005752,0.3360723089564503,0.4494658997534922,0.8923582580115037,0.1076417419884963
3636,674,484,190,543,131,0.7181008902077152,0.2818991097922849,0.8056379821958457,0.1943620178041543,763,100,299,364,695,68,0.1310615989515072,0.3918741808650065,0.47706422018348627,0.9108781127129751,0.0891218872870249
3637,1294,998,296,1085,209,0.7712519319938176,0.2287480680061824,0.8384853168469861,0.1615146831530139,1177,102,232,843,899,278,0.08666100254885302,0.19711129991503823,0.7162276975361087,0.7638062871707731,0.23619371282922685
3638,846,635,211,756,90,0.7505910165484634,0.24940898345153664,0.8936170212765957,0.10638297872340426,972,143,238,591,770,202,0.147119341563786,0.2448559670781893,0.6080246913580247,0.7921810699588477,0.20781893004115226
3639,873,620,253,692,181,0.7101947308132875,0.2898052691867125,0.7926689576174112,0.2073310423825888,1234,260,410,564,1102,132,0.2106969205834684,0.33225283630470015,0.45705024311183146,0.893030794165316,0.10696920583468396
3640,1169,879,290,911,258,0.7519247219846023,0.24807527801539778,0.7792985457656116,0.22070145423438836,1164,102,233,829,886,278,0.08762886597938144,0.20017182130584193,0.7121993127147767,0.761168384879725,0.23883161512027493
3641,342,209,133,298,44,0.6111111111111112,0.3888888888888889,0.8713450292397661,0.1286549707602339,712,135,246,331,596,116,0.1896067415730337,0.3455056179775281,0.4648876404494382,0.8370786516853933,0.16292134831460675
3642,568,339,229,447,121,0.596830985915493,0.40316901408450706,0.7869718309859155,0.2130281690140845,828,119,245,464,755,73,0.14371980676328502,0.29589371980676327,0.5603864734299517,0.9118357487922706,0.08816425120772947
3643,3120,2682,438,2492,628,0.8596153846153847,0.14038461538461539,0.7987179487179488,0.2012820512820513,1742,219,523,1000,1371,371,0.12571756601607348,0.3002296211251435,0.574052812858783,0.7870264064293915,0.2129735935706085
3644,485,302,183,404,81,0.622680412371134,0.37731958762886597,0.8329896907216495,0.1670103092783505,882,93,202,587,715,167,0.1054421768707483,0.2290249433106576,0.6655328798185941,0.8106575963718821,0.1893424036281179
3645,423,237,186,344,79,0.5602836879432624,0.4397163120567376,0.8132387706855791,0.1867612293144208,629,101,158,370,562,67,0.16057233704292528,0.25119236883942764,0.5882352941176471,0.8934817170111288,0.10651828298887123
3646,448,282,166,365,83,0.6294642857142857,0.3705357142857143,0.8147321428571429,0.18526785714285715,764,105,184,475,692,72,0.13743455497382198,0.24083769633507854,0.6217277486910995,0.9057591623036649,0.09424083769633508
3647,1266,966,300,1026,240,0.7630331753554502,0.23696682464454977,0.8104265402843602,0.1895734597156398,1115,195,398,522,982,133,0.17488789237668162,0.35695067264573993,0.46816143497757845,0.8807174887892377,0.11928251121076233
3648,595,401,194,468,127,0.6739495798319328,0.32605042016806723,0.7865546218487395,0.2134453781512605,733,132,194,407,662,71,0.1800818553888131,0.2646657571623465,0.5552523874488404,0.903137789904502,0.09686221009549795
3649,611,416,195,489,122,0.6808510638297872,0.3191489361702128,0.8003273322422259,0.19967266775777415,987,188,272,527,859,128,0.19047619047619047,0.2755825734549139,0.5339412360688957,0.8703140830800405,0.12968591691995948
3650,361,227,134,318,43,0.628808864265928,0.37119113573407203,0.8808864265927978,0.11911357340720222,623,146,210,267,570,53,0.23434991974317818,0.33707865168539325,0.42857142857142855,0.9149277688603531,0.08507223113964688
3651,1292,998,294,1083,209,0.7724458204334366,0.22755417956656346,0.8382352941176471,0.16176470588235295,1180,102,236,842,902,278,0.08644067796610169,0.2,0.7135593220338983,0.764406779661017,0.23559322033898306
3652,371,197,174,290,81,0.5309973045822103,0.46900269541778977,0.7816711590296496,0.2183288409703504,568,84,154,330,502,66,0.14788732394366197,0.2711267605633803,0.5809859154929577,0.8838028169014085,0.11619718309859155
3653,763,519,244,589,174,0.6802096985583224,0.3197903014416776,0.7719528178243774,0.22804718217562253,1216,285,263,668,1057,159,0.234375,0.21628289473684212,0.5493421052631579,0.8692434210526315,0.13075657894736842
3654,342,211,131,299,43,0.6169590643274854,0.3830409356725146,0.8742690058479532,0.12573099415204678,822,117,233,472,699,123,0.14233576642335766,0.28345498783454987,0.5742092457420924,0.8503649635036497,0.14963503649635038
3655,1259,1032,227,1102,157,0.8196981731532963,0.18030182684670373,0.8752978554408261,0.12470214455917394,1070,149,285,636,849,221,0.13925233644859814,0.26635514018691586,0.594392523364486,0.7934579439252336,0.20654205607476636
3656,377,195,182,302,75,0.5172413793103449,0.4827586206896552,0.8010610079575596,0.1989389920424403,593,89,148,356,526,67,0.15008431703204048,0.24957841483979765,0.6003372681281619,0.8870151770657673,0.11298482293423272
3657,326,206,120,283,43,0.6319018404907976,0.36809815950920244,0.8680981595092024,0.13190184049079753,808,121,217,470,689,119,0.14975247524752475,0.2685643564356436,0.5816831683168316,0.8527227722772277,0.14727722772277227
3658,474,330,144,372,102,0.6962025316455697,0.3037974683544304,0.7848101265822784,0.21518987341772153,435,70,227,138,434,1,0.16091954022988506,0.5218390804597701,0.31724137931034485,0.9977011494252873,0.0022988505747126436
3659,459,326,133,385,74,0.710239651416122,0.289760348583878,0.8387799564270153,0.16122004357298475,817,232,230,355,712,105,0.2839657282741738,0.28151774785801714,0.43451652386780903,0.8714810281517748,0.12851897184822522
3660,487,303,184,407,80,0.62217659137577,0.37782340862423,0.8357289527720739,0.16427104722792607,988,117,229,642,817,171,0.11842105263157894,0.23178137651821862,0.6497975708502024,0.8269230769230769,0.17307692307692307
3661,500,311,189,368,132,0.622,0.378,0.736,0.264,677,164,173,340,664,13,0.24224519940915806,0.2555391432791728,0.5022156573116692,0.9807976366322009,0.019202363367799114
3662,359,233,126,315,44,0.649025069637883,0.35097493036211697,0.8774373259052924,0.12256267409470752,688,133,235,320,572,116,0.1933139534883721,0.34156976744186046,0.46511627906976744,0.8313953488372093,0.1686046511627907
3663,1337,1016,321,1080,257,0.7599102468212415,0.2400897531787584,0.8077786088257293,0.19222139117427076,1309,210,408,691,1074,235,0.16042780748663102,0.3116883116883117,0.5278838808250573,0.8204736440030558,0.17952635599694422
3664,345,215,130,301,44,0.6231884057971014,0.37681159420289856,0.8724637681159421,0.12753623188405797,764,148,259,357,646,118,0.193717277486911,0.3390052356020942,0.46727748691099474,0.8455497382198953,0.1544502617801047
3665,1291,998,293,1082,209,0.7730441518202944,0.22695584817970565,0.8381099922540666,0.16189000774593337,1176,102,233,841,898,278,0.08673469387755102,0.19812925170068027,0.7151360544217688,0.7636054421768708,0.23639455782312926
3666,1257,1035,222,1099,158,0.8233890214797136,0.1766109785202864,0.8743038981702467,0.12569610182975338,1067,149,279,639,845,222,0.13964386129334583,0.2614807872539831,0.598875351452671,0.7919400187441424,0.20805998125585753
3667,1286,998,288,1077,209,0.776049766718507,0.223950233281493,0.8374805598755832,0.1625194401244168,1166,102,228,836,888,278,0.08747855917667238,0.1955403087478559,0.7169811320754716,0.7615780445969125,0.23842195540308747
3668,505,334,171,432,73,0.6613861386138614,0.33861386138613864,0.8554455445544554,0.14455445544554454,472,39,109,324,465,7,0.0826271186440678,0.2309322033898305,0.6864406779661016,0.9851694915254238,0.014830508474576272
3669,1297,1001,296,1086,211,0.7717810331534309,0.228218966846569,0.8373168851195065,0.16268311488049345,1173,102,231,840,895,278,0.08695652173913043,0.1969309462915601,0.7161125319693095,0.763000852514919,0.236999147485081
3670,824,575,249,661,163,0.6978155339805825,0.30218446601941745,0.8021844660194175,0.19781553398058252,1068,103,203,762,841,227,0.09644194756554307,0.1900749063670412,0.7134831460674157,0.7874531835205992,0.21254681647940074
3671,1987,1583,404,1703,284,0.7966784096628082,0.20332159033719174,0.8570709612481128,0.14292903875188726,1711,162,296,1253,1291,420,0.09468147282291058,0.17299824663939217,0.7323202805376973,0.7545295149035651,0.24547048509643482
3672,347,225,122,285,62,0.6484149855907781,0.3515850144092219,0.8213256484149856,0.1786743515850144,483,153,168,162,474,9,0.3167701863354037,0.34782608695652173,0.33540372670807456,0.9813664596273292,0.018633540372670808
3673,332,198,134,291,41,0.5963855421686747,0.4036144578313253,0.8765060240963856,0.12349397590361445,633,143,222,268,581,52,0.2259083728278041,0.35071090047393366,0.42338072669826227,0.9178515007898894,0.08214849921011058
3674,355,223,132,310,45,0.6281690140845071,0.37183098591549296,0.8732394366197183,0.1267605633802817,663,179,216,268,611,52,0.26998491704374056,0.3257918552036199,0.4042232277526395,0.9215686274509803,0.0784313725490196
3675,486,319,167,399,87,0.6563786008230452,0.3436213991769547,0.8209876543209876,0.17901234567901234,909,179,217,513,842,67,0.19691969196919692,0.23872387238723872,0.5643564356435643,0.9262926292629263,0.0737073707370737
3676,417,240,177,347,70,0.5755395683453237,0.4244604316546763,0.8321342925659473,0.16786570743405277,1224,297,277,650,1063,161,0.2426470588235294,0.22630718954248366,0.5310457516339869,0.8684640522875817,0.1315359477124183
3677,473,290,183,398,75,0.6131078224101479,0.386892177589852,0.8414376321353065,0.15856236786469344,612,95,160,357,546,66,0.15522875816993464,0.26143790849673204,0.5833333333333334,0.8921568627450981,0.10784313725490197
3678,802,558,244,654,148,0.6957605985037406,0.30423940149625933,0.8154613466334164,0.18453865336658354,1075,98,211,766,848,227,0.09116279069767441,0.19627906976744186,0.7125581395348837,0.7888372093023256,0.2111627906976744
3679,1237,964,273,1023,214,0.7793047696038804,0.22069523039611966,0.8270008084074374,0.17299919159256266,1206,268,411,527,1077,129,0.2222222222222222,0.3407960199004975,0.4369817578772803,0.8930348258706468,0.10696517412935323
3680,379,249,130,318,61,0.6569920844327177,0.34300791556728233,0.8390501319261213,0.16094986807387862,548,154,222,172,541,7,0.28102189781021897,0.4051094890510949,0.31386861313868614,0.9872262773722628,0.012773722627737226
3681,1506,1258,248,1289,217,0.8353253652058433,0.1646746347941567,0.8559096945551129,0.14409030544488713,1157,160,317,680,932,225,0.13828867761452032,0.27398444252376836,0.5877268798617113,0.8055315471045809,0.1944684528954192
3682,663,469,194,533,130,0.7073906485671192,0.29260935143288086,0.803921568627451,0.19607843137254902,868,146,335,387,799,69,0.16820276497695852,0.3859447004608295,0.44585253456221197,0.9205069124423964,0.07949308755760369
3683,411,230,181,334,77,0.559610705596107,0.44038929440389296,0.8126520681265207,0.1873479318734793,655,121,164,370,587,68,0.18473282442748093,0.250381679389313,0.5648854961832062,0.8961832061068702,0.10381679389312977
3684,691,504,187,559,132,0.7293777134587555,0.2706222865412446,0.808972503617945,0.191027496382055,758,102,287,369,691,67,0.1345646437994723,0.3786279683377309,0.4868073878627968,0.9116094986807388,0.08839050131926121
3685,505,289,216,399,106,0.5722772277227722,0.4277227722772277,0.7900990099009901,0.2099009900990099,785,103,253,429,712,73,0.13121019108280255,0.32229299363057323,0.5464968152866242,0.9070063694267516,0.0929936305732484
3686,1289,998,291,1080,209,0.7742435996896819,0.22575640031031807,0.8378588052754073,0.1621411947245927,1171,102,231,838,893,278,0.08710503842869342,0.19726729291204098,0.7156276686592656,0.762596071733561,0.23740392826643894
3687,1512,1266,246,1296,216,0.8373015873015873,0.1626984126984127,0.8571428571428571,0.14285714285714285,1195,181,324,690,969,226,0.1514644351464435,0.2711297071129707,0.5774058577405857,0.8108786610878661,0.1891213389121339
3688,589,374,215,463,126,0.634974533106961,0.36502546689303905,0.7860780984719864,0.21392190152801357,798,98,210,490,633,165,0.12280701754385964,0.2631578947368421,0.6140350877192983,0.793233082706767,0.20676691729323307
3689,1524,1271,253,1305,219,0.833989501312336,0.16601049868766404,0.8562992125984252,0.1437007874015748,1192,181,324,687,967,225,0.1518456375838926,0.27181208053691275,0.5763422818791947,0.8112416107382551,0.18875838926174496
3690,461,285,176,379,82,0.6182212581344902,0.38177874186550975,0.8221258134490239,0.17787418655097614,789,107,212,470,715,74,0.13561470215462612,0.26869455006337134,0.5956907477820025,0.9062103929024081,0.09378960709759189
3691,1252,1032,220,1095,157,0.8242811501597445,0.1757188498402556,0.8746006389776357,0.1253993610223642,1082,149,298,635,860,222,0.1377079482439926,0.2754158964879852,0.5868761552680222,0.7948243992606284,0.20517560073937152
3692,315,147,168,239,76,0.4666666666666667,0.5333333333333333,0.7587301587301587,0.24126984126984127,542,82,141,319,476,66,0.15129151291512916,0.26014760147601473,0.5885608856088561,0.8782287822878229,0.12177121771217712
3693,321,191,130,281,40,0.5950155763239875,0.40498442367601245,0.8753894080996885,0.12461059190031153,595,126,200,269,543,52,0.21176470588235294,0.33613445378151263,0.45210084033613446,0.9126050420168067,0.08739495798319327
3694,858,589,269,678,180,0.6864801864801865,0.3135198135198135,0.7902097902097902,0.2097902097902098,1126,137,338,651,892,234,0.1216696269982238,0.30017761989342806,0.5781527531083481,0.7921847246891652,0.20781527531083482
3695,792,566,226,646,146,0.7146464646464646,0.28535353535353536,0.8156565656565656,0.18434343434343434,1208,261,394,553,1077,131,0.21605960264900662,0.326158940397351,0.45778145695364236,0.8915562913907285,0.10844370860927152
3696,1169,879,290,911,258,0.7519247219846023,0.24807527801539778,0.7792985457656116,0.22070145423438836,1164,102,233,829,886,278,0.08762886597938144,0.20017182130584193,0.7121993127147767,0.761168384879725,0.23883161512027493
3697,427,293,134,319,108,0.6861826697892272,0.31381733021077285,0.747072599531616,0.2529274004683841,644,195,259,190,636,8,0.3027950310559006,0.40217391304347827,0.2950310559006211,0.9875776397515528,0.012422360248447204
3698,1291,1001,290,1080,211,0.7753679318357862,0.2246320681642138,0.836560805577072,0.16343919442292795,1173,102,233,838,895,278,0.08695652173913043,0.19863597612958228,0.7144075021312873,0.763000852514919,0.236999147485081
3699,1527,1272,255,1306,221,0.8330058939096268,0.16699410609037327,0.8552717747216765,0.14472822527832352,1189,181,325,683,964,225,0.15222876366694701,0.27333894028595457,0.5744322960470984,0.8107653490328006,0.18923465096719932
3700,1255,1031,224,1099,156,0.8215139442231075,0.17848605577689244,0.8756972111553785,0.12430278884462151,1065,155,283,627,844,221,0.14553990610328638,0.26572769953051645,0.5887323943661972,0.7924882629107981,0.20751173708920187
3701,181,50,131,171,10,0.27624309392265195,0.7237569060773481,0.9447513812154696,0.055248618784530384,664,114,167,383,609,55,0.1716867469879518,0.25150602409638556,0.5768072289156626,0.9171686746987951,0.08283132530120482
3702,1643,1302,341,1342,301,0.7924528301886793,0.20754716981132076,0.8167985392574558,0.18320146074254412,1321,217,427,677,1089,232,0.1642694928084784,0.32323996971990915,0.5124905374716124,0.8243754731264193,0.17562452687358063
3703,1420,1181,239,1214,206,0.8316901408450704,0.16830985915492958,0.8549295774647887,0.14507042253521127,1133,158,309,666,909,224,0.13945278022947927,0.2727272727272727,0.587819947043248,0.8022947925860547,0.1977052074139453
3704,596,397,199,498,98,0.6661073825503355,0.3338926174496644,0.8355704697986577,0.1644295302013423,496,121,153,222,479,17,0.2439516129032258,0.3084677419354839,0.4475806451612903,0.9657258064516129,0.034274193548387094
3705,631,435,196,522,109,0.6893819334389857,0.31061806656101426,0.8272583201267829,0.17274167987321712,1064,225,300,539,936,128,0.21146616541353383,0.2819548872180451,0.506578947368421,0.8796992481203008,0.12030075187969924
3706,1294,1001,293,1083,211,0.7735703245749613,0.22642967542503864,0.8369397217928902,0.16306027820710975,1176,102,232,842,898,278,0.08673469387755102,0.19727891156462585,0.7159863945578231,0.7636054421768708,0.23639455782312926
3707,697,482,215,551,146,0.6915351506456241,0.3084648493543759,0.7905308464849354,0.20946915351506457,848,114,330,404,780,68,0.13443396226415094,0.3891509433962264,0.47641509433962265,0.9198113207547169,0.08018867924528301
3708,386,201,185,309,77,0.5207253886010362,0.4792746113989637,0.8005181347150259,0.19948186528497408,595,92,152,351,528,67,0.1546218487394958,0.25546218487394956,0.5899159663865546,0.8873949579831932,0.11260504201680673
3709,567,380,187,460,107,0.6701940035273368,0.3298059964726631,0.8112874779541446,0.18871252204585537,1024,256,270,498,959,65,0.25,0.263671875,0.486328125,0.9365234375,0.0634765625
3710,470,294,176,388,82,0.625531914893617,0.37446808510638296,0.825531914893617,0.17446808510638298,871,126,206,539,796,75,0.1446613088404133,0.2365097588978186,0.618828932261768,0.9138920780711826,0.08610792192881746
3711,343,210,133,299,44,0.6122448979591837,0.3877551020408163,0.8717201166180758,0.1282798833819242,695,118,235,342,578,117,0.1697841726618705,0.3381294964028777,0.4920863309352518,0.8316546762589928,0.1683453237410072
3712,528,354,174,434,94,0.6704545454545454,0.32954545454545453,0.821969696969697,0.17803030303030304,1076,179,235,662,905,171,0.16635687732342008,0.2184014869888476,0.6152416356877324,0.8410780669144982,0.15892193308550187
3713,607,423,184,496,111,0.6968698517298187,0.3031301482701812,0.8171334431630972,0.1828665568369028,1083,233,280,570,954,129,0.21514312096029548,0.2585410895660203,0.5263157894736842,0.8808864265927978,0.11911357340720222
3714,359,227,132,287,72,0.6323119777158774,0.36768802228412256,0.7994428969359332,0.20055710306406685,670,158,183,329,656,14,0.23582089552238805,0.27313432835820894,0.491044776119403,0.9791044776119403,0.020895522388059702
3715,429,239,190,332,97,0.5571095571095571,0.4428904428904429,0.7738927738927739,0.2261072261072261,605,99,153,353,540,65,0.16363636363636364,0.2528925619834711,0.5834710743801653,0.8925619834710744,0.10743801652892562
3716,1238,1031,207,1082,156,0.8327948303715671,0.16720516962843296,0.8739903069466882,0.1260096930533118,1053,155,266,632,832,221,0.14719848053181386,0.2526115859449193,0.6001899335232669,0.7901234567901234,0.20987654320987653
3717,1288,998,290,1079,209,0.7748447204968945,0.2251552795031056,0.8377329192546584,0.1622670807453416,1174,102,232,840,896,278,0.0868824531516184,0.19761499148211242,0.7155025553662692,0.7632027257240205,0.23679727427597955
3718,546,361,185,455,91,0.6611721611721612,0.33882783882783885,0.8333333333333334,0.16666666666666666,1137,312,306,519,1066,71,0.27440633245382584,0.2691292875989446,0.45646437994722955,0.9375549692172384,0.06244503078276165
3719,1712,1464,248,1472,240,0.8551401869158879,0.14485981308411214,0.8598130841121495,0.14018691588785046,1212,181,332,699,986,226,0.14933993399339934,0.2739273927392739,0.5767326732673267,0.8135313531353136,0.18646864686468648
3720,476,279,197,394,82,0.5861344537815126,0.41386554621848737,0.8277310924369747,0.1722689075630252,1005,113,255,637,837,168,0.11243781094527364,0.2537313432835821,0.6338308457711442,0.8328358208955224,0.16716417910447762
3721,619,425,194,500,119,0.6865912762520194,0.3134087237479806,0.8077544426494345,0.19224555735056542,1225,235,299,691,1000,225,0.19183673469387755,0.24408163265306124,0.5640816326530612,0.8163265306122449,0.1836734693877551
3722,473,288,185,390,83,0.6088794926004228,0.39112050739957716,0.8245243128964059,0.17547568710359407,891,121,241,529,816,75,0.13580246913580246,0.27048260381593714,0.5937149270482603,0.9158249158249159,0.08417508417508418
3723,644,418,226,488,156,0.6490683229813664,0.35093167701863354,0.7577639751552795,0.2422360248447205,1031,115,223,693,803,228,0.11154219204655674,0.2162948593598448,0.6721629485935985,0.7788554801163918,0.22114451988360814
3724,832,574,258,669,163,0.6899038461538461,0.31009615384615385,0.8040865384615384,0.19591346153846154,1072,103,203,766,845,227,0.0960820895522388,0.18936567164179105,0.7145522388059702,0.7882462686567164,0.21175373134328357
3725,2375,2023,352,1943,432,0.8517894736842105,0.1482105263157895,0.8181052631578948,0.18189473684210528,1342,212,446,684,1134,208,0.15797317436661698,0.3323397913561848,0.5096870342771982,0.8450074515648286,0.15499254843517138
3726,573,356,217,447,126,0.6212914485165794,0.3787085514834206,0.7801047120418848,0.2198952879581152,798,131,226,441,724,74,0.16416040100250626,0.2832080200501253,0.5526315789473685,0.9072681704260651,0.09273182957393483
3727,386,250,136,337,49,0.6476683937823834,0.35233160621761656,0.8730569948186528,0.12694300518134716,719,114,220,385,597,122,0.15855354659248957,0.30598052851182195,0.5354659248956884,0.8303198887343533,0.16968011126564672
3728,589,484,105,449,140,0.8217317487266553,0.17826825127334464,0.7623089983022071,0.23769100169779286,606,113,281,212,603,3,0.18646864686468648,0.4636963696369637,0.34983498349834985,0.995049504950495,0.0049504950495049506
3729,1247,1036,211,1090,157,0.830793905372895,0.16920609462710506,0.8740978348035284,0.12590216519647154,1065,155,269,641,843,222,0.14553990610328638,0.25258215962441316,0.6018779342723005,0.7915492957746478,0.2084507042253521
3730,621,409,212,485,136,0.6586151368760065,0.3413848631239936,0.7809983896940419,0.21900161030595813,1173,189,262,722,944,229,0.16112531969309463,0.22335890878090367,0.6155157715260017,0.8047740835464621,0.19522591645353793
3731,1170,880,290,912,258,0.7521367521367521,0.24786324786324787,0.7794871794871795,0.2205128205128205,1158,102,229,827,880,278,0.08808290155440414,0.19775474956822106,0.7141623488773747,0.7599309153713298,0.24006908462867013
3732,671,479,192,541,130,0.713859910581222,0.28614008941877794,0.8062593144560357,0.19374068554396423,790,96,330,364,723,67,0.12151898734177215,0.4177215189873418,0.4607594936708861,0.9151898734177215,0.08481012658227848
3733,1270,1049,221,1110,160,0.8259842519685039,0.17401574803149605,0.8740157480314961,0.12598425196850394,1047,149,263,635,825,222,0.14231136580706782,0.2511938872970392,0.606494746895893,0.7879656160458453,0.21203438395415472
3734,305,184,121,264,41,0.6032786885245902,0.39672131147540984,0.8655737704918033,0.13442622950819672,760,156,204,400,700,60,0.20526315789473684,0.26842105263157895,0.5263157894736842,0.9210526315789473,0.07894736842105263
3735,616,416,200,500,116,0.6753246753246753,0.3246753246753247,0.8116883116883117,0.18831168831168832,1420,312,352,756,1186,234,0.21971830985915494,0.24788732394366197,0.532394366197183,0.8352112676056338,0.1647887323943662
3736,1451,1243,208,1270,181,0.8566505858028945,0.14334941419710545,0.8752584424534804,0.12474155754651964,1047,155,262,630,826,221,0.14804202483285578,0.2502387774594078,0.6017191977077364,0.7889207258834766,0.2110792741165234
3737,1289,1001,288,1078,211,0.7765709852598914,0.22342901474010862,0.8363072148952676,0.16369278510473234,1171,102,231,838,893,278,0.08710503842869342,0.19726729291204098,0.7156276686592656,0.762596071733561,0.23740392826643894
3738,1255,1032,223,1098,157,0.8223107569721115,0.17768924302788844,0.8749003984063745,0.1250996015936255,1092,149,308,635,870,222,0.13644688644688643,0.28205128205128205,0.5815018315018315,0.7967032967032966,0.2032967032967033
3739,117,67,50,65,52,0.5726495726495726,0.42735042735042733,0.5555555555555556,0.4444444444444444,142,3,65,74,140,2,0.02112676056338028,0.45774647887323944,0.5211267605633803,0.9859154929577465,0.014084507042253521
3740,1266,1035,231,1106,160,0.8175355450236966,0.18246445497630331,0.8736176935229067,0.1263823064770932,1089,149,312,628,868,221,0.13682277318640956,0.2865013774104683,0.5766758494031221,0.7970615243342516,0.20293847566574838
3741,1138,794,344,907,231,0.6977152899824253,0.3022847100175747,0.79701230228471,0.20298769771529,1163,105,204,854,893,270,0.09028374892519346,0.17540842648323302,0.7343078245915735,0.7678417884780739,0.23215821152192606
3742,677,479,198,548,129,0.707533234859675,0.29246676514032494,0.8094534711964549,0.19054652880354506,813,106,317,390,745,68,0.13038130381303814,0.3899138991389914,0.4797047970479705,0.9163591635916359,0.08364083640836409
3743,601,395,206,470,131,0.6572379367720466,0.3427620632279534,0.7820299500831946,0.21797004991680533,1050,231,255,564,970,80,0.22,0.24285714285714285,0.5371428571428571,0.9238095238095239,0.0761904761904762
3744,1162,880,282,904,258,0.7573149741824441,0.24268502581755594,0.7779690189328744,0.22203098106712565,1156,102,230,824,878,278,0.08823529411764706,0.19896193771626297,0.71280276816609,0.759515570934256,0.24048442906574394
3745,1246,1032,214,1090,156,0.8282504012841091,0.17174959871589085,0.8747993579454254,0.12520064205457465,1081,155,292,634,859,222,0.14338575393154487,0.27012025901942643,0.5864939870490287,0.7946345975948196,0.2053654024051804
3746,1292,998,294,1083,209,0.7724458204334366,0.22755417956656346,0.8382352941176471,0.16176470588235295,1180,102,236,842,902,278,0.08644067796610169,0.2,0.7135593220338983,0.764406779661017,0.23559322033898306
3747,2742,2325,417,2267,475,0.8479212253829321,0.15207877461706784,0.8267687819110139,0.17323121808898614,1442,180,385,877,1225,217,0.12482662968099861,0.2669902912621359,0.6081830790568654,0.8495145631067961,0.15048543689320387
3748,488,315,173,405,83,0.6454918032786885,0.35450819672131145,0.8299180327868853,0.17008196721311475,765,96,192,477,693,72,0.12549019607843137,0.25098039215686274,0.6235294117647059,0.9058823529411765,0.09411764705882353
3749,437,254,183,362,75,0.5812356979405034,0.41876430205949655,0.8283752860411899,0.17162471395881007,997,244,244,509,932,65,0.24473420260782347,0.24473420260782347,0.5105315947843531,0.9348044132397192,0.06519558676028084
3750,558,387,171,459,99,0.6935483870967742,0.3064516129032258,0.8225806451612904,0.1774193548387097,1068,204,283,581,935,133,0.19101123595505617,0.2649812734082397,0.5440074906367042,0.8754681647940075,0.12453183520599251
3751,839,575,264,676,163,0.6853396901072706,0.3146603098927294,0.8057210965435042,0.19427890345649582,1078,103,205,770,851,227,0.09554730983302412,0.1901669758812616,0.7142857142857143,0.7894248608534323,0.21057513914656772
3752,408,231,177,321,87,0.5661764705882353,0.4338235294117647,0.7867647058823529,0.21323529411764705,626,108,160,358,559,67,0.17252396166134185,0.25559105431309903,0.5718849840255591,0.8929712460063898,0.10702875399361023
3753,576,349,227,458,118,0.6059027777777778,0.3940972222222222,0.7951388888888888,0.2048611111111111,756,99,254,403,685,71,0.13095238095238096,0.335978835978836,0.533068783068783,0.906084656084656,0.09391534391534391
3754,680,486,194,547,133,0.7147058823529412,0.2852941176470588,0.8044117647058824,0.19558823529411765,823,123,307,393,755,68,0.14945321992709598,0.3730255164034022,0.4775212636695018,0.9173754556500607,0.08262454434993925
3755,1281,941,340,1007,274,0.7345823575331772,0.2654176424668228,0.7861046057767369,0.21389539422326306,1101,123,340,638,879,222,0.11171662125340599,0.30881017257039056,0.5794732061762035,0.7983651226158038,0.2016348773841962
3756,362,228,134,318,44,0.6298342541436464,0.3701657458563536,0.8784530386740331,0.12154696132596685,809,174,273,362,692,117,0.21508034610630408,0.3374536464771323,0.44746600741656367,0.8553770086526576,0.1446229913473424
3757,1835,1510,325,1540,295,0.8228882833787466,0.1771117166212534,0.8392370572207084,0.16076294277929154,1172,181,402,589,1021,151,0.15443686006825938,0.3430034129692833,0.5025597269624573,0.871160409556314,0.128839590443686
3758,451,282,169,367,84,0.6252771618625277,0.37472283813747226,0.8137472283813747,0.18625277161862527,722,95,179,448,649,73,0.13157894736842105,0.24792243767313019,0.6204986149584487,0.8988919667590027,0.10110803324099724
3759,1556,1297,259,1333,223,0.833547557840617,0.16645244215938304,0.8566838046272494,0.14331619537275064,1166,166,321,679,940,226,0.1423670668953688,0.27530017152658665,0.5823327615780446,0.8061749571183533,0.19382504288164665
3760,335,223,112,286,49,0.6656716417910448,0.33432835820895523,0.8537313432835821,0.14626865671641792,587,148,161,278,578,9,0.252129471890971,0.27427597955706984,0.4735945485519591,0.9846678023850085,0.015332197614991482
3761,1716,1370,346,1449,267,0.7983682983682984,0.20163170163170163,0.8444055944055944,0.1555944055944056,1343,200,430,713,1105,238,0.14892032762472077,0.32017870439314966,0.5309009679821296,0.8227848101265823,0.17721518987341772
3762,1162,880,282,904,258,0.7573149741824441,0.24268502581755594,0.7779690189328744,0.22203098106712565,1156,102,230,824,878,278,0.08823529411764706,0.19896193771626297,0.71280276816609,0.759515570934256,0.24048442906574394
3763,1423,1124,299,1189,234,0.7898805340829234,0.2101194659170766,0.8355586788475052,0.16444132115249474,1174,102,230,842,896,278,0.0868824531516184,0.19591141396933562,0.717206132879046,0.7632027257240205,0.23679727427597955
3764,318,192,126,277,41,0.6037735849056604,0.39622641509433965,0.8710691823899371,0.1289308176100629,616,151,209,256,564,52,0.24512987012987014,0.3392857142857143,0.4155844155844156,0.9155844155844156,0.08441558441558442
3765,308,184,124,267,41,0.5974025974025974,0.4025974025974026,0.8668831168831169,0.1331168831168831,746,147,210,389,690,56,0.1970509383378016,0.28150134048257375,0.5214477211796247,0.9249329758713136,0.07506702412868632
3766,1526,1273,253,1306,220,0.8342070773263434,0.1657929226736566,0.8558322411533421,0.14416775884665792,1198,172,333,693,973,225,0.14357262103505844,0.27796327212020033,0.5784641068447413,0.8121869782971619,0.18781302170283806
3767,364,233,131,320,44,0.6401098901098901,0.3598901098901099,0.8791208791208791,0.12087912087912088,756,149,243,364,638,118,0.1970899470899471,0.32142857142857145,0.48148148148148145,0.843915343915344,0.15608465608465608
3768,409,228,181,318,91,0.5574572127139364,0.44254278728606355,0.7775061124694377,0.22249388753056235,617,104,157,356,550,67,0.1685575364667747,0.2544570502431118,0.5769854132901134,0.8914100486223663,0.1085899513776337
3769,307,187,120,264,43,0.6091205211726385,0.39087947882736157,0.8599348534201955,0.14006514657980457,735,125,187,423,675,60,0.17006802721088435,0.254421768707483,0.5755102040816327,0.9183673469387755,0.08163265306122448
3770,796,584,212,666,130,0.7336683417085427,0.2663316582914573,0.8366834170854272,0.16331658291457288,1061,215,361,485,935,126,0.20263901979264845,0.3402450518378888,0.4571159283694628,0.88124410933082,0.11875589066918002
3771,343,213,130,299,44,0.6209912536443148,0.37900874635568516,0.8717201166180758,0.1282798833819242,727,138,236,353,611,116,0.18982118294360384,0.3246217331499312,0.4855570839064649,0.8404401650618982,0.15955983493810177
3772,1521,1271,250,1303,218,0.8356344510190664,0.16436554898093358,0.8566732412886259,0.1433267587113741,1205,181,336,688,979,226,0.15020746887966804,0.27883817427385893,0.570954356846473,0.812448132780083,0.187551867219917
3773,1282,998,284,1073,209,0.7784711388455539,0.22152886115444617,0.8369734789391575,0.16302652106084242,1166,102,230,834,888,278,0.08747855917667238,0.19725557461406518,0.7152658662092625,0.7615780445969125,0.23842195540308747
3774,166,46,120,155,11,0.27710843373493976,0.7228915662650602,0.9337349397590361,0.06626506024096386,505,118,152,235,455,50,0.23366336633663368,0.300990099009901,0.46534653465346537,0.900990099009901,0.09900990099009901
3775,1236,880,356,978,258,0.7119741100323624,0.28802588996763756,0.7912621359223301,0.2087378640776699,1217,102,245,870,939,278,0.0838126540673788,0.20131470829909615,0.714872637633525,0.7715694330320461,0.228430566967954
3776,1519,1269,250,1302,217,0.8354180381830152,0.16458196181698487,0.8571428571428571,0.14285714285714285,1165,166,319,680,941,224,0.1424892703862661,0.2738197424892704,0.5836909871244635,0.8077253218884121,0.192274678111588
3777,606,407,199,487,119,0.6716171617161716,0.32838283828382836,0.8036303630363036,0.19636963696369636,1039,251,263,525,973,66,0.24157844080846969,0.2531280076997113,0.5052935514918191,0.9364773820981713,0.06352261790182868
3778,1288,998,290,1079,209,0.7748447204968945,0.2251552795031056,0.8377329192546584,0.1622670807453416,1175,102,232,841,897,278,0.08680851063829788,0.1974468085106383,0.7157446808510638,0.7634042553191489,0.23659574468085107
3779,805,565,240,636,169,0.7018633540372671,0.2981366459627329,0.7900621118012422,0.20993788819875778,1266,288,420,558,1137,129,0.22748815165876776,0.33175355450236965,0.44075829383886256,0.8981042654028436,0.1018957345971564
3780,1524,1275,249,1309,215,0.8366141732283464,0.16338582677165353,0.8589238845144357,0.1410761154855643,1194,178,325,691,968,226,0.1490787269681742,0.2721943048576214,0.5787269681742043,0.8107202680067002,0.18927973199329984
3781,710,476,234,559,151,0.6704225352112676,0.3295774647887324,0.7873239436619718,0.21267605633802816,1237,220,289,728,1001,236,0.1778496362166532,0.23362974939369444,0.5885206143896524,0.809215844785772,0.19078415521422798
3782,381,204,177,298,83,0.5354330708661418,0.4645669291338583,0.7821522309711286,0.2178477690288714,612,103,160,349,548,64,0.16830065359477125,0.26143790849673204,0.5702614379084967,0.8954248366013072,0.10457516339869281
3783,364,225,139,320,44,0.6181318681318682,0.38186813186813184,0.8791208791208791,0.12087912087912088,772,133,249,390,653,119,0.172279792746114,0.3225388601036269,0.5051813471502591,0.8458549222797928,0.15414507772020725
3784,445,248,197,332,113,0.5573033707865168,0.44269662921348313,0.7460674157303371,0.2539325842696629,566,88,138,340,499,67,0.15547703180212014,0.24381625441696114,0.6007067137809188,0.8816254416961131,0.11837455830388692
3785,1906,1570,336,1599,307,0.8237145855194123,0.17628541448058763,0.8389296956977964,0.16107030430220357,1502,210,407,885,1227,275,0.13981358189081225,0.27097203728362185,0.5892143808255659,0.8169107856191744,0.18308921438082557
3786,311,183,128,271,40,0.5884244372990354,0.4115755627009646,0.8713826366559485,0.12861736334405144,621,126,186,309,567,54,0.2028985507246377,0.2995169082125604,0.4975845410628019,0.9130434782608695,0.08695652173913043
3787,604,382,222,479,125,0.6324503311258278,0.3675496688741722,0.793046357615894,0.20695364238410596,804,117,257,430,730,74,0.1455223880597015,0.31965174129353235,0.5348258706467661,0.9079601990049752,0.09203980099502487
3788,575,388,187,474,101,0.6747826086956522,0.32521739130434785,0.8243478260869566,0.17565217391304347,1184,269,324,591,1054,130,0.22719594594594594,0.27364864864864863,0.49915540540540543,0.8902027027027027,0.1097972972972973
3789,386,251,135,331,55,0.6502590673575129,0.34974093264248707,0.8575129533678757,0.14248704663212436,543,116,173,254,491,52,0.2136279926335175,0.31860036832412525,0.4677716390423573,0.9042357274401474,0.09576427255985268
3790,601,364,237,470,131,0.6056572379367721,0.39434276206322794,0.7820299500831946,0.21797004991680533,783,104,256,423,711,72,0.13282247765006386,0.3269476372924649,0.5402298850574713,0.9080459770114943,0.09195402298850575
3791,630,425,205,498,132,0.6746031746031746,0.3253968253968254,0.7904761904761904,0.20952380952380953,1046,172,253,621,915,131,0.16443594646271512,0.2418738049713193,0.5936902485659655,0.8747609942638623,0.12523900573613767
3792,1291,998,293,1082,209,0.7730441518202944,0.22695584817970565,0.8381099922540666,0.16189000774593337,1172,102,231,839,894,278,0.08703071672354949,0.197098976109215,0.7158703071672355,0.7627986348122867,0.23720136518771331
3793,563,346,217,444,119,0.6145648312611013,0.38543516873889877,0.7886323268206039,0.2113676731793961,758,113,223,422,683,75,0.14907651715039577,0.2941952506596306,0.5567282321899736,0.9010554089709762,0.09894459102902374
3794,325,201,124,283,42,0.6184615384615385,0.38153846153846155,0.8707692307692307,0.12923076923076923,588,142,191,255,536,52,0.24149659863945577,0.32482993197278914,0.4336734693877551,0.9115646258503401,0.08843537414965986
3795,480,283,197,391,89,0.5895833333333333,0.41041666666666665,0.8145833333333333,0.18541666666666667,935,93,227,615,768,167,0.09946524064171124,0.2427807486631016,0.6577540106951871,0.8213903743315508,0.1786096256684492
3796,322,199,123,282,40,0.6180124223602484,0.38198757763975155,0.8757763975155279,0.12422360248447205,612,133,188,291,558,54,0.2173202614379085,0.30718954248366015,0.47549019607843135,0.9117647058823529,0.08823529411764706
3797,1231,880,351,973,258,0.7148659626320065,0.2851340373679935,0.7904142973192526,0.20958570268074736,1213,102,244,867,935,278,0.08408903544929926,0.20115416323165705,0.7147568013190437,0.7708161582852432,0.2291838417147568
3798,4625,3943,682,3882,743,0.8525405405405405,0.14745945945945946,0.8393513513513513,0.16064864864864864,1862,259,521,1082,1618,244,0.13909774436090225,0.2798066595059076,0.5810955961331902,0.8689581095596133,0.1310418904403867
3799,590,367,223,463,127,0.6220338983050847,0.37796610169491524,0.7847457627118644,0.21525423728813559,768,112,250,406,698,70,0.14583333333333334,0.3255208333333333,0.5286458333333334,0.9088541666666666,0.09114583333333333
3800,1286,998,288,1077,209,0.776049766718507,0.223950233281493,0.8374805598755832,0.1625194401244168,1176,102,234,840,898,278,0.08673469387755102,0.1989795918367347,0.7142857142857143,0.7636054421768708,0.23639455782312926
3801,403,256,147,346,57,0.6352357320099256,0.36476426799007444,0.858560794044665,0.141439205955335,634,151,214,269,582,52,0.23817034700315456,0.33753943217665616,0.4242902208201893,0.917981072555205,0.08201892744479496
3802,1248,1031,217,1091,157,0.8261217948717948,0.17387820512820512,0.874198717948718,0.12580128205128205,1039,149,266,624,818,221,0.14340712223291627,0.25601539942252166,0.6005774783445621,0.7872954764196343,0.21270452358036573
3803,644,439,205,519,125,0.6816770186335404,0.31832298136645965,0.8059006211180124,0.19409937888198758,1127,149,245,733,901,226,0.13220940550133098,0.21739130434782608,0.650399290150843,0.7994676131322094,0.2005323868677906
3804,1518,1270,248,1301,217,0.836627140974967,0.16337285902503293,0.8570487483530962,0.1429512516469038,1187,175,326,686,962,225,0.14743049705139005,0.2746419545071609,0.577927548441449,0.81044650379107,0.18955349620893008
3805,432,285,147,344,88,0.6597222222222222,0.3402777777777778,0.7962962962962963,0.2037037037037037,596,174,172,250,588,8,0.29194630872483224,0.28859060402684567,0.41946308724832215,0.9865771812080537,0.013422818791946308
3806,101,47,54,41,60,0.46534653465346537,0.5346534653465347,0.40594059405940597,0.594059405940594,101,3,33,65,100,1,0.0297029702970297,0.32673267326732675,0.6435643564356436,0.9900990099009901,0.009900990099009901
3807,580,354,226,453,127,0.6103448275862069,0.3896551724137931,0.7810344827586206,0.2189655172413793,784,100,246,438,698,86,0.12755102040816327,0.3137755102040816,0.5586734693877551,0.8903061224489796,0.1096938775510204
3808,345,219,126,292,53,0.6347826086956522,0.3652173913043478,0.8463768115942029,0.1536231884057971,877,136,237,504,758,119,0.15507411630558723,0.2702394526795895,0.5746864310148233,0.8643101482326112,0.13568985176738882
3809,676,479,197,539,137,0.7085798816568047,0.29142011834319526,0.7973372781065089,0.20266272189349113,837,120,332,385,768,69,0.14336917562724014,0.3966547192353644,0.45997610513739545,0.9175627240143369,0.08243727598566308
3810,587,359,228,461,126,0.6115843270868825,0.38841567291311757,0.7853492333901193,0.21465076660988075,810,103,249,458,736,74,0.1271604938271605,0.3074074074074074,0.5654320987654321,0.908641975308642,0.09135802469135802
3811,1515,1207,308,1246,269,0.7966996699669967,0.2033003300330033,0.8224422442244225,0.17755775577557756,1397,275,441,681,1224,173,0.1968503937007874,0.31567644953471724,0.4874731567644954,0.8761632068718683,0.12383679312813171
3812,2851,2442,409,2444,407,0.8565415643633812,0.14345843563661873,0.8572430726061031,0.14275692739389687,1792,192,497,1103,1384,408,0.10714285714285714,0.27734375,0.6155133928571429,0.7723214285714286,0.22767857142857142
3813,1262,1033,229,1104,158,0.8185419968304279,0.1814580031695721,0.8748019017432647,0.12519809825673534,1071,150,284,637,849,222,0.1400560224089636,0.26517273576097106,0.5947712418300654,0.7927170868347339,0.20728291316526612
3814,1255,1034,221,1096,159,0.8239043824701195,0.17609561752988048,0.8733067729083666,0.12669322709163347,1055,149,273,633,833,222,0.14123222748815165,0.25876777251184835,0.6,0.7895734597156399,0.2104265402843602
3815,1256,1038,218,1098,158,0.8264331210191083,0.1735668789808917,0.8742038216560509,0.12579617834394904,1056,150,268,638,834,222,0.14204545454545456,0.2537878787878788,0.6041666666666666,0.7897727272727273,0.21022727272727273
3816,353,227,126,310,43,0.6430594900849859,0.35694050991501414,0.8781869688385269,0.12181303116147309,833,110,221,502,707,126,0.13205282112845138,0.2653061224489796,0.602641056422569,0.8487394957983193,0.15126050420168066
3817,1241,954,287,1025,216,0.7687348912167606,0.23126510878323933,0.8259468170829976,0.17405318291700242,1173,212,415,546,1038,135,0.18073316283034954,0.3537936913895993,0.46547314578005117,0.8849104859335039,0.11508951406649616
3818,455,290,165,322,133,0.6373626373626373,0.3626373626373626,0.7076923076923077,0.2923076923076923,320,51,112,157,313,7,0.159375,0.35,0.490625,0.978125,0.021875
3819,1503,1254,249,1287,216,0.8343313373253493,0.1656686626746507,0.8562874251497006,0.1437125748502994,1215,181,335,699,989,226,0.14897119341563786,0.2757201646090535,0.5753086419753086,0.8139917695473251,0.1860082304526749
3820,611,410,201,498,113,0.6710310965630114,0.32896890343698854,0.8150572831423896,0.18494271685761046,1077,222,280,575,949,128,0.20612813370473537,0.25998142989786444,0.5338904363974002,0.8811513463324049,0.11884865366759517
3821,221,95,126,192,29,0.4298642533936652,0.5701357466063348,0.8687782805429864,0.13122171945701358,591,76,128,387,406,185,0.12859560067681894,0.21658206429780033,0.6548223350253807,0.6869712351945855,0.3130287648054145
3822,805,559,246,657,148,0.6944099378881987,0.30559006211180123,0.8161490683229814,0.18385093167701863,1080,99,214,767,853,227,0.09166666666666666,0.19814814814814816,0.7101851851851851,0.7898148148148149,0.2101851851851852
3823,451,278,173,369,82,0.6164079822616408,0.3835920177383592,0.8181818181818182,0.18181818181818182,776,108,202,466,705,71,0.13917525773195877,0.2603092783505155,0.6005154639175257,0.9085051546391752,0.09149484536082474
3824,1014,758,256,838,176,0.747534516765286,0.252465483234714,0.8264299802761341,0.17357001972386588,1164,214,397,553,1019,145,0.18384879725085912,0.34106529209621994,0.47508591065292094,0.8754295532646048,0.12457044673539519
3825,1371,1060,311,1120,251,0.7731582786287381,0.22684172137126185,0.8169219547775346,0.18307804522246535,1299,295,440,564,1164,135,0.2270977675134719,0.33872209391839875,0.4341801385681293,0.8960739030023095,0.10392609699769054
3826,388,252,136,344,44,0.6494845360824743,0.35051546391752575,0.8865979381443299,0.1134020618556701,877,158,263,456,756,121,0.18015963511972635,0.2998859749144812,0.5199543899657925,0.8620296465222349,0.1379703534777651
3827,834,623,211,745,89,0.7470023980815348,0.2529976019184652,0.8932853717026379,0.10671462829736211,985,143,255,587,784,201,0.14517766497461929,0.25888324873096447,0.5959390862944163,0.7959390862944162,0.20406091370558377
3828,629,415,214,503,126,0.6597774244833068,0.34022257551669316,0.7996820349761526,0.20031796502384738,777,127,222,428,702,75,0.16344916344916344,0.2857142857142857,0.5508365508365508,0.9034749034749034,0.09652509652509653
3829,382,205,177,296,86,0.5366492146596858,0.46335078534031415,0.774869109947644,0.225130890052356,653,125,169,359,585,68,0.19142419601837674,0.25880551301684535,0.5497702909647779,0.8958652373660031,0.10413476263399694
3830,307,180,127,267,40,0.5863192182410424,0.41368078175895767,0.8697068403908795,0.13029315960912052,567,115,186,266,515,52,0.20282186948853614,0.328042328042328,0.4691358024691358,0.908289241622575,0.09171075837742504
3831,340,210,130,297,43,0.6176470588235294,0.38235294117647056,0.8735294117647059,0.1264705882352941,866,105,239,522,743,123,0.12124711316397228,0.2759815242494226,0.6027713625866051,0.8579676674364896,0.1420323325635104
3832,1375,1073,302,1157,218,0.7803636363636364,0.21963636363636363,0.8414545454545455,0.15854545454545454,1357,249,425,683,1091,266,0.18349299926308033,0.31319086219602066,0.5033161385408991,0.8039793662490788,0.19602063375092116
3833,1253,1033,220,1097,156,0.8244213886671987,0.17557861133280128,0.8754988028731046,0.12450119712689545,1102,156,313,633,880,222,0.14156079854809436,0.28402903811252267,0.574410163339383,0.7985480943738656,0.2014519056261343
3834,1122,847,275,905,217,0.7549019607843137,0.24509803921568626,0.8065953654188949,0.19340463458110516,1217,246,427,544,1082,135,0.20213640098603122,0.35086277732128185,0.44700082169268696,0.8890714872637634,0.11092851273623665
3835,476,286,190,394,82,0.6008403361344538,0.39915966386554624,0.8277310924369747,0.1722689075630252,895,103,245,547,821,74,0.11508379888268157,0.2737430167597765,0.6111731843575419,0.9173184357541899,0.08268156424581005
3836,1283,998,285,1074,209,0.7778643803585347,0.2221356196414653,0.8371005455962588,0.16289945440374123,1168,102,231,835,890,278,0.08732876712328767,0.19777397260273974,0.7148972602739726,0.761986301369863,0.238013698630137
3837,464,283,181,384,80,0.6099137931034483,0.3900862068965517,0.8275862068965517,0.1724137931034483,802,109,207,486,730,72,0.13591022443890274,0.2581047381546135,0.6059850374064838,0.9102244389027432,0.08977556109725686
3838,781,538,243,656,125,0.6888604353393086,0.3111395646606914,0.8399487836107554,0.16005121638924455,1043,100,210,733,819,224,0.09587727708533078,0.20134228187919462,0.7027804410354745,0.785234899328859,0.21476510067114093
3839,1510,1258,252,1293,217,0.833112582781457,0.16688741721854305,0.8562913907284768,0.14370860927152318,1180,163,319,698,955,225,0.13813559322033897,0.27033898305084747,0.5915254237288136,0.809322033898305,0.1906779661016949
3840,1168,879,289,910,258,0.752568493150685,0.24743150684931506,0.7791095890410958,0.2208904109589041,1164,102,232,830,886,278,0.08762886597938144,0.19931271477663232,0.7130584192439863,0.761168384879725,0.23883161512027493
3841,430,251,179,355,75,0.5837209302325581,0.41627906976744183,0.8255813953488372,0.1744186046511628,578,83,150,345,511,67,0.14359861591695502,0.25951557093425603,0.596885813148789,0.884083044982699,0.11591695501730104
3842,1261,1045,216,1103,158,0.8287073750991277,0.17129262490087233,0.8747026169706582,0.1252973830293418,1068,155,274,639,846,222,0.1451310861423221,0.2565543071161049,0.598314606741573,0.7921348314606742,0.20786516853932585
3843,1270,1042,228,1111,159,0.8204724409448819,0.1795275590551181,0.8748031496062992,0.1251968503937008,1073,149,293,631,852,221,0.13886300093196646,0.27306616961789376,0.5880708294501398,0.7940354147250699,0.2059645852749301
3844,604,376,228,477,127,0.6225165562913907,0.37748344370860926,0.7897350993377483,0.21026490066225165,807,127,243,437,734,73,0.15737298636926889,0.30111524163568776,0.5415117719950434,0.909541511771995,0.09045848822800495
3845,468,288,180,387,81,0.6153846153846154,0.38461538461538464,0.8269230769230769,0.17307692307692307,916,104,208,604,747,169,0.11353711790393013,0.22707423580786026,0.6593886462882096,0.8155021834061136,0.18449781659388648
3846,833,575,258,670,163,0.6902761104441777,0.3097238895558223,0.8043217286914766,0.19567827130852342,1083,103,209,771,856,227,0.0951061865189289,0.19298245614035087,0.7119113573407202,0.7903970452446907,0.20960295475530932
3847,670,266,404,423,247,0.3970149253731343,0.6029850746268657,0.6313432835820896,0.3686567164179104,146,3,58,85,145,1,0.02054794520547945,0.3972602739726027,0.5821917808219178,0.9931506849315068,0.00684931506849315
3848,1238,880,358,980,258,0.7108239095315024,0.28917609046849757,0.7915993537964459,0.2084006462035541,1227,102,251,874,949,278,0.08312958435207823,0.2045639771801141,0.7123064384678076,0.7734311328443357,0.2265688671556642
3849,690,485,205,557,133,0.7028985507246377,0.2971014492753623,0.8072463768115942,0.1927536231884058,867,124,336,407,799,68,0.14302191464821223,0.3875432525951557,0.46943483275663206,0.9215686274509803,0.0784313725490196
3850,1284,998,286,1075,209,0.7772585669781932,0.22274143302180685,0.8372274143302181,0.16277258566978192,1164,102,228,834,886,278,0.08762886597938144,0.1958762886597938,0.7164948453608248,0.761168384879725,0.23883161512027493
3851,343,212,131,299,44,0.6180758017492711,0.3819241982507289,0.8717201166180758,0.1282798833819242,658,166,221,271,604,54,0.25227963525835867,0.33586626139817627,0.41185410334346506,0.9179331306990881,0.08206686930091185
3852,1240,880,360,982,258,0.7096774193548387,0.2903225806451613,0.7919354838709678,0.20806451612903226,1228,102,251,875,950,278,0.08306188925081433,0.20439739413680783,0.7125407166123778,0.7736156351791531,0.2263843648208469
3853,1167,880,287,909,258,0.7540702656383891,0.24592973436161097,0.7789203084832905,0.2210796915167095,1161,102,232,827,883,278,0.08785529715762273,0.19982773471145565,0.7123169681309216,0.7605512489233419,0.23944875107665806
3854,1252,1031,221,1095,157,0.8234824281150159,0.17651757188498401,0.8746006389776357,0.1253993610223642,1080,149,300,631,858,222,0.13796296296296295,0.2777777777777778,0.5842592592592593,0.7944444444444444,0.20555555555555555
3855,340,224,116,287,53,0.6588235294117647,0.3411764705882353,0.8441176470588235,0.15588235294117647,575,164,176,235,566,9,0.2852173913043478,0.3060869565217391,0.40869565217391307,0.9843478260869565,0.01565217391304348
3856,809,587,222,649,160,0.7255871446229913,0.27441285537700866,0.8022249690976514,0.19777503090234858,795,109,304,382,727,68,0.1371069182389937,0.38238993710691827,0.48050314465408805,0.9144654088050315,0.08553459119496855
3857,461,284,177,380,81,0.6160520607375272,0.3839479392624729,0.824295010845987,0.175704989154013,803,95,216,492,730,73,0.11830635118306351,0.26899128268991285,0.6127023661270237,0.9090909090909091,0.09090909090909091
3858,1330,992,338,1064,266,0.7458646616541353,0.25413533834586466,0.8,0.2,1185,223,397,565,1054,131,0.1881856540084388,0.33502109704641353,0.4767932489451477,0.889451476793249,0.11054852320675106
3859,826,625,201,736,90,0.7566585956416465,0.24334140435835352,0.8910411622276029,0.1089588377723971,961,136,240,585,760,201,0.14151925078043703,0.2497398543184183,0.6087408949011447,0.7908428720083247,0.20915712799167535
3860,1517,1265,252,1300,217,0.8338826631509558,0.16611733684904417,0.8569545154911009,0.14304548450889915,1155,163,315,677,930,225,0.14112554112554113,0.2727272727272727,0.5861471861471862,0.8051948051948052,0.19480519480519481
3861,1282,998,284,1073,209,0.7784711388455539,0.22152886115444617,0.8369734789391575,0.16302652106084242,1167,102,230,835,889,278,0.08740359897172237,0.19708654670094258,0.715509854327335,0.7617823479005998,0.23821765209940018
3862,865,623,242,699,166,0.7202312138728324,0.27976878612716766,0.8080924855491329,0.19190751445086704,1204,194,379,631,977,227,0.1611295681063123,0.31478405315614616,0.5240863787375415,0.8114617940199336,0.18853820598006646
3863,498,294,204,399,99,0.5903614457831325,0.40963855421686746,0.8012048192771084,0.19879518072289157,957,92,231,634,789,168,0.0961337513061651,0.2413793103448276,0.6624869383490073,0.8244514106583072,0.1755485893416928
3864,2163,874,1289,1270,893,0.4040684234858992,0.5959315765141008,0.5871474803513639,0.4128525196486362,403,3,145,255,403,0,0.007444168734491315,0.3598014888337469,0.6327543424317618,1.0,0.0
3865,1166,877,289,911,255,0.7521440823327615,0.2478559176672384,0.7813036020583191,0.21869639794168097,1159,102,228,829,881,278,0.08800690250215704,0.19672131147540983,0.7152717860224331,0.7601380500431406,0.23986194995685936
3866,1251,1033,218,1095,156,0.8257394084732215,0.17426059152677859,0.8752997601918465,0.12470023980815348,1075,155,284,636,853,222,0.14418604651162792,0.2641860465116279,0.5916279069767442,0.7934883720930233,0.20651162790697675
3867,464,283,181,383,81,0.6099137931034483,0.3900862068965517,0.8254310344827587,0.17456896551724138,866,118,226,522,792,74,0.13625866050808313,0.26096997690531176,0.6027713625866051,0.9145496535796767,0.08545034642032333
3868,1170,880,290,912,258,0.7521367521367521,0.24786324786324787,0.7794871794871795,0.2205128205128205,1170,102,237,831,892,278,0.08717948717948718,0.20256410256410257,0.7102564102564103,0.7623931623931623,0.2376068376068376
3869,1312,351,961,709,603,0.26753048780487804,0.7324695121951219,0.5403963414634146,0.45960365853658536,324,3,113,208,324,0,0.009259259259259259,0.3487654320987654,0.6419753086419753,1.0,0.0
3870,1241,1031,210,1084,157,0.830781627719581,0.16921837228041903,0.8734891216760677,0.12651087832393232,1048,149,272,627,827,221,0.14217557251908397,0.2595419847328244,0.5982824427480916,0.7891221374045801,0.21087786259541985
3871,1498,1248,250,1283,215,0.8331108144192256,0.16688918558077437,0.8564753004005341,0.14352469959946595,1190,175,328,687,965,225,0.14705882352941177,0.27563025210084036,0.5773109243697478,0.8109243697478992,0.18907563025210083
3872,311,182,129,271,40,0.5852090032154341,0.41479099678456594,0.8713826366559485,0.12861736334405144,730,130,192,408,673,57,0.1780821917808219,0.26301369863013696,0.5589041095890411,0.9219178082191781,0.07808219178082192
3873,357,226,131,310,47,0.6330532212885154,0.36694677871148457,0.8683473389355743,0.13165266106442577,928,151,265,512,805,123,0.1627155172413793,0.2855603448275862,0.5517241379310345,0.8674568965517241,0.13254310344827586
3874,573,392,181,484,89,0.6841186736474695,0.3158813263525305,0.8446771378708552,0.15532286212914484,1028,217,282,529,957,71,0.21108949416342412,0.27431906614785995,0.5145914396887159,0.9309338521400778,0.06906614785992218
3875,1162,880,282,904,258,0.7573149741824441,0.24268502581755594,0.7779690189328744,0.22203098106712565,1156,102,230,824,878,278,0.08823529411764706,0.19896193771626297,0.71280276816609,0.759515570934256,0.24048442906574394
3876,463,285,178,381,82,0.6155507559395248,0.38444924406047515,0.8228941684665226,0.1771058315334773,813,95,208,510,740,73,0.11685116851168512,0.25584255842558423,0.6273062730627307,0.9102091020910209,0.0897908979089791
3877,611,393,218,477,134,0.6432078559738135,0.3567921440261866,0.7806873977086743,0.2193126022913257,1108,281,287,540,1042,66,0.2536101083032491,0.25902527075812276,0.48736462093862815,0.9404332129963899,0.05956678700361011
3878,402,257,145,344,58,0.6393034825870647,0.36069651741293535,0.8557213930348259,0.14427860696517414,595,134,203,258,542,53,0.22521008403361345,0.3411764705882353,0.4336134453781513,0.9109243697478991,0.08907563025210084
3879,824,575,249,661,163,0.6978155339805825,0.30218446601941745,0.8021844660194175,0.19781553398058252,1068,103,203,762,841,227,0.09644194756554307,0.1900749063670412,0.7134831460674157,0.7874531835205992,0.21254681647940074
3880,823,625,198,731,92,0.7594167679222357,0.24058323207776428,0.8882138517618469,0.1117861482381531,949,136,230,583,749,200,0.14330874604847207,0.24236037934668073,0.6143308746048473,0.7892518440463646,0.2107481559536354
3881,320,193,127,280,40,0.603125,0.396875,0.875,0.125,754,120,201,433,696,58,0.15915119363395225,0.26657824933687,0.5742705570291777,0.9230769230769231,0.07692307692307693
3882,837,559,278,644,193,0.6678614097968937,0.3321385902031063,0.7694145758661888,0.23058542413381122,1460,384,339,737,1295,165,0.26301369863013696,0.2321917808219178,0.5047945205479452,0.886986301369863,0.11301369863013698
3883,696,496,200,569,127,0.7126436781609196,0.28735632183908044,0.8175287356321839,0.1824712643678161,821,116,320,385,752,69,0.14129110840438489,0.38976857490864797,0.4689403166869671,0.9159561510353228,0.08404384896467722
3884,463,269,194,375,88,0.5809935205183585,0.4190064794816415,0.8099352051835853,0.1900647948164147,614,97,153,364,547,67,0.15798045602605862,0.249185667752443,0.5928338762214984,0.8908794788273615,0.10912052117263844
3885,417,236,181,343,74,0.565947242206235,0.434052757793765,0.8225419664268585,0.1774580335731415,1053,239,227,587,898,155,0.22697056030389365,0.21557454890788225,0.5574548907882241,0.8528015194681862,0.14719848053181386
3886,1285,998,287,1076,209,0.7766536964980545,0.22334630350194554,0.8373540856031129,0.16264591439688716,1166,102,229,835,888,278,0.08747855917667238,0.19639794168096056,0.7161234991423671,0.7615780445969125,0.23842195540308747
3887,726,530,196,597,129,0.7300275482093664,0.2699724517906336,0.8223140495867769,0.17768595041322313,791,107,297,387,723,68,0.13527180783817952,0.3754740834386852,0.4892541087231353,0.9140328697850821,0.08596713021491782
3888,610,385,225,486,124,0.6311475409836066,0.36885245901639346,0.7967213114754098,0.20327868852459016,837,123,250,464,761,76,0.14695340501792115,0.2986857825567503,0.5543608124253285,0.9091995221027479,0.0908004778972521
3889,1254,1031,223,1098,156,0.8221690590111643,0.17783094098883573,0.8755980861244019,0.12440191387559808,1076,155,282,639,855,221,0.14405204460966542,0.2620817843866171,0.5938661710037175,0.7946096654275093,0.2053903345724907
3890,730,510,220,574,156,0.6986301369863014,0.3013698630136986,0.7863013698630137,0.2136986301369863,737,134,198,405,665,72,0.18181818181818182,0.26865671641791045,0.5495251017639078,0.9023066485753053,0.09769335142469471
3891,541,373,168,447,94,0.6894639556377079,0.31053604436229204,0.8262476894639557,0.17375231053604437,990,243,243,504,925,65,0.24545454545454545,0.24545454545454545,0.509090909090909,0.9343434343434344,0.06565656565656566
3892,390,208,182,301,89,0.5333333333333333,0.4666666666666667,0.7717948717948718,0.2282051282051282,607,102,162,343,541,66,0.16803953871499178,0.26688632619439867,0.5650741350906096,0.8912685337726524,0.10873146622734761
3893,333,211,122,290,43,0.6336336336336337,0.3663663663663664,0.8708708708708709,0.12912912912912913,740,158,258,324,624,116,0.21351351351351353,0.34864864864864864,0.43783783783783786,0.8432432432432433,0.15675675675675677
3894,471,327,144,406,65,0.6942675159235668,0.3057324840764331,0.861995753715499,0.13800424628450106,825,170,218,437,769,56,0.20606060606060606,0.2642424242424242,0.5296969696969697,0.9321212121212121,0.06787878787878789
3895,1295,1001,294,1084,211,0.772972972972973,0.22702702702702704,0.8370656370656371,0.16293436293436295,1175,102,231,842,897,278,0.08680851063829788,0.19659574468085106,0.7165957446808511,0.7634042553191489,0.23659574468085107
3896,1286,1002,284,1005,281,0.7791601866251944,0.2208398133748056,0.78149300155521,0.21850699844479005,1168,102,235,831,889,279,0.08732876712328767,0.2011986301369863,0.711472602739726,0.7611301369863014,0.23886986301369864
3897,1501,1251,250,1284,217,0.8334443704197202,0.1665556295802798,0.8554297135243171,0.14457028647568287,1186,175,324,687,961,225,0.1475548060708263,0.27318718381112983,0.5792580101180439,0.8102866779089376,0.1897133220910624
3898,1512,1261,251,1296,216,0.833994708994709,0.16600529100529102,0.8571428571428571,0.14285714285714285,1173,172,325,676,948,225,0.1466325660699062,0.2770673486786019,0.5763000852514919,0.8081841432225064,0.1918158567774936
3899,1496,1255,241,1280,216,0.838903743315508,0.16109625668449198,0.8556149732620321,0.1443850267379679,1162,169,312,681,937,225,0.14543889845094665,0.2685025817555938,0.5860585197934596,0.806368330464716,0.193631669535284
3900,647,430,217,516,131,0.6646058732612056,0.33539412673879443,0.7975270479134466,0.20247295208655333,1131,263,275,593,1062,69,0.23253757736516356,0.24314765694076038,0.5243147656940761,0.9389920424403183,0.0610079575596817
3901,381,201,180,291,90,0.5275590551181102,0.47244094488188976,0.7637795275590551,0.23622047244094488,629,110,162,357,561,68,0.17488076311605724,0.2575516693163752,0.5675675675675675,0.8918918918918919,0.10810810810810811
3902,222,95,127,193,29,0.42792792792792794,0.5720720720720721,0.8693693693693694,0.13063063063063063,593,76,129,388,408,185,0.1281618887015177,0.2175379426644182,0.654300168634064,0.688026981450253,0.31197301854974707
3903,395,216,179,322,73,0.5468354430379747,0.4531645569620253,0.8151898734177215,0.1848101265822785,635,114,160,361,568,67,0.1795275590551181,0.25196850393700787,0.568503937007874,0.8944881889763779,0.10551181102362205
3904,572,378,194,445,127,0.6608391608391608,0.33916083916083917,0.777972027972028,0.22202797202797203,719,129,193,397,648,71,0.17941585535465926,0.26842837273991654,0.5521557719054242,0.9012517385257302,0.09874826147426982
3905,576,381,195,464,112,0.6614583333333334,0.3385416666666667,0.8055555555555556,0.19444444444444445,1069,274,285,510,1003,66,0.25631431244153413,0.2666043030869972,0.47708138447146864,0.9382600561272217,0.0617399438727783
3906,454,282,172,362,92,0.6211453744493393,0.3788546255506608,0.7973568281938326,0.2026431718061674,742,104,181,457,669,73,0.14016172506738545,0.24393530997304583,0.6159029649595688,0.9016172506738545,0.09838274932614555
3907,404,221,183,312,92,0.5470297029702971,0.452970297029703,0.7722772277227723,0.22772277227722773,553,82,140,331,487,66,0.14828209764918626,0.25316455696202533,0.5985533453887885,0.8806509945750453,0.11934900542495479
3908,391,212,179,318,73,0.5421994884910486,0.4578005115089514,0.8132992327365729,0.1867007672634271,648,117,165,366,581,67,0.18055555555555555,0.25462962962962965,0.5648148148148148,0.8966049382716049,0.10339506172839506
3909,343,200,143,294,49,0.5830903790087464,0.41690962099125367,0.8571428571428571,0.14285714285714285,822,167,216,439,762,60,0.20316301703163017,0.26277372262773724,0.5340632603406326,0.927007299270073,0.072992700729927
3910,1242,913,329,969,273,0.7351046698872786,0.2648953301127214,0.7801932367149759,0.21980676328502416,1021,139,347,535,889,132,0.13614103819784526,0.33986287952987265,0.5239960822722821,0.8707149853085211,0.12928501469147893
3911,1193,919,274,964,229,0.7703269069572506,0.22967309304274938,0.8080469404861693,0.19195305951383068,1312,254,411,647,1087,225,0.19359756097560976,0.3132621951219512,0.49314024390243905,0.8285060975609756,0.1714939024390244
3912,608,385,223,486,122,0.6332236842105263,0.3667763157894737,0.7993421052631579,0.20065789473684212,829,116,232,481,750,79,0.1399276236429433,0.2798552472858866,0.5802171290711701,0.9047044632086851,0.09529553679131483
3913,162,40,122,154,8,0.24691358024691357,0.7530864197530864,0.9506172839506173,0.04938271604938271,704,119,166,419,648,56,0.1690340909090909,0.23579545454545456,0.5951704545454546,0.9204545454545454,0.07954545454545454
3914,773,556,217,652,121,0.7192755498059509,0.2807244501940492,0.8434670116429496,0.15653298835705046,855,107,225,523,687,168,0.12514619883040937,0.2631578947368421,0.6116959064327485,0.8035087719298246,0.19649122807017544
3915,1289,998,291,1080,209,0.7742435996896819,0.22575640031031807,0.8378588052754073,0.1621411947245927,1168,102,229,837,890,278,0.08732876712328767,0.19606164383561644,0.7166095890410958,0.761986301369863,0.238013698630137
3916,335,212,123,293,42,0.6328358208955224,0.36716417910447763,0.8746268656716418,0.1253731343283582,655,120,215,320,538,117,0.183206106870229,0.3282442748091603,0.48854961832061067,0.8213740458015267,0.17862595419847327
3917,464,316,148,392,72,0.6810344827586207,0.31896551724137934,0.8448275862068966,0.15517241379310345,692,148,227,317,576,116,0.2138728323699422,0.32803468208092484,0.45809248554913296,0.8323699421965318,0.1676300578034682
3918,582,359,223,462,120,0.6168384879725086,0.38316151202749144,0.7938144329896907,0.20618556701030927,778,112,248,418,705,73,0.14395886889460155,0.31876606683804626,0.5372750642673522,0.9061696658097687,0.09383033419023136
3919,1291,998,293,1082,209,0.7730441518202944,0.22695584817970565,0.8381099922540666,0.16189000774593337,1178,102,233,843,900,278,0.0865874363327674,0.19779286926994907,0.7156196943972836,0.7640067911714771,0.23599320882852293
3920,1498,1253,245,1283,215,0.8364485981308412,0.16355140186915887,0.8564753004005341,0.14352469959946595,1196,181,326,689,970,226,0.15133779264214048,0.2725752508361204,0.5760869565217391,0.8110367892976589,0.18896321070234115
3921,314,189,125,273,41,0.6019108280254777,0.3980891719745223,0.8694267515923567,0.1305732484076433,777,134,198,445,716,61,0.17245817245817247,0.2548262548262548,0.5727155727155727,0.9214929214929215,0.07850707850707851
3922,335,210,125,277,58,0.6268656716417911,0.373134328358209,0.826865671641791,0.17313432835820897,729,115,186,428,669,60,0.15775034293552812,0.2551440329218107,0.5871056241426612,0.9176954732510288,0.0823045267489712
3923,1284,998,286,1075,209,0.7772585669781932,0.22274143302180685,0.8372274143302181,0.16277258566978192,1167,102,230,835,889,278,0.08740359897172237,0.19708654670094258,0.715509854327335,0.7617823479005998,0.23821765209940018
3924,787,549,238,649,138,0.6975857687420585,0.30241423125794153,0.8246505717916137,0.17534942820838628,1067,99,209,759,840,227,0.09278350515463918,0.1958762886597938,0.711340206185567,0.7872539831302718,0.21274601686972822
3925,1171,880,291,913,258,0.7514944491887275,0.24850555081127243,0.7796754910333049,0.22032450896669514,1175,102,238,835,897,278,0.08680851063829788,0.2025531914893617,0.7106382978723405,0.7634042553191489,0.23659574468085107
3926,3759,3307,452,3139,620,0.87975525405693,0.12024474594306997,0.8350625166267625,0.16493748337323758,1842,164,355,1323,1391,451,0.08903365906623235,0.19272529858849077,0.7182410423452769,0.755157437567861,0.24484256243213898
3927,852,596,256,676,176,0.6995305164319249,0.3004694835680751,0.7934272300469484,0.20657276995305165,1288,245,400,643,1066,222,0.19021739130434784,0.3105590062111801,0.49922360248447206,0.827639751552795,0.17236024844720496
3928,319,190,129,274,45,0.5956112852664577,0.4043887147335423,0.8589341692789969,0.14106583072100312,747,157,207,383,688,59,0.2101740294511379,0.27710843373493976,0.5127175368139224,0.9210174029451138,0.07898259705488621
3929,1293,998,295,1084,209,0.7718484145398299,0.22815158546017014,0.8383604021655066,0.16163959783449341,1178,102,233,843,900,278,0.0865874363327674,0.19779286926994907,0.7156196943972836,0.7640067911714771,0.23599320882852293
3930,1914,1568,346,1606,308,0.819226750261233,0.180773249738767,0.8390804597701149,0.16091954022988506,1238,152,352,734,1062,176,0.12277867528271405,0.284329563812601,0.592891760904685,0.8578352180936996,0.1421647819063005
3931,315,190,125,272,43,0.6031746031746031,0.3968253968253968,0.8634920634920635,0.1365079365079365,718,126,186,406,660,58,0.17548746518105848,0.2590529247910863,0.5654596100278552,0.9192200557103064,0.0807799442896936
3932,1294,998,296,1085,209,0.7712519319938176,0.2287480680061824,0.8384853168469861,0.1615146831530139,1177,102,232,843,899,278,0.08666100254885302,0.19711129991503823,0.7162276975361087,0.7638062871707731,0.23619371282922685
3933,1251,1033,218,1095,156,0.8257394084732215,0.17426059152677859,0.8752997601918465,0.12470023980815348,1085,155,302,628,864,221,0.14285714285714285,0.2783410138248848,0.5788018433179724,0.7963133640552995,0.20368663594470046
3934,674,431,243,495,179,0.6394658753709199,0.36053412462908013,0.7344213649851632,0.2655786350148368,1097,171,255,671,873,224,0.15587967183226983,0.2324521422060164,0.6116681859617138,0.7958067456700091,0.2041932543299909
3935,369,249,120,324,45,0.6747967479674797,0.3252032520325203,0.8780487804878049,0.12195121951219512,1038,159,241,638,884,154,0.1531791907514451,0.2321772639691715,0.6146435452793835,0.8516377649325626,0.14836223506743737
3936,375,198,177,286,89,0.528,0.472,0.7626666666666667,0.23733333333333334,595,103,149,343,528,67,0.173109243697479,0.2504201680672269,0.5764705882352941,0.8873949579831932,0.11260504201680673
3937,735,523,212,597,138,0.7115646258503401,0.28843537414965986,0.8122448979591836,0.18775510204081633,1301,294,401,606,1080,221,0.22598001537279017,0.30822444273635663,0.4657955418908532,0.830130668716372,0.16986933128362797
3938,1288,998,290,1079,209,0.7748447204968945,0.2251552795031056,0.8377329192546584,0.1622670807453416,1172,102,232,838,894,278,0.08703071672354949,0.19795221843003413,0.7150170648464164,0.7627986348122867,0.23720136518771331
3939,1285,1027,258,1058,227,0.7992217898832685,0.20077821011673153,0.8233463035019455,0.17665369649805449,1370,290,407,673,1154,216,0.2116788321167883,0.29708029197080293,0.4912408759124088,0.8423357664233576,0.15766423357664233
3940,371,192,179,284,87,0.5175202156334232,0.48247978436657685,0.7654986522911051,0.23450134770889489,614,109,160,345,547,67,0.1775244299674267,0.26058631921824105,0.5618892508143323,0.8908794788273615,0.10912052117263844
3941,153,38,115,145,8,0.24836601307189543,0.7516339869281046,0.9477124183006536,0.05228758169934641,480,108,135,237,429,51,0.225,0.28125,0.49375,0.89375,0.10625
3942,311,193,118,271,40,0.6205787781350482,0.37942122186495175,0.8713826366559485,0.12861736334405144,780,127,195,458,718,62,0.16282051282051282,0.25,0.5871794871794872,0.9205128205128205,0.07948717948717948
3943,835,575,260,672,163,0.688622754491018,0.31137724550898205,0.8047904191616766,0.19520958083832335,1082,103,209,770,855,227,0.09519408502772643,0.19316081330868762,0.711645101663586,0.7902033271719039,0.2097966728280961
3944,349,221,128,307,42,0.6332378223495702,0.3667621776504298,0.8796561604584527,0.12034383954154727,692,128,238,326,576,116,0.18497109826589594,0.3439306358381503,0.47109826589595377,0.8323699421965318,0.1676300578034682
3945,1253,1034,219,1094,159,0.825219473264166,0.174780526735834,0.8731045490822027,0.12689545091779728,1045,149,267,629,823,222,0.14258373205741626,0.2555023923444976,0.6019138755980862,0.7875598086124402,0.21244019138755982
3946,352,222,130,305,47,0.6306818181818182,0.3693181818181818,0.8664772727272727,0.13352272727272727,641,162,211,268,588,53,0.25273010920436817,0.3291731669266771,0.41809672386895474,0.9173166926677067,0.08268330733229329
3947,1162,880,282,904,258,0.7573149741824441,0.24268502581755594,0.7779690189328744,0.22203098106712565,1156,102,230,824,878,278,0.08823529411764706,0.19896193771626297,0.71280276816609,0.759515570934256,0.24048442906574394
3948,1295,998,297,1086,209,0.7706563706563706,0.22934362934362934,0.8386100386100386,0.1613899613899614,1171,102,229,840,893,278,0.08710503842869342,0.19555935098206662,0.71733561058924,0.762596071733561,0.23740392826643894
3949,1510,1262,248,1294,216,0.8357615894039735,0.16423841059602648,0.856953642384106,0.14304635761589404,1158,163,317,678,933,225,0.14075993091537134,0.27374784110535405,0.5854922279792746,0.805699481865285,0.19430051813471502
3950,619,408,211,474,145,0.6591276252019386,0.3408723747980614,0.7657512116316639,0.23424878836833601,1081,140,234,707,853,228,0.12950971322849214,0.21646623496762257,0.6540240518038853,0.7890841813135985,0.21091581868640147
3951,1405,1126,279,1150,255,0.801423487544484,0.19857651245551602,0.8185053380782918,0.18149466192170818,1195,206,390,599,1030,165,0.1723849372384937,0.3263598326359833,0.501255230125523,0.8619246861924686,0.13807531380753138
3952,1165,883,282,907,258,0.7579399141630901,0.24206008583690988,0.7785407725321889,0.22145922746781116,1156,102,230,824,878,278,0.08823529411764706,0.19896193771626297,0.71280276816609,0.759515570934256,0.24048442906574394
3953,3372,2843,529,2862,510,0.8431198102016607,0.15688018979833926,0.8487544483985765,0.1512455516014235,1968,204,529,1235,1504,464,0.10365853658536585,0.2688008130081301,0.6275406504065041,0.7642276422764228,0.23577235772357724
3954,497,313,184,414,83,0.6297786720321932,0.3702213279678068,0.8329979879275654,0.16700201207243462,827,104,233,490,753,74,0.12575574365175332,0.28174123337363965,0.592503022974607,0.9105199516324063,0.08948004836759371
3955,621,439,182,495,126,0.7069243156199678,0.29307568438003223,0.7971014492753623,0.2028985507246377,765,110,285,370,699,66,0.1437908496732026,0.37254901960784315,0.48366013071895425,0.9137254901960784,0.08627450980392157
3956,462,259,203,357,105,0.5606060606060606,0.4393939393939394,0.7727272727272727,0.22727272727272727,622,107,162,353,554,68,0.1720257234726688,0.2604501607717042,0.567524115755627,0.8906752411575563,0.10932475884244373
3957,1290,1070,220,1128,162,0.8294573643410853,0.17054263565891473,0.8744186046511628,0.12558139534883722,1059,149,266,644,838,221,0.14069877242681775,0.251180358829084,0.6081208687440982,0.7913125590179415,0.20868744098205855
3958,1231,929,302,998,233,0.7546709991876523,0.24532900081234768,0.8107229894394801,0.1892770105605199,1127,201,372,554,994,133,0.17834960070984915,0.3300798580301686,0.49157054125998223,0.8819875776397516,0.11801242236024845
3959,166,102,64,76,90,0.6144578313253012,0.3855421686746988,0.4578313253012048,0.5421686746987951,405,181,174,50,405,0,0.4469135802469136,0.42962962962962964,0.12345679012345678,1.0,0.0
3960,1295,998,297,1086,209,0.7706563706563706,0.22934362934362934,0.8386100386100386,0.1613899613899614,1180,102,235,843,902,278,0.08644067796610169,0.19915254237288135,0.714406779661017,0.764406779661017,0.23559322033898306
3961,362,223,139,316,46,0.6160220994475138,0.3839779005524862,0.8729281767955801,0.1270718232044199,744,133,241,370,627,117,0.17876344086021506,0.3239247311827957,0.49731182795698925,0.842741935483871,0.15725806451612903
3962,1257,1032,225,1099,158,0.8210023866348448,0.17899761336515513,0.8743038981702467,0.12569610182975338,1058,149,282,627,836,222,0.14083175803402648,0.2665406427221172,0.5926275992438563,0.7901701323251418,0.20982986767485823
3963,712,507,205,569,143,0.7120786516853933,0.28792134831460675,0.7991573033707865,0.20084269662921347,830,118,316,396,761,69,0.14216867469879518,0.38072289156626504,0.4771084337349398,0.9168674698795181,0.08313253012048193
3964,1234,880,354,976,258,0.713128038897893,0.28687196110210694,0.7909238249594813,0.20907617504051865,1216,102,245,869,938,278,0.08388157894736842,0.20148026315789475,0.7146381578947368,0.7713815789473685,0.22861842105263158
3965,610,423,187,497,113,0.6934426229508197,0.30655737704918035,0.8147540983606557,0.18524590163934426,1166,252,313,601,1032,134,0.21612349914236706,0.2684391080617496,0.5154373927958834,0.8850771869639794,0.11492281303602059
3966,538,363,175,445,93,0.6747211895910781,0.3252788104089219,0.8271375464684015,0.17286245353159851,1100,211,247,642,936,164,0.1918181818181818,0.22454545454545455,0.5836363636363636,0.850909090909091,0.14909090909090908
3967,2154,1830,324,1754,400,0.8495821727019499,0.15041782729805014,0.8142989786443825,0.18570102135561745,1331,241,443,647,1134,197,0.18106686701728025,0.33283245679939893,0.4861006761833208,0.8519909842223892,0.14800901577761083
3968,322,197,125,277,45,0.6118012422360248,0.38819875776397517,0.860248447204969,0.13975155279503104,757,128,198,431,698,59,0.1690885072655218,0.261558784676354,0.5693527080581242,0.9220607661822986,0.07793923381770146
3969,372,237,135,304,68,0.6370967741935484,0.3629032258064516,0.8172043010752689,0.1827956989247312,516,154,164,198,508,8,0.29844961240310075,0.3178294573643411,0.38372093023255816,0.9844961240310077,0.015503875968992248
3970,381,202,179,293,88,0.5301837270341208,0.46981627296587924,0.7690288713910761,0.23097112860892388,599,102,155,342,532,67,0.17028380634390652,0.2587646076794658,0.5709515859766278,0.8881469115191987,0.11185308848080133
3971,315,183,132,274,41,0.580952380952381,0.41904761904761906,0.8698412698412699,0.13015873015873017,608,138,200,270,556,52,0.22697368421052633,0.32894736842105265,0.4440789473684211,0.9144736842105263,0.08552631578947369
3972,296,183,113,257,39,0.6182432432432432,0.38175675675675674,0.8682432432432432,0.13175675675675674,531,122,168,241,479,52,0.2297551789077213,0.3163841807909605,0.4538606403013183,0.9020715630885122,0.09792843691148775
3973,392,248,144,308,84,0.6326530612244898,0.3673469387755102,0.7857142857142857,0.21428571428571427,558,136,149,273,547,11,0.24372759856630824,0.2670250896057348,0.489247311827957,0.9802867383512545,0.01971326164874552
3974,458,329,129,388,70,0.7183406113537117,0.2816593886462882,0.8471615720524017,0.15283842794759825,810,215,228,367,705,105,0.2654320987654321,0.2814814814814815,0.45308641975308644,0.8703703703703703,0.12962962962962962
3975,1515,1265,250,1298,217,0.834983498349835,0.16501650165016502,0.8567656765676568,0.14323432343234324,1183,175,321,687,958,225,0.14792899408284024,0.2713440405748098,0.5807269653423499,0.8098055790363483,0.19019442096365174
3976,1170,879,291,912,258,0.7512820512820513,0.24871794871794872,0.7794871794871795,0.2205128205128205,1166,102,234,830,888,278,0.08747855917667238,0.2006861063464837,0.7118353344768439,0.7615780445969125,0.23842195540308747
3977,1468,1161,307,1247,221,0.7908719346049047,0.20912806539509537,0.8494550408719346,0.1505449591280654,1224,208,412,604,1048,176,0.16993464052287582,0.3366013071895425,0.4934640522875817,0.8562091503267973,0.1437908496732026
3978,388,230,158,296,92,0.5927835051546392,0.4072164948453608,0.7628865979381443,0.23711340206185566,594,172,174,248,584,10,0.2895622895622896,0.29292929292929293,0.4175084175084175,0.9831649831649831,0.016835016835016835
3979,1268,1046,222,1111,157,0.8249211356466877,0.1750788643533123,0.8761829652996845,0.12381703470031545,1066,156,272,638,845,221,0.14634146341463414,0.2551594746716698,0.5984990619136961,0.7926829268292683,0.2073170731707317
3980,4146,3562,584,3490,656,0.859141341051616,0.14085865894838398,0.8417752050168837,0.15822479498311626,1847,171,530,1146,1449,398,0.09258256632376827,0.2869518137520303,0.6204656199242015,0.7845154304277207,0.21548456957227938
3981,686,488,198,555,131,0.7113702623906706,0.2886297376093295,0.8090379008746356,0.19096209912536444,831,118,315,398,762,69,0.14199759326113118,0.37906137184115524,0.4789410348977136,0.9169675090252708,0.08303249097472924
3982,334,212,122,288,46,0.6347305389221557,0.3652694610778443,0.8622754491017964,0.1377245508982036,775,146,208,421,716,59,0.18838709677419355,0.26838709677419353,0.5432258064516129,0.9238709677419354,0.07612903225806451
3983,831,575,256,668,163,0.6919374247894103,0.30806257521058966,0.8038507821901324,0.19614921780986763,1070,103,201,766,843,227,0.09626168224299066,0.18785046728971963,0.7158878504672898,0.7878504672897196,0.21214953271028036
3984,557,351,206,439,118,0.63016157989228,0.36983842010771995,0.7881508078994613,0.2118491921005386,763,110,231,422,690,73,0.14416775884665792,0.30275229357798167,0.5530799475753604,0.9043250327653998,0.09567496723460026
3985,179,109,70,75,104,0.6089385474860335,0.39106145251396646,0.41899441340782123,0.5810055865921788,441,178,214,49,441,0,0.4036281179138322,0.4852607709750567,0.1111111111111111,1.0,0.0
3986,1166,878,288,911,255,0.7530017152658662,0.2469982847341338,0.7813036020583191,0.21869639794168097,1155,102,227,826,877,278,0.08831168831168831,0.19653679653679654,0.7151515151515152,0.7593073593073593,0.24069264069264068
3987,552,339,213,435,117,0.6141304347826086,0.3858695652173913,0.7880434782608695,0.21195652173913043,778,117,237,424,703,75,0.15038560411311053,0.3046272493573265,0.5449871465295629,0.903598971722365,0.09640102827763496
3988,1293,998,295,1084,209,0.7718484145398299,0.22815158546017014,0.8383604021655066,0.16163959783449341,1173,102,231,840,895,278,0.08695652173913043,0.1969309462915601,0.7161125319693095,0.763000852514919,0.236999147485081
3989,1333,1036,297,1095,238,0.7771942985746436,0.22280570142535633,0.8214553638409603,0.17854463615903976,1169,197,403,569,1022,147,0.16852010265183917,0.34473909324208724,0.48674080410607357,0.874251497005988,0.12574850299401197
3990,835,625,210,744,91,0.7485029940119761,0.25149700598802394,0.8910179640718563,0.1089820359281437,966,142,238,586,766,200,0.14699792960662525,0.2463768115942029,0.6066252587991718,0.7929606625258799,0.2070393374741201
3991,459,284,175,380,79,0.6187363834422658,0.3812636165577342,0.8278867102396514,0.1721132897603486,862,118,215,529,788,74,0.1368909512761021,0.2494199535962877,0.6136890951276102,0.91415313225058,0.08584686774941995
3992,414,233,181,340,74,0.5628019323671497,0.43719806763285024,0.821256038647343,0.178743961352657,623,98,164,361,556,67,0.15730337078651685,0.26324237560192615,0.579454253611557,0.8924558587479936,0.10754414125200643
3993,357,236,121,304,53,0.6610644257703081,0.3389355742296919,0.8515406162464986,0.1484593837535014,865,144,241,480,740,125,0.16647398843930636,0.2786127167630058,0.5549132947976878,0.8554913294797688,0.14450867052023122
3994,862,620,242,699,163,0.7192575406032483,0.28074245939675174,0.8109048723897911,0.18909512761020883,1222,262,404,556,1086,136,0.2144026186579378,0.33060556464811786,0.45499181669394434,0.8887070376432079,0.11129296235679215
3995,728,521,207,600,128,0.7156593406593407,0.28434065934065933,0.8241758241758241,0.17582417582417584,1235,282,416,537,1107,128,0.22834008097165992,0.3368421052631579,0.4348178137651822,0.8963562753036437,0.10364372469635627
3996,1510,1262,248,1293,217,0.8357615894039735,0.16423841059602648,0.8562913907284768,0.14370860927152318,1159,169,315,675,935,224,0.1458153580672994,0.271786022433132,0.5823986194995686,0.8067299396031061,0.19327006039689387
3997,1169,879,290,911,258,0.7519247219846023,0.24807527801539778,0.7792985457656116,0.22070145423438836,1169,102,235,832,891,278,0.0872540633019675,0.20102651839178784,0.7117194183062446,0.7621899059024807,0.23781009409751924
3998,1295,998,297,1086,209,0.7706563706563706,0.22934362934362934,0.8386100386100386,0.1613899613899614,1176,102,231,843,898,278,0.08673469387755102,0.19642857142857142,0.7168367346938775,0.7636054421768708,0.23639455782312926
3999,341,212,129,298,43,0.6217008797653959,0.3782991202346041,0.873900293255132,0.12609970674486803,865,128,235,502,743,122,0.14797687861271677,0.27167630057803466,0.5803468208092486,0.8589595375722543,0.14104046242774568
4000,1716,1387,329,1442,274,0.8082750582750583,0.19172494172494173,0.8403263403263403,0.15967365967365968,1265,257,445,563,1125,140,0.20316205533596837,0.35177865612648224,0.4450592885375494,0.8893280632411067,0.11067193675889328
4001,464,284,180,382,82,0.6120689655172413,0.3879310344827586,0.8232758620689655,0.17672413793103448,816,112,219,485,743,73,0.13725490196078433,0.26838235294117646,0.5943627450980392,0.9105392156862745,0.08946078431372549
4002,805,559,246,657,148,0.6944099378881987,0.30559006211180123,0.8161490683229814,0.18385093167701863,1080,99,214,767,853,227,0.09166666666666666,0.19814814814814816,0.7101851851851851,0.7898148148148149,0.2101851851851852
4003,592,403,189,479,113,0.6807432432432432,0.31925675675675674,0.8091216216216216,0.19087837837837837,1106,290,269,547,1042,64,0.26220614828209765,0.24321880650994576,0.4945750452079566,0.9421338155515371,0.05786618444846293
4004,1291,1079,212,1130,161,0.8357862122385747,0.16421378776142526,0.8752904725019365,0.12470952749806352,1055,155,268,632,834,221,0.14691943127962084,0.25402843601895736,0.5990521327014218,0.790521327014218,0.209478672985782
4005,632,429,203,508,124,0.6787974683544303,0.3212025316455696,0.8037974683544303,0.1962025316455696,1369,300,360,709,1145,224,0.2191380569758948,0.26296566837107377,0.5178962746530315,0.8363769174579986,0.16362308254200147
4006,1162,880,282,904,258,0.7573149741824441,0.24268502581755594,0.7779690189328744,0.22203098106712565,1156,102,230,824,878,278,0.08823529411764706,0.19896193771626297,0.71280276816609,0.759515570934256,0.24048442906574394
4007,3227,2783,444,2619,608,0.8624109079640533,0.1375890920359467,0.8115897118066315,0.18841028819336844,1841,169,349,1323,1384,457,0.09179793590439979,0.18957088538837588,0.7186311787072244,0.7517653449212385,0.24823465507876155
4008,558,380,178,465,93,0.6810035842293907,0.31899641577060933,0.8333333333333334,0.16666666666666666,1071,212,299,560,941,130,0.19794584500466852,0.2791783380018674,0.5228758169934641,0.8786181139122315,0.12138188608776844
4009,374,188,186,288,86,0.5026737967914439,0.49732620320855614,0.7700534759358288,0.22994652406417113,599,92,165,342,532,67,0.15358931552587646,0.27545909849749584,0.5709515859766278,0.8881469115191987,0.11185308848080133
4010,336,223,113,283,53,0.6636904761904762,0.33630952380952384,0.8422619047619048,0.15773809523809523,590,157,167,266,581,9,0.26610169491525426,0.2830508474576271,0.45084745762711864,0.9847457627118644,0.015254237288135594
4011,1295,998,297,1086,209,0.7706563706563706,0.22934362934362934,0.8386100386100386,0.1613899613899614,1180,102,235,843,902,278,0.08644067796610169,0.19915254237288135,0.714406779661017,0.764406779661017,0.23559322033898306
4012,531,345,186,440,91,0.6497175141242938,0.3502824858757062,0.8286252354048964,0.1713747645951036,821,95,209,517,748,73,0.11571254567600488,0.2545676004872107,0.6297198538367844,0.9110840438489647,0.08891595615103533
4013,6561,5683,878,5636,925,0.8661789361377839,0.13382106386221612,0.8590153939948179,0.14098460600518214,2396,235,588,1573,1900,496,0.09808013355592654,0.24540901502504173,0.6565108514190318,0.7929883138564274,0.20701168614357263
4014,1252,1031,221,1095,157,0.8234824281150159,0.17651757188498401,0.8746006389776357,0.1253993610223642,1084,149,302,633,863,221,0.13745387453874539,0.2785977859778598,0.5839483394833949,0.7961254612546126,0.20387453874538744
4015,413,237,176,339,74,0.5738498789346247,0.4261501210653753,0.8208232445520581,0.1791767554479419,886,225,211,450,826,60,0.25395033860045146,0.2381489841986456,0.5079006772009029,0.9322799097065463,0.06772009029345373
4016,1293,998,295,1084,209,0.7718484145398299,0.22815158546017014,0.8383604021655066,0.16163959783449341,1173,102,231,840,895,278,0.08695652173913043,0.1969309462915601,0.7161125319693095,0.763000852514919,0.236999147485081
4017,1285,992,293,1076,209,0.7719844357976654,0.22801556420233463,0.8373540856031129,0.16264591439688716,1163,102,225,836,885,278,0.08770421324161651,0.1934651762682717,0.7188306104901118,0.7609630266552021,0.23903697334479793
4018,77,23,54,27,50,0.2987012987012987,0.7012987012987013,0.35064935064935066,0.6493506493506493,101,0,32,69,101,0,0.0,0.31683168316831684,0.6831683168316832,1.0,0.0
4019,191,15,176,148,43,0.07853403141361257,0.9214659685863874,0.774869109947644,0.225130890052356,135,0,25,110,132,3,0.0,0.18518518518518517,0.8148148148148148,0.9777777777777777,0.022222222222222223
4020,115,19,96,73,42,0.16521739130434782,0.8347826086956521,0.6347826086956522,0.3652173913043478,110,0,0,110,107,3,0.0,0.0,1.0,0.9727272727272728,0.02727272727272727
4021,94,18,76,58,36,0.19148936170212766,0.8085106382978723,0.6170212765957447,0.3829787234042553,117,0,0,117,113,4,0.0,0.0,1.0,0.9658119658119658,0.03418803418803419
4022,92,8,84,69,23,0.08695652173913043,0.9130434782608695,0.75,0.25,88,0,1,87,84,4,0.0,0.011363636363636364,0.9886363636363636,0.9545454545454546,0.045454545454545456
4023,121,10,111,84,37,0.08264462809917356,0.9173553719008265,0.6942148760330579,0.30578512396694213,110,0,2,108,106,4,0.0,0.01818181818181818,0.9818181818181818,0.9636363636363636,0.03636363636363636
4024,195,17,178,153,42,0.08717948717948718,0.9128205128205128,0.7846153846153846,0.2153846153846154,149,0,27,122,147,2,0.0,0.18120805369127516,0.8187919463087249,0.9865771812080537,0.013422818791946308
4025,62,14,48,28,34,0.22580645161290322,0.7741935483870968,0.45161290322580644,0.5483870967741935,139,0,0,139,136,3,0.0,0.0,1.0,0.9784172661870504,0.02158273381294964
4026,111,20,91,56,55,0.18018018018018017,0.8198198198198198,0.5045045045045045,0.4954954954954955,178,0,54,124,175,3,0.0,0.30337078651685395,0.6966292134831461,0.9831460674157303,0.016853932584269662
4027,128,18,110,77,51,0.140625,0.859375,0.6015625,0.3984375,106,0,1,105,103,3,0.0,0.009433962264150943,0.9905660377358491,0.9716981132075472,0.02830188679245283
4028,213,12,201,171,42,0.056338028169014086,0.9436619718309859,0.8028169014084507,0.19718309859154928,139,0,27,112,136,3,0.0,0.19424460431654678,0.8057553956834532,0.9784172661870504,0.02158273381294964
4029,42,8,34,19,23,0.19047619047619047,0.8095238095238095,0.4523809523809524,0.5476190476190477,82,0,32,50,82,0,0.0,0.3902439024390244,0.6097560975609756,1.0,0.0
4030,194,15,179,156,38,0.07731958762886598,0.9226804123711341,0.8041237113402062,0.1958762886597938,139,0,25,114,136,3,0.0,0.17985611510791366,0.8201438848920863,0.9784172661870504,0.02158273381294964
4031,59,11,48,27,32,0.1864406779661017,0.8135593220338984,0.4576271186440678,0.5423728813559322,139,0,0,139,136,3,0.0,0.0,1.0,0.9784172661870504,0.02158273381294964
4032,142,126,16,139,3,0.8873239436619719,0.11267605633802817,0.9788732394366197,0.02112676056338028,320,0,32,288,86,234,0.0,0.1,0.9,0.26875,0.73125
4033,92,16,76,54,38,0.17391304347826086,0.8260869565217391,0.5869565217391305,0.41304347826086957,111,0,0,111,108,3,0.0,0.0,1.0,0.972972972972973,0.02702702702702703
4034,38,5,33,30,8,0.13157894736842105,0.868421052631579,0.7894736842105263,0.21052631578947367,97,0,22,75,94,3,0.0,0.2268041237113402,0.7731958762886598,0.9690721649484536,0.030927835051546393
4035,197,15,182,154,43,0.07614213197969544,0.9238578680203046,0.7817258883248731,0.2182741116751269,139,0,27,112,136,3,0.0,0.19424460431654678,0.8057553956834532,0.9784172661870504,0.02158273381294964
4036,194,14,180,154,40,0.07216494845360824,0.9278350515463918,0.7938144329896907,0.20618556701030927,135,0,27,108,132,3,0.0,0.2,0.8,0.9777777777777777,0.022222222222222223
4037,124,15,109,84,40,0.12096774193548387,0.8790322580645161,0.6774193548387096,0.3225806451612903,117,0,1,116,113,4,0.0,0.008547008547008548,0.9914529914529915,0.9658119658119658,0.03418803418803419
4038,211,14,197,172,39,0.06635071090047394,0.933649289099526,0.8151658767772512,0.1848341232227488,146,0,25,121,144,2,0.0,0.17123287671232876,0.8287671232876712,0.9863013698630136,0.0136986301369863
4039,107,4,103,84,23,0.037383177570093455,0.9626168224299065,0.7850467289719626,0.21495327102803738,87,0,11,76,85,2,0.0,0.12643678160919541,0.8735632183908046,0.9770114942528736,0.022988505747126436
4040,120,6,114,99,21,0.05,0.95,0.825,0.175,86,0,5,81,84,2,0.0,0.05813953488372093,0.9418604651162791,0.9767441860465116,0.023255813953488372
4041,90,14,76,56,34,0.15555555555555556,0.8444444444444444,0.6222222222222222,0.37777777777777777,111,0,0,111,107,4,0.0,0.0,1.0,0.963963963963964,0.036036036036036036
4042,121,15,106,79,42,0.12396694214876033,0.8760330578512396,0.6528925619834711,0.34710743801652894,120,0,1,119,117,3,0.0,0.008333333333333333,0.9916666666666667,0.975,0.025
4043,124,9,115,94,30,0.07258064516129033,0.9274193548387096,0.7580645161290323,0.24193548387096775,98,0,18,80,96,2,0.0,0.1836734693877551,0.8163265306122449,0.9795918367346939,0.02040816326530612
4044,190,12,178,155,35,0.06315789473684211,0.9368421052631579,0.8157894736842105,0.18421052631578946,131,0,27,104,129,2,0.0,0.20610687022900764,0.7938931297709924,0.9847328244274809,0.015267175572519083
4045,125,15,110,84,41,0.12,0.88,0.672,0.328,113,0,1,112,109,4,0.0,0.008849557522123894,0.9911504424778761,0.9646017699115044,0.035398230088495575
4046,62,14,48,26,36,0.22580645161290322,0.7741935483870968,0.41935483870967744,0.5806451612903226,151,0,0,151,148,3,0.0,0.0,1.0,0.9801324503311258,0.019867549668874173
4047,46,12,34,21,25,0.2608695652173913,0.7391304347826086,0.45652173913043476,0.5434782608695652,93,0,32,61,93,0,0.0,0.34408602150537637,0.6559139784946236,1.0,0.0
4048,123,12,111,76,47,0.0975609756097561,0.9024390243902439,0.6178861788617886,0.3821138211382114,106,0,2,104,102,4,0.0,0.018867924528301886,0.9811320754716981,0.9622641509433962,0.03773584905660377
4049,73,9,64,33,40,0.1232876712328767,0.8767123287671232,0.4520547945205479,0.547945205479452,93,0,28,65,93,0,0.0,0.3010752688172043,0.6989247311827957,1.0,0.0
4050,60,13,47,27,33,0.21666666666666667,0.7833333333333333,0.45,0.55,146,0,0,146,143,3,0.0,0.0,1.0,0.9794520547945206,0.02054794520547945
4051,68,14,54,25,43,0.20588235294117646,0.7941176470588235,0.36764705882352944,0.6323529411764706,105,0,32,73,105,0,0.0,0.3047619047619048,0.6952380952380952,1.0,0.0
4052,59,12,47,27,32,0.2033898305084746,0.7966101694915254,0.4576271186440678,0.5423728813559322,137,0,0,137,135,2,0.0,0.0,1.0,0.9854014598540146,0.014598540145985401
4053,115,17,98,70,45,0.14782608695652175,0.8521739130434782,0.6086956521739131,0.391304347826087,122,0,0,122,118,4,0.0,0.0,1.0,0.9672131147540983,0.03278688524590164
4054,172,24,148,121,51,0.13953488372093023,0.8604651162790697,0.7034883720930233,0.29651162790697677,156,1,24,131,155,1,0.00641025641025641,0.15384615384615385,0.8397435897435898,0.9935897435897436,0.00641025641025641
4055,201,20,181,158,43,0.09950248756218906,0.900497512437811,0.7860696517412935,0.21393034825870647,147,0,29,118,144,3,0.0,0.19727891156462585,0.8027210884353742,0.9795918367346939,0.02040816326530612
4056,121,11,110,78,43,0.09090909090909091,0.9090909090909091,0.6446280991735537,0.35537190082644626,117,0,1,116,113,4,0.0,0.008547008547008548,0.9914529914529915,0.9658119658119658,0.03418803418803419
4057,211,15,196,167,44,0.07109004739336493,0.9289099526066351,0.7914691943127962,0.20853080568720378,140,0,24,116,137,3,0.0,0.17142857142857143,0.8285714285714286,0.9785714285714285,0.02142857142857143
4058,127,16,111,82,45,0.12598425196850394,0.8740157480314961,0.6456692913385826,0.3543307086614173,98,0,2,96,94,4,0.0,0.02040816326530612,0.9795918367346939,0.9591836734693877,0.04081632653061224
4059,128,17,111,80,48,0.1328125,0.8671875,0.625,0.375,116,0,2,114,112,4,0.0,0.017241379310344827,0.9827586206896551,0.9655172413793104,0.034482758620689655
4060,66,12,54,30,36,0.18181818181818182,0.8181818181818182,0.45454545454545453,0.5454545454545454,103,0,30,73,103,0,0.0,0.2912621359223301,0.7087378640776699,1.0,0.0
4061,120,10,110,76,44,0.08333333333333333,0.9166666666666666,0.6333333333333333,0.36666666666666664,109,0,2,107,106,3,0.0,0.01834862385321101,0.981651376146789,0.9724770642201835,0.027522935779816515
4062,59,12,47,25,34,0.2033898305084746,0.7966101694915254,0.423728813559322,0.576271186440678,139,0,0,139,136,3,0.0,0.0,1.0,0.9784172661870504,0.02158273381294964
4063,203,18,185,159,44,0.08866995073891626,0.9113300492610837,0.7832512315270936,0.21674876847290642,130,0,25,105,128,2,0.0,0.19230769230769232,0.8076923076923077,0.9846153846153847,0.015384615384615385
4064,43,9,34,15,28,0.20930232558139536,0.7906976744186046,0.3488372093023256,0.6511627906976745,91,0,30,61,91,0,0.0,0.32967032967032966,0.6703296703296703,1.0,0.0
4065,121,17,104,79,42,0.14049586776859505,0.859504132231405,0.6528925619834711,0.34710743801652894,120,0,0,120,116,4,0.0,0.0,1.0,0.9666666666666667,0.03333333333333333
4066,96,20,76,52,44,0.20833333333333334,0.7916666666666666,0.5416666666666666,0.4583333333333333,108,0,0,108,104,4,0.0,0.0,1.0,0.9629629629629629,0.037037037037037035
4067,40,7,33,30,10,0.175,0.825,0.75,0.25,86,0,13,73,83,3,0.0,0.1511627906976744,0.8488372093023255,0.9651162790697675,0.03488372093023256
4068,121,11,110,84,37,0.09090909090909091,0.9090909090909091,0.6942148760330579,0.30578512396694213,101,0,1,100,97,4,0.0,0.009900990099009901,0.9900990099009901,0.9603960396039604,0.039603960396039604
4069,122,13,109,84,38,0.10655737704918032,0.8934426229508197,0.6885245901639344,0.3114754098360656,108,0,1,107,104,4,0.0,0.009259259259259259,0.9907407407407407,0.9629629629629629,0.037037037037037035
4070,123,14,109,77,46,0.11382113821138211,0.8861788617886179,0.6260162601626016,0.37398373983739835,106,0,1,105,102,4,0.0,0.009433962264150943,0.9905660377358491,0.9622641509433962,0.03773584905660377
4071,73,4,69,52,21,0.0547945205479452,0.9452054794520548,0.7123287671232876,0.2876712328767123,83,0,1,82,79,4,0.0,0.012048192771084338,0.9879518072289156,0.9518072289156626,0.04819277108433735
4072,71,17,54,29,42,0.23943661971830985,0.7605633802816901,0.4084507042253521,0.5915492957746479,99,0,30,69,99,0,0.0,0.30303030303030304,0.696969696969697,1.0,0.0
4073,42,7,35,33,9,0.16666666666666666,0.8333333333333334,0.7857142857142857,0.21428571428571427,86,0,19,67,84,2,0.0,0.22093023255813954,0.7790697674418605,0.9767441860465116,0.023255813953488372
4074,126,15,111,82,44,0.11904761904761904,0.8809523809523809,0.6507936507936508,0.3492063492063492,104,0,2,102,100,4,0.0,0.019230769230769232,0.9807692307692307,0.9615384615384616,0.038461538461538464
4075,73,6,67,51,22,0.0821917808219178,0.9178082191780822,0.6986301369863014,0.3013698630136986,76,0,0,76,73,3,0.0,0.0,1.0,0.9605263157894737,0.039473684210526314
4076,198,18,180,155,43,0.09090909090909091,0.9090909090909091,0.7828282828282829,0.21717171717171718,137,0,27,110,134,3,0.0,0.19708029197080293,0.8029197080291971,0.9781021897810219,0.021897810218978103
4077,39,5,34,32,7,0.1282051282051282,0.8717948717948718,0.8205128205128205,0.1794871794871795,87,0,17,70,84,3,0.0,0.19540229885057472,0.8045977011494253,0.9655172413793104,0.034482758620689655
4078,198,15,183,153,45,0.07575757575757576,0.9242424242424242,0.7727272727272727,0.22727272727272727,139,0,25,114,137,2,0.0,0.17985611510791366,0.8201438848920863,0.9856115107913669,0.014388489208633094
4079,39,6,33,30,9,0.15384615384615385,0.8461538461538461,0.7692307692307693,0.23076923076923078,90,0,20,70,87,3,0.0,0.2222222222222222,0.7777777777777778,0.9666666666666667,0.03333333333333333
4080,94,18,76,58,36,0.19148936170212766,0.8085106382978723,0.6170212765957447,0.3829787234042553,112,0,0,112,109,3,0.0,0.0,1.0,0.9732142857142857,0.026785714285714284
4081,111,20,91,65,46,0.18018018018018017,0.8198198198198198,0.5855855855855856,0.4144144144144144,182,0,54,128,178,4,0.0,0.2967032967032967,0.7032967032967034,0.978021978021978,0.02197802197802198
4082,118,8,110,83,35,0.06779661016949153,0.9322033898305084,0.7033898305084746,0.2966101694915254,98,0,1,97,95,3,0.0,0.01020408163265306,0.9897959183673469,0.9693877551020408,0.030612244897959183
4083,140,10,130,101,39,0.07142857142857142,0.9285714285714286,0.7214285714285714,0.2785714285714286,134,0,25,109,133,1,0.0,0.1865671641791045,0.8134328358208955,0.9925373134328358,0.007462686567164179
4084,124,9,115,98,26,0.07258064516129033,0.9274193548387096,0.7903225806451613,0.20967741935483872,105,0,19,86,103,2,0.0,0.18095238095238095,0.819047619047619,0.9809523809523809,0.01904761904761905
4085,114,10,104,71,43,0.08771929824561403,0.9122807017543859,0.6228070175438597,0.37719298245614036,130,0,0,130,126,4,0.0,0.0,1.0,0.9692307692307692,0.03076923076923077
4086,193,13,180,153,40,0.06735751295336788,0.9326424870466321,0.7927461139896373,0.20725388601036268,149,0,25,124,147,2,0.0,0.16778523489932887,0.8322147651006712,0.9865771812080537,0.013422818791946308
4087,74,20,54,31,43,0.2702702702702703,0.7297297297297297,0.4189189189189189,0.581081081081081,102,0,30,72,102,0,0.0,0.29411764705882354,0.7058823529411765,1.0,0.0
4088,40,4,36,33,7,0.1,0.9,0.825,0.175,86,0,16,70,83,3,0.0,0.18604651162790697,0.813953488372093,0.9651162790697675,0.03488372093023256
4089,62,15,47,26,36,0.24193548387096775,0.7580645161290323,0.41935483870967744,0.5806451612903226,136,0,0,136,133,3,0.0,0.0,1.0,0.9779411764705882,0.022058823529411766
4090,132,21,111,79,53,0.1590909090909091,0.8409090909090909,0.5984848484848485,0.4015151515151515,110,0,2,108,106,4,0.0,0.01818181818181818,0.9818181818181818,0.9636363636363636,0.03636363636363636
4091,77,14,63,39,38,0.18181818181818182,0.8181818181818182,0.5064935064935064,0.4935064935064935,92,0,28,64,92,0,0.0,0.30434782608695654,0.6956521739130435,1.0,0.0
4092,173,25,148,114,59,0.14450867052023122,0.8554913294797688,0.6589595375722543,0.34104046242774566,142,0,24,118,141,1,0.0,0.16901408450704225,0.8309859154929577,0.9929577464788732,0.007042253521126761
4093,119,13,106,77,42,0.1092436974789916,0.8907563025210085,0.6470588235294118,0.35294117647058826,123,0,0,123,120,3,0.0,0.0,1.0,0.975609756097561,0.024390243902439025
4094,59,12,47,26,33,0.2033898305084746,0.7966101694915254,0.4406779661016949,0.559322033898305,137,0,0,137,134,3,0.0,0.0,1.0,0.9781021897810219,0.021897810218978103
4095,124,14,110,86,38,0.11290322580645161,0.8870967741935484,0.6935483870967742,0.3064516129032258,102,0,1,101,98,4,0.0,0.00980392156862745,0.9901960784313726,0.9607843137254902,0.0392156862745098
4096,124,14,110,81,43,0.11290322580645161,0.8870967741935484,0.6532258064516129,0.3467741935483871,114,0,0,114,110,4,0.0,0.0,1.0,0.9649122807017544,0.03508771929824561
4097,0,0,0,0,0,0.0,0.0,0.0,0.0,0,0,0,0,0,0,0.0,0.0,0.0,0.0,0.0
4098,123,14,109,84,39,0.11382113821138211,0.8861788617886179,0.6829268292682927,0.3170731707317073,101,0,1,100,97,4,0.0,0.009900990099009901,0.9900990099009901,0.9603960396039604,0.039603960396039604
4099,92,9,83,65,27,0.09782608695652174,0.9021739130434783,0.7065217391304348,0.29347826086956524,83,0,1,82,79,4,0.0,0.012048192771084338,0.9879518072289156,0.9518072289156626,0.04819277108433735
4100,162,14,148,111,51,0.08641975308641975,0.9135802469135802,0.6851851851851852,0.3148148148148148,136,0,24,112,135,1,0.0,0.17647058823529413,0.8235294117647058,0.9926470588235294,0.007352941176470588
4101,114,14,100,76,38,0.12280701754385964,0.8771929824561403,0.6666666666666666,0.3333333333333333,125,0,0,125,123,2,0.0,0.0,1.0,0.984,0.016
4102,73,10,63,50,23,0.136986301369863,0.863013698630137,0.684931506849315,0.3150684931506849,77,0,0,77,73,4,0.0,0.0,1.0,0.948051948051948,0.05194805194805195
4103,108,17,91,57,51,0.1574074074074074,0.8425925925925926,0.5277777777777778,0.4722222222222222,185,0,54,131,183,2,0.0,0.2918918918918919,0.7081081081081081,0.9891891891891892,0.010810810810810811
4104,123,12,111,86,37,0.0975609756097561,0.9024390243902439,0.6991869918699187,0.3008130081300813,108,0,2,106,104,4,0.0,0.018518518518518517,0.9814814814814815,0.9629629629629629,0.037037037037037035
4105,102,11,91,65,37,0.10784313725490197,0.8921568627450981,0.6372549019607843,0.3627450980392157,175,0,54,121,171,4,0.0,0.30857142857142855,0.6914285714285714,0.9771428571428571,0.022857142857142857
4106,125,15,110,83,42,0.12,0.88,0.664,0.336,108,0,2,106,104,4,0.0,0.018518518518518517,0.9814814814814815,0.9629629629629629,0.037037037037037035
4107,128,17,111,83,45,0.1328125,0.8671875,0.6484375,0.3515625,110,0,2,108,107,3,0.0,0.01818181818181818,0.9818181818181818,0.9727272727272728,0.02727272727272727
4108,71,17,54,25,46,0.23943661971830985,0.7605633802816901,0.352112676056338,0.647887323943662,100,0,30,70,100,0,0.0,0.3,0.7,1.0,0.0
4109,124,13,111,85,39,0.10483870967741936,0.8951612903225806,0.6854838709677419,0.31451612903225806,122,0,2,120,118,4,0.0,0.01639344262295082,0.9836065573770492,0.9672131147540983,0.03278688524590164
4110,147,14,133,100,47,0.09523809523809523,0.9047619047619048,0.6802721088435374,0.3197278911564626,138,0,24,114,137,1,0.0,0.17391304347826086,0.8260869565217391,0.9927536231884058,0.007246376811594203
4111,139,9,130,97,42,0.06474820143884892,0.935251798561151,0.697841726618705,0.302158273381295,136,0,25,111,135,1,0.0,0.18382352941176472,0.8161764705882353,0.9926470588235294,0.007352941176470588
4112,55,8,47,26,29,0.14545454545454545,0.8545454545454545,0.4727272727272727,0.5272727272727272,144,0,0,144,141,3,0.0,0.0,1.0,0.9791666666666666,0.020833333333333332
4113,81,16,65,39,42,0.19753086419753085,0.8024691358024691,0.48148148148148145,0.5185185185185185,101,0,32,69,101,0,0.0,0.31683168316831684,0.6831683168316832,1.0,0.0
4114,119,9,110,83,36,0.07563025210084033,0.9243697478991597,0.6974789915966386,0.3025210084033613,120,0,1,119,116,4,0.0,0.008333333333333333,0.9916666666666667,0.9666666666666667,0.03333333333333333
4115,118,9,109,75,43,0.07627118644067797,0.923728813559322,0.635593220338983,0.3644067796610169,104,0,1,103,100,4,0.0,0.009615384615384616,0.9903846153846154,0.9615384615384616,0.038461538461538464
4116,57,10,47,26,31,0.17543859649122806,0.8245614035087719,0.45614035087719296,0.543859649122807,132,0,0,132,129,3,0.0,0.0,1.0,0.9772727272727273,0.022727272727272728
4117,130,11,119,101,29,0.08461538461538462,0.9153846153846154,0.7769230769230769,0.2230769230769231,107,0,15,92,105,2,0.0,0.14018691588785046,0.8598130841121495,0.9813084112149533,0.018691588785046728
4118,41,7,34,32,9,0.17073170731707318,0.8292682926829268,0.7804878048780488,0.21951219512195122,87,0,14,73,84,3,0.0,0.16091954022988506,0.8390804597701149,0.9655172413793104,0.034482758620689655
4119,72,18,54,31,41,0.25,0.75,0.4305555555555556,0.5694444444444444,111,0,30,81,111,0,0.0,0.2702702702702703,0.7297297297297297,1.0,0.0
4120,93,17,76,52,41,0.1827956989247312,0.8172043010752689,0.5591397849462365,0.44086021505376344,109,0,0,109,105,4,0.0,0.0,1.0,0.963302752293578,0.03669724770642202
4121,84,8,76,53,31,0.09523809523809523,0.9047619047619048,0.6309523809523809,0.36904761904761907,109,0,0,109,105,4,0.0,0.0,1.0,0.963302752293578,0.03669724770642202
4122,125,10,115,89,36,0.08,0.92,0.712,0.288,101,0,17,84,99,2,0.0,0.16831683168316833,0.8316831683168316,0.9801980198019802,0.019801980198019802
4123,89,7,82,66,23,0.07865168539325842,0.9213483146067416,0.7415730337078652,0.25842696629213485,80,0,1,79,77,3,0.0,0.0125,0.9875,0.9625,0.0375
4124,115,6,109,76,39,0.05217391304347826,0.9478260869565217,0.6608695652173913,0.3391304347826087,109,0,1,108,105,4,0.0,0.009174311926605505,0.9908256880733946,0.963302752293578,0.03669724770642202
4125,127,16,111,77,50,0.12598425196850394,0.8740157480314961,0.6062992125984252,0.3937007874015748,108,0,2,106,104,4,0.0,0.018518518518518517,0.9814814814814815,0.9629629629629629,0.037037037037037035
4126,115,24,91,53,62,0.20869565217391303,0.7913043478260869,0.4608695652173913,0.5391304347826087,180,0,54,126,178,2,0.0,0.3,0.7,0.9888888888888889,0.011111111111111112
4127,122,12,110,81,41,0.09836065573770492,0.9016393442622951,0.6639344262295082,0.3360655737704918,102,0,1,101,98,4,0.0,0.00980392156862745,0.9901960784313726,0.9607843137254902,0.0392156862745098
4128,126,16,110,85,41,0.12698412698412698,0.873015873015873,0.6746031746031746,0.3253968253968254,109,0,1,108,105,4,0.0,0.009174311926605505,0.9908256880733946,0.963302752293578,0.03669724770642202
4129,122,12,110,78,44,0.09836065573770492,0.9016393442622951,0.639344262295082,0.36065573770491804,108,0,1,107,104,4,0.0,0.009259259259259259,0.9907407407407407,0.9629629629629629,0.037037037037037035
4130,92,16,76,56,36,0.17391304347826086,0.8260869565217391,0.6086956521739131,0.391304347826087,112,0,0,112,109,3,0.0,0.0,1.0,0.9732142857142857,0.026785714285714284
4131,199,19,180,155,44,0.09547738693467336,0.9045226130653267,0.7788944723618091,0.22110552763819097,141,0,27,114,138,3,0.0,0.19148936170212766,0.8085106382978723,0.9787234042553191,0.02127659574468085
4132,128,18,110,83,45,0.140625,0.859375,0.6484375,0.3515625,94,0,2,92,90,4,0.0,0.02127659574468085,0.9787234042553191,0.9574468085106383,0.0425531914893617
4133,199,18,181,153,46,0.09045226130653267,0.9095477386934674,0.7688442211055276,0.23115577889447236,130,0,26,104,127,3,0.0,0.2,0.8,0.9769230769230769,0.023076923076923078
4134,122,12,110,76,46,0.09836065573770492,0.9016393442622951,0.6229508196721312,0.3770491803278688,107,0,1,106,103,4,0.0,0.009345794392523364,0.9906542056074766,0.9626168224299065,0.037383177570093455
4135,82,16,66,40,42,0.1951219512195122,0.8048780487804879,0.4878048780487805,0.5121951219512195,100,0,28,72,100,0,0.0,0.28,0.72,1.0,0.0
4136,112,4,108,93,19,0.03571428571428571,0.9642857142857143,0.8303571428571429,0.16964285714285715,81,0,8,73,78,3,0.0,0.09876543209876543,0.9012345679012346,0.9629629629629629,0.037037037037037035
4137,114,3,111,92,22,0.02631578947368421,0.9736842105263158,0.8070175438596491,0.19298245614035087,78,0,7,71,76,2,0.0,0.08974358974358974,0.9102564102564102,0.9743589743589743,0.02564102564102564
4138,87,11,76,60,27,0.12643678160919541,0.8735632183908046,0.6896551724137931,0.3103448275862069,116,0,0,116,113,3,0.0,0.0,1.0,0.9741379310344828,0.02586206896551724
4139,114,8,106,85,29,0.07017543859649122,0.9298245614035088,0.7456140350877193,0.2543859649122807,82,0,10,72,80,2,0.0,0.12195121951219512,0.8780487804878049,0.975609756097561,0.024390243902439025
4140,58,10,48,25,33,0.1724137931034483,0.8275862068965517,0.43103448275862066,0.5689655172413793,145,0,0,145,142,3,0.0,0.0,1.0,0.9793103448275862,0.020689655172413793
4141,201,23,178,152,49,0.11442786069651742,0.8855721393034826,0.7562189054726368,0.24378109452736318,132,0,26,106,129,3,0.0,0.19696969696969696,0.803030303030303,0.9772727272727273,0.022727272727272728
4142,109,18,91,50,59,0.1651376146788991,0.8348623853211009,0.45871559633027525,0.5412844036697247,190,0,54,136,186,4,0.0,0.28421052631578947,0.7157894736842105,0.9789473684210527,0.021052631578947368
4143,123,12,111,84,39,0.0975609756097561,0.9024390243902439,0.6829268292682927,0.3170731707317073,114,0,2,112,110,4,0.0,0.017543859649122806,0.9824561403508771,0.9649122807017544,0.03508771929824561
4144,127,17,110,75,52,0.13385826771653545,0.8661417322834646,0.5905511811023622,0.4094488188976378,108,0,1,107,104,4,0.0,0.009259259259259259,0.9907407407407407,0.9629629629629629,0.037037037037037035
4145,162,14,148,118,44,0.08641975308641975,0.9135802469135802,0.7283950617283951,0.2716049382716049,140,1,24,115,139,1,0.007142857142857143,0.17142857142857143,0.8214285714285714,0.9928571428571429,0.007142857142857143
4146,93,17,76,55,38,0.1827956989247312,0.8172043010752689,0.5913978494623656,0.40860215053763443,120,0,0,120,117,3,0.0,0.0,1.0,0.975,0.025
4147,74,6,68,56,18,0.08108108108108109,0.918918918918919,0.7567567567567568,0.24324324324324326,78,0,0,78,74,4,0.0,0.0,1.0,0.9487179487179487,0.05128205128205128
4148,119,9,110,78,41,0.07563025210084033,0.9243697478991597,0.6554621848739496,0.3445378151260504,119,0,1,118,115,4,0.0,0.008403361344537815,0.9915966386554622,0.9663865546218487,0.03361344537815126
4149,120,7,113,94,26,0.058333333333333334,0.9416666666666667,0.7833333333333333,0.21666666666666667,94,0,15,79,92,2,0.0,0.1595744680851064,0.8404255319148937,0.9787234042553191,0.02127659574468085
4150,195,15,180,155,40,0.07692307692307693,0.9230769230769231,0.7948717948717948,0.20512820512820512,148,0,27,121,145,3,0.0,0.18243243243243243,0.8175675675675675,0.9797297297297297,0.02027027027027027
4151,163,21,142,113,50,0.12883435582822086,0.8711656441717791,0.6932515337423313,0.3067484662576687,142,0,24,118,141,1,0.0,0.16901408450704225,0.8309859154929577,0.9929577464788732,0.007042253521126761
4152,60,13,47,28,32,0.21666666666666667,0.7833333333333333,0.4666666666666667,0.5333333333333333,146,0,0,146,143,3,0.0,0.0,1.0,0.9794520547945206,0.02054794520547945
4153,116,7,109,95,21,0.0603448275862069,0.9396551724137931,0.8189655172413793,0.1810344827586207,81,0,7,74,79,2,0.0,0.08641975308641975,0.9135802469135802,0.9753086419753086,0.024691358024691357
4154,123,13,110,88,35,0.10569105691056911,0.8943089430894309,0.7154471544715447,0.2845528455284553,113,0,1,112,109,4,0.0,0.008849557522123894,0.9911504424778761,0.9646017699115044,0.035398230088495575
4155,193,13,180,151,42,0.06735751295336788,0.9326424870466321,0.7823834196891192,0.21761658031088082,137,0,24,113,134,3,0.0,0.17518248175182483,0.8248175182481752,0.9781021897810219,0.021897810218978103
4156,119,19,100,73,46,0.15966386554621848,0.8403361344537815,0.6134453781512605,0.3865546218487395,124,0,0,124,121,3,0.0,0.0,1.0,0.9758064516129032,0.024193548387096774
4157,107,5,102,89,18,0.04672897196261682,0.9532710280373832,0.8317757009345794,0.16822429906542055,92,0,16,76,90,2,0.0,0.17391304347826086,0.8260869565217391,0.9782608695652174,0.021739130434782608
4158,122,12,110,81,41,0.09836065573770492,0.9016393442622951,0.6639344262295082,0.3360655737704918,104,0,1,103,101,3,0.0,0.009615384615384616,0.9903846153846154,0.9711538461538461,0.028846153846153848
4159,120,16,104,78,42,0.13333333333333333,0.8666666666666667,0.65,0.35,126,0,0,126,122,4,0.0,0.0,1.0,0.9682539682539683,0.031746031746031744
4160,64,17,47,27,37,0.265625,0.734375,0.421875,0.578125,146,0,0,146,143,3,0.0,0.0,1.0,0.9794520547945206,0.02054794520547945
4161,200,19,181,153,47,0.095,0.905,0.765,0.235,140,0,26,114,137,3,0.0,0.18571428571428572,0.8142857142857143,0.9785714285714285,0.02142857142857143
4162,126,16,110,79,47,0.12698412698412698,0.873015873015873,0.626984126984127,0.373015873015873,107,0,1,106,103,4,0.0,0.009345794392523364,0.9906542056074766,0.9626168224299065,0.037383177570093455
4163,133,14,119,99,34,0.10526315789473684,0.8947368421052632,0.7443609022556391,0.2556390977443609,89,0,13,76,87,2,0.0,0.14606741573033707,0.8539325842696629,0.9775280898876404,0.02247191011235955
4164,106,15,91,60,46,0.14150943396226415,0.8584905660377359,0.5660377358490566,0.4339622641509434,197,1,54,142,193,4,0.005076142131979695,0.27411167512690354,0.7208121827411168,0.9796954314720813,0.02030456852791878
4165,87,21,66,39,48,0.2413793103448276,0.7586206896551724,0.4482758620689655,0.5517241379310345,96,0,29,67,96,0,0.0,0.3020833333333333,0.6979166666666666,1.0,0.0
4166,55,8,47,26,29,0.14545454545454545,0.8545454545454545,0.4727272727272727,0.5272727272727272,137,0,0,137,134,3,0.0,0.0,1.0,0.9781021897810219,0.021897810218978103
4167,127,17,110,89,38,0.13385826771653545,0.8661417322834646,0.7007874015748031,0.2992125984251969,101,0,1,100,98,3,0.0,0.009900990099009901,0.9900990099009901,0.9702970297029703,0.0297029702970297
4168,118,8,110,80,38,0.06779661016949153,0.9322033898305084,0.6779661016949152,0.3220338983050847,105,0,1,104,101,4,0.0,0.009523809523809525,0.9904761904761905,0.9619047619047619,0.0380952380952381
4169,43,9,34,20,23,0.20930232558139536,0.7906976744186046,0.46511627906976744,0.5348837209302325,80,0,30,50,80,0,0.0,0.375,0.625,1.0,0.0
4170,59,11,48,28,31,0.1864406779661017,0.8135593220338984,0.4745762711864407,0.5254237288135594,133,0,0,133,130,3,0.0,0.0,1.0,0.9774436090225563,0.022556390977443608
4171,63,19,44,21,42,0.30158730158730157,0.6984126984126984,0.3333333333333333,0.6666666666666666,89,0,30,59,89,0,0.0,0.33707865168539325,0.6629213483146067,1.0,0.0
4172,150,18,132,109,41,0.12,0.88,0.7266666666666667,0.2733333333333333,124,0,24,100,123,1,0.0,0.1935483870967742,0.8064516129032258,0.9919354838709677,0.008064516129032258
4173,67,5,62,48,19,0.07462686567164178,0.9253731343283582,0.7164179104477612,0.2835820895522388,74,0,0,74,70,4,0.0,0.0,1.0,0.9459459459459459,0.05405405405405406
4174,114,12,102,77,37,0.10526315789473684,0.8947368421052632,0.6754385964912281,0.32456140350877194,129,0,0,129,126,3,0.0,0.0,1.0,0.9767441860465116,0.023255813953488372
4175,84,8,76,57,27,0.09523809523809523,0.9047619047619048,0.6785714285714286,0.32142857142857145,113,0,0,113,109,4,0.0,0.0,1.0,0.9646017699115044,0.035398230088495575
4176,95,11,84,69,26,0.11578947368421053,0.8842105263157894,0.7263157894736842,0.2736842105263158,83,0,1,82,79,4,0.0,0.012048192771084338,0.9879518072289156,0.9518072289156626,0.04819277108433735
4177,124,14,110,80,44,0.11290322580645161,0.8870967741935484,0.6451612903225806,0.3548387096774194,113,0,1,112,110,3,0.0,0.008849557522123894,0.9911504424778761,0.9734513274336283,0.02654867256637168
4178,122,12,110,80,42,0.09836065573770492,0.9016393442622951,0.6557377049180327,0.3442622950819672,110,0,1,109,107,3,0.0,0.00909090909090909,0.990909090909091,0.9727272727272728,0.02727272727272727
4179,199,18,181,156,43,0.09045226130653267,0.9095477386934674,0.7839195979899497,0.21608040201005024,144,0,26,118,141,3,0.0,0.18055555555555555,0.8194444444444444,0.9791666666666666,0.020833333333333332
4180,124,13,111,82,42,0.10483870967741936,0.8951612903225806,0.6612903225806451,0.3387096774193548,118,0,2,116,114,4,0.0,0.01694915254237288,0.9830508474576272,0.9661016949152542,0.03389830508474576
4181,83,17,66,42,41,0.20481927710843373,0.7951807228915663,0.5060240963855421,0.4939759036144578,100,0,30,70,100,0,0.0,0.3,0.7,1.0,0.0
4182,91,15,76,55,36,0.16483516483516483,0.8351648351648352,0.6043956043956044,0.3956043956043956,111,0,0,111,108,3,0.0,0.0,1.0,0.972972972972973,0.02702702702702703
4183,121,11,110,76,45,0.09090909090909091,0.9090909090909091,0.628099173553719,0.371900826446281,113,0,1,112,109,4,0.0,0.008849557522123894,0.9911504424778761,0.9646017699115044,0.035398230088495575
4184,59,12,47,28,31,0.2033898305084746,0.7966101694915254,0.4745762711864407,0.5254237288135594,134,0,0,134,131,3,0.0,0.0,1.0,0.9776119402985075,0.022388059701492536
4185,89,13,76,53,36,0.14606741573033707,0.8539325842696629,0.5955056179775281,0.4044943820224719,104,0,0,104,100,4,0.0,0.0,1.0,0.9615384615384616,0.038461538461538464
4186,59,12,47,25,34,0.2033898305084746,0.7966101694915254,0.423728813559322,0.576271186440678,139,0,0,139,136,3,0.0,0.0,1.0,0.9784172661870504,0.02158273381294964
4187,84,9,75,59,25,0.10714285714285714,0.8928571428571429,0.7023809523809523,0.2976190476190476,87,0,1,86,84,3,0.0,0.011494252873563218,0.9885057471264368,0.9655172413793104,0.034482758620689655
4188,119,9,110,80,39,0.07563025210084033,0.9243697478991597,0.6722689075630253,0.3277310924369748,110,0,2,108,107,3,0.0,0.01818181818181818,0.9818181818181818,0.9727272727272728,0.02727272727272727
4189,125,15,110,77,48,0.12,0.88,0.616,0.384,111,0,1,110,107,4,0.0,0.009009009009009009,0.990990990990991,0.963963963963964,0.036036036036036036
4190,129,9,120,98,31,0.06976744186046512,0.9302325581395349,0.7596899224806202,0.24031007751937986,102,0,14,88,100,2,0.0,0.13725490196078433,0.8627450980392157,0.9803921568627451,0.0196078431372549
4191,200,18,182,152,48,0.09,0.91,0.76,0.24,140,0,25,115,138,2,0.0,0.17857142857142858,0.8214285714285714,0.9857142857142858,0.014285714285714285
4192,119,21,98,69,50,0.17647058823529413,0.8235294117647058,0.5798319327731093,0.42016806722689076,111,0,0,111,108,3,0.0,0.0,1.0,0.972972972972973,0.02702702702702703
4193,59,12,47,26,33,0.2033898305084746,0.7966101694915254,0.4406779661016949,0.559322033898305,137,0,0,137,134,3,0.0,0.0,1.0,0.9781021897810219,0.021897810218978103
4194,218,21,197,168,50,0.0963302752293578,0.9036697247706422,0.7706422018348624,0.22935779816513763,138,0,24,114,135,3,0.0,0.17391304347826086,0.8260869565217391,0.9782608695652174,0.021739130434782608
4195,88,6,82,63,25,0.06818181818181818,0.9318181818181818,0.7159090909090909,0.2840909090909091,92,0,1,91,88,4,0.0,0.010869565217391304,0.9891304347826086,0.9565217391304348,0.043478260869565216
4196,212,16,196,164,48,0.07547169811320754,0.9245283018867925,0.7735849056603774,0.22641509433962265,148,0,25,123,145,3,0.0,0.16891891891891891,0.831081081081081,0.9797297297297297,0.02027027027027027
4197,80,8,72,56,24,0.1,0.9,0.7,0.3,81,0,1,80,78,3,0.0,0.012345679012345678,0.9876543209876543,0.9629629629629629,0.037037037037037035
4198,127,18,109,84,43,0.14173228346456693,0.8582677165354331,0.6614173228346457,0.33858267716535434,110,0,1,109,106,4,0.0,0.00909090909090909,0.990909090909091,0.9636363636363636,0.03636363636363636
4199,61,14,47,28,33,0.22950819672131148,0.7704918032786885,0.45901639344262296,0.5409836065573771,143,0,0,143,140,3,0.0,0.0,1.0,0.9790209790209791,0.02097902097902098
4200,109,18,91,51,58,0.1651376146788991,0.8348623853211009,0.46788990825688076,0.5321100917431193,184,0,54,130,180,4,0.0,0.29347826086956524,0.7065217391304348,0.9782608695652174,0.021739130434782608
4201,111,20,91,55,56,0.18018018018018017,0.8198198198198198,0.4954954954954955,0.5045045045045045,172,0,54,118,168,4,0.0,0.313953488372093,0.686046511627907,0.9767441860465116,0.023255813953488372
4202,122,12,110,74,48,0.09836065573770492,0.9016393442622951,0.6065573770491803,0.39344262295081966,103,0,1,102,99,4,0.0,0.009708737864077669,0.9902912621359223,0.9611650485436893,0.038834951456310676
4203,42,7,35,33,9,0.16666666666666666,0.8333333333333334,0.7857142857142857,0.21428571428571427,86,0,16,70,84,2,0.0,0.18604651162790697,0.813953488372093,0.9767441860465116,0.023255813953488372
4204,87,11,76,59,28,0.12643678160919541,0.8735632183908046,0.6781609195402298,0.3218390804597701,109,0,0,109,105,4,0.0,0.0,1.0,0.963302752293578,0.03669724770642202
4205,114,7,107,93,21,0.06140350877192982,0.9385964912280702,0.8157894736842105,0.18421052631578946,85,0,13,72,83,2,0.0,0.15294117647058825,0.8470588235294118,0.9764705882352941,0.023529411764705882
4206,190,15,175,151,39,0.07894736842105263,0.9210526315789473,0.7947368421052632,0.20526315789473684,151,0,25,126,148,3,0.0,0.16556291390728478,0.8344370860927153,0.9801324503311258,0.019867549668874173
4207,116,9,107,93,23,0.07758620689655173,0.9224137931034483,0.8017241379310345,0.19827586206896552,84,0,13,71,82,2,0.0,0.15476190476190477,0.8452380952380952,0.9761904761904762,0.023809523809523808
4208,168,20,148,112,56,0.11904761904761904,0.8809523809523809,0.6666666666666666,0.3333333333333333,152,0,24,128,151,1,0.0,0.15789473684210525,0.8421052631578947,0.993421052631579,0.006578947368421052
4209,54,10,44,24,30,0.18518518518518517,0.8148148148148148,0.4444444444444444,0.5555555555555556,103,0,31,72,103,0,0.0,0.30097087378640774,0.6990291262135923,1.0,0.0
4210,116,8,108,94,22,0.06896551724137931,0.9310344827586207,0.8103448275862069,0.1896551724137931,107,0,20,87,104,3,0.0,0.18691588785046728,0.8130841121495327,0.9719626168224299,0.028037383177570093
4211,198,19,179,155,43,0.09595959595959595,0.9040404040404041,0.7828282828282829,0.21717171717171718,139,0,26,113,137,2,0.0,0.18705035971223022,0.8129496402877698,0.9856115107913669,0.014388489208633094
4212,83,5,78,65,18,0.060240963855421686,0.9397590361445783,0.7831325301204819,0.21686746987951808,81,0,1,80,78,3,0.0,0.012345679012345678,0.9876543209876543,0.9629629629629629,0.037037037037037035
4213,163,15,148,111,52,0.09202453987730061,0.9079754601226994,0.6809815950920245,0.31901840490797545,150,0,24,126,149,1,0.0,0.16,0.84,0.9933333333333333,0.006666666666666667
4214,119,12,107,78,41,0.10084033613445378,0.8991596638655462,0.6554621848739496,0.3445378151260504,110,0,2,108,106,4,0.0,0.01818181818181818,0.9818181818181818,0.9636363636363636,0.03636363636363636
4215,84,21,63,34,50,0.25,0.75,0.40476190476190477,0.5952380952380952,99,0,32,67,99,0,0.0,0.32323232323232326,0.6767676767676768,1.0,0.0
4216,107,7,100,84,23,0.06542056074766354,0.9345794392523364,0.7850467289719626,0.21495327102803738,88,0,14,74,86,2,0.0,0.1590909090909091,0.8409090909090909,0.9772727272727273,0.022727272727272728
4217,61,17,44,21,40,0.2786885245901639,0.7213114754098361,0.3442622950819672,0.6557377049180327,96,0,30,66,96,0,0.0,0.3125,0.6875,1.0,0.0
4218,110,6,104,92,18,0.05454545454545454,0.9454545454545454,0.8363636363636363,0.16363636363636364,90,0,15,75,88,2,0.0,0.16666666666666666,0.8333333333333334,0.9777777777777777,0.022222222222222223
4219,40,5,35,32,8,0.125,0.875,0.8,0.2,87,0,19,68,84,3,0.0,0.21839080459770116,0.7816091954022989,0.9655172413793104,0.034482758620689655
4220,87,11,76,55,32,0.12643678160919541,0.8735632183908046,0.632183908045977,0.367816091954023,112,0,0,112,108,4,0.0,0.0,1.0,0.9642857142857143,0.03571428571428571
4221,165,17,148,113,52,0.10303030303030303,0.896969696969697,0.6848484848484848,0.3151515151515151,152,0,24,128,151,1,0.0,0.15789473684210525,0.8421052631578947,0.993421052631579,0.006578947368421052
4222,123,13,110,82,41,0.10569105691056911,0.8943089430894309,0.6666666666666666,0.3333333333333333,123,0,1,122,119,4,0.0,0.008130081300813009,0.991869918699187,0.967479674796748,0.032520325203252036
4223,194,16,178,152,42,0.08247422680412371,0.9175257731958762,0.7835051546391752,0.21649484536082475,149,0,27,122,146,3,0.0,0.18120805369127516,0.8187919463087249,0.9798657718120806,0.020134228187919462
4224,124,14,110,79,45,0.11290322580645161,0.8870967741935484,0.6370967741935484,0.3629032258064516,106,0,1,105,102,4,0.0,0.009433962264150943,0.9905660377358491,0.9622641509433962,0.03773584905660377
4225,168,20,148,113,55,0.11904761904761904,0.8809523809523809,0.6726190476190477,0.3273809523809524,146,0,24,122,145,1,0.0,0.1643835616438356,0.8356164383561644,0.9931506849315068,0.00684931506849315
4226,94,18,76,53,41,0.19148936170212766,0.8085106382978723,0.5638297872340425,0.43617021276595747,112,0,0,112,109,3,0.0,0.0,1.0,0.9732142857142857,0.026785714285714284
4227,76,13,63,34,42,0.17105263157894737,0.8289473684210527,0.4473684210526316,0.5526315789473685,93,0,28,65,93,0,0.0,0.3010752688172043,0.6989247311827957,1.0,0.0
4228,115,9,106,74,41,0.0782608695652174,0.9217391304347826,0.6434782608695652,0.3565217391304348,122,0,0,122,120,2,0.0,0.0,1.0,0.9836065573770492,0.01639344262295082
4229,122,6,116,98,24,0.04918032786885246,0.9508196721311475,0.8032786885245902,0.19672131147540983,98,0,15,83,96,2,0.0,0.15306122448979592,0.8469387755102041,0.9795918367346939,0.02040816326530612
4230,93,11,82,62,31,0.11827956989247312,0.8817204301075269,0.6666666666666666,0.3333333333333333,86,0,1,85,82,4,0.0,0.011627906976744186,0.9883720930232558,0.9534883720930233,0.046511627906976744
4231,72,8,64,47,25,0.1111111111111111,0.8888888888888888,0.6527777777777778,0.3472222222222222,77,0,0,77,73,4,0.0,0.0,1.0,0.948051948051948,0.05194805194805195
4232,108,8,100,87,21,0.07407407407407407,0.9259259259259259,0.8055555555555556,0.19444444444444445,89,0,19,70,87,2,0.0,0.21348314606741572,0.7865168539325843,0.9775280898876404,0.02247191011235955
4233,124,14,110,77,47,0.11290322580645161,0.8870967741935484,0.6209677419354839,0.3790322580645161,103,0,1,102,99,4,0.0,0.009708737864077669,0.9902912621359223,0.9611650485436893,0.038834951456310676
4234,124,7,117,85,39,0.056451612903225805,0.9435483870967742,0.6854838709677419,0.31451612903225806,93,0,13,80,90,3,0.0,0.13978494623655913,0.8602150537634409,0.967741935483871,0.03225806451612903
4235,57,10,47,24,33,0.17543859649122806,0.8245614035087719,0.42105263157894735,0.5789473684210527,139,0,0,139,136,3,0.0,0.0,1.0,0.9784172661870504,0.02158273381294964
4236,61,14,47,27,34,0.22950819672131148,0.7704918032786885,0.4426229508196721,0.5573770491803278,138,0,0,138,135,3,0.0,0.0,1.0,0.9782608695652174,0.021739130434782608
4237,78,14,64,37,41,0.1794871794871795,0.8205128205128205,0.47435897435897434,0.5256410256410257,99,0,32,67,99,0,0.0,0.32323232323232326,0.6767676767676768,1.0,0.0
4238,126,16,110,76,50,0.12698412698412698,0.873015873015873,0.6031746031746031,0.3968253968253968,108,0,2,106,104,4,0.0,0.018518518518518517,0.9814814814814815,0.9629629629629629,0.037037037037037035
4239,62,15,47,24,38,0.24193548387096775,0.7580645161290323,0.3870967741935484,0.6129032258064516,145,0,0,145,143,2,0.0,0.0,1.0,0.9862068965517241,0.013793103448275862
4240,69,15,54,30,39,0.21739130434782608,0.782608695652174,0.43478260869565216,0.5652173913043478,101,0,30,71,101,0,0.0,0.297029702970297,0.7029702970297029,1.0,0.0
4241,132,9,123,104,28,0.06818181818181818,0.9318181818181818,0.7878787878787878,0.21212121212121213,93,0,11,82,91,2,0.0,0.11827956989247312,0.8817204301075269,0.978494623655914,0.021505376344086023
4242,167,19,148,120,47,0.11377245508982035,0.8862275449101796,0.718562874251497,0.281437125748503,160,0,24,136,159,1,0.0,0.15,0.85,0.99375,0.00625
4243,75,12,63,35,40,0.16,0.84,0.4666666666666667,0.5333333333333333,101,0,30,71,101,0,0.0,0.297029702970297,0.7029702970297029,1.0,0.0
4244,70,16,54,24,46,0.22857142857142856,0.7714285714285715,0.34285714285714286,0.6571428571428571,101,0,30,71,101,0,0.0,0.297029702970297,0.7029702970297029,1.0,0.0
4245,127,16,111,85,42,0.12598425196850394,0.8740157480314961,0.6692913385826772,0.33070866141732286,107,0,2,105,104,3,0.0,0.018691588785046728,0.9813084112149533,0.9719626168224299,0.028037383177570093
4246,92,16,76,54,38,0.17391304347826086,0.8260869565217391,0.5869565217391305,0.41304347826086957,102,0,0,102,99,3,0.0,0.0,1.0,0.9705882352941176,0.029411764705882353
4247,60,12,48,27,33,0.2,0.8,0.45,0.55,144,0,0,144,141,3,0.0,0.0,1.0,0.9791666666666666,0.020833333333333332
4248,38,6,32,30,8,0.15789473684210525,0.8421052631578947,0.7894736842105263,0.21052631578947367,87,0,16,71,84,3,0.0,0.1839080459770115,0.8160919540229885,0.9655172413793104,0.034482758620689655
4249,114,6,108,91,23,0.05263157894736842,0.9473684210526315,0.7982456140350878,0.20175438596491227,88,0,13,75,86,2,0.0,0.14772727272727273,0.8522727272727273,0.9772727272727273,0.022727272727272728
4250,79,14,65,34,45,0.17721518987341772,0.8227848101265823,0.43037974683544306,0.569620253164557,95,0,30,65,95,0,0.0,0.3157894736842105,0.6842105263157895,1.0,0.0
4251,116,7,109,84,32,0.0603448275862069,0.9396551724137931,0.7241379310344828,0.27586206896551724,107,0,1,106,103,4,0.0,0.009345794392523364,0.9906542056074766,0.9626168224299065,0.037383177570093455
4252,62,15,47,22,40,0.24193548387096775,0.7580645161290323,0.3548387096774194,0.6451612903225806,129,0,0,129,126,3,0.0,0.0,1.0,0.9767441860465116,0.023255813953488372
4253,57,9,48,24,33,0.15789473684210525,0.8421052631578947,0.42105263157894735,0.5789473684210527,139,0,0,139,137,2,0.0,0.0,1.0,0.9856115107913669,0.014388489208633094
4254,122,12,110,77,45,0.09836065573770492,0.9016393442622951,0.6311475409836066,0.36885245901639346,108,0,1,107,104,4,0.0,0.009259259259259259,0.9907407407407407,0.9629629629629629,0.037037037037037035
4255,122,13,109,79,43,0.10655737704918032,0.8934426229508197,0.6475409836065574,0.3524590163934426,104,0,1,103,101,3,0.0,0.009615384615384616,0.9903846153846154,0.9711538461538461,0.028846153846153848
4256,110,6,104,95,15,0.05454545454545454,0.9454545454545454,0.8636363636363636,0.13636363636363635,84,0,9,75,81,3,0.0,0.10714285714285714,0.8928571428571429,0.9642857142857143,0.03571428571428571
4257,126,17,109,78,48,0.1349206349206349,0.8650793650793651,0.6190476190476191,0.38095238095238093,117,0,0,117,113,4,0.0,0.0,1.0,0.9658119658119658,0.03418803418803419
4258,114,7,107,92,22,0.06140350877192982,0.9385964912280702,0.8070175438596491,0.19298245614035087,81,0,11,70,79,2,0.0,0.13580246913580246,0.8641975308641975,0.9753086419753086,0.024691358024691357
4259,69,15,54,31,38,0.21739130434782608,0.782608695652174,0.4492753623188406,0.5507246376811594,116,0,32,84,116,0,0.0,0.27586206896551724,0.7241379310344828,1.0,0.0
4260,90,8,82,65,25,0.08888888888888889,0.9111111111111111,0.7222222222222222,0.2777777777777778,82,0,1,81,78,4,0.0,0.012195121951219513,0.9878048780487805,0.9512195121951219,0.04878048780487805
4261,203,25,178,155,48,0.12315270935960591,0.8768472906403941,0.7635467980295566,0.23645320197044334,137,0,26,111,134,3,0.0,0.1897810218978102,0.8102189781021898,0.9781021897810219,0.021897810218978103
4262,125,15,110,77,48,0.12,0.88,0.616,0.384,112,0,1,111,109,3,0.0,0.008928571428571428,0.9910714285714286,0.9732142857142857,0.026785714285714284
4263,81,6,75,56,25,0.07407407407407407,0.9259259259259259,0.691358024691358,0.30864197530864196,81,0,1,80,77,4,0.0,0.012345679012345678,0.9876543209876543,0.9506172839506173,0.04938271604938271
4264,120,7,113,102,18,0.058333333333333334,0.9416666666666667,0.85,0.15,83,0,7,76,81,2,0.0,0.08433734939759036,0.9156626506024096,0.9759036144578314,0.024096385542168676
4265,126,16,110,78,48,0.12698412698412698,0.873015873015873,0.6190476190476191,0.38095238095238093,103,0,1,102,100,3,0.0,0.009708737864077669,0.9902912621359223,0.970873786407767,0.02912621359223301
4266,72,18,54,32,40,0.25,0.75,0.4444444444444444,0.5555555555555556,103,0,32,71,103,0,0.0,0.3106796116504854,0.6893203883495146,1.0,0.0
4267,196,17,179,157,39,0.08673469387755102,0.9132653061224489,0.8010204081632653,0.1989795918367347,136,0,25,111,133,3,0.0,0.18382352941176472,0.8161764705882353,0.9779411764705882,0.022058823529411766
4268,86,22,64,38,48,0.2558139534883721,0.7441860465116279,0.4418604651162791,0.5581395348837209,108,0,30,78,108,0,0.0,0.2777777777777778,0.7222222222222222,1.0,0.0
4269,209,12,197,167,42,0.05741626794258373,0.9425837320574163,0.7990430622009569,0.20095693779904306,157,0,26,131,155,2,0.0,0.16560509554140126,0.8343949044585988,0.9872611464968153,0.012738853503184714
4270,56,8,48,27,29,0.14285714285714285,0.8571428571428571,0.48214285714285715,0.5178571428571429,141,0,0,141,139,2,0.0,0.0,1.0,0.9858156028368794,0.014184397163120567
4271,158,15,143,113,45,0.0949367088607595,0.9050632911392406,0.7151898734177216,0.2848101265822785,142,0,24,118,141,1,0.0,0.16901408450704225,0.8309859154929577,0.9929577464788732,0.007042253521126761
4272,131,20,111,77,54,0.15267175572519084,0.8473282442748091,0.5877862595419847,0.4122137404580153,103,0,2,101,99,4,0.0,0.019417475728155338,0.9805825242718447,0.9611650485436893,0.038834951456310676
4273,61,14,47,28,33,0.22950819672131148,0.7704918032786885,0.45901639344262296,0.5409836065573771,136,0,0,136,133,3,0.0,0.0,1.0,0.9779411764705882,0.022058823529411766
4274,121,10,111,84,37,0.08264462809917356,0.9173553719008265,0.6942148760330579,0.30578512396694213,108,0,2,106,104,4,0.0,0.018518518518518517,0.9814814814814815,0.9629629629629629,0.037037037037037035
4275,133,11,122,95,38,0.08270676691729323,0.9172932330827067,0.7142857142857143,0.2857142857142857,95,0,13,82,93,2,0.0,0.1368421052631579,0.8631578947368421,0.9789473684210527,0.021052631578947368
4276,39,5,34,30,9,0.1282051282051282,0.8717948717948718,0.7692307692307693,0.23076923076923078,82,0,12,70,79,3,0.0,0.14634146341463414,0.8536585365853658,0.9634146341463414,0.036585365853658534
4277,124,14,110,79,45,0.11290322580645161,0.8870967741935484,0.6370967741935484,0.3629032258064516,115,0,1,114,111,4,0.0,0.008695652173913044,0.991304347826087,0.9652173913043478,0.034782608695652174
4278,62,15,47,27,35,0.24193548387096775,0.7580645161290323,0.43548387096774194,0.5645161290322581,141,0,0,141,138,3,0.0,0.0,1.0,0.9787234042553191,0.02127659574468085
4279,115,5,110,91,24,0.043478260869565216,0.9565217391304348,0.7913043478260869,0.20869565217391303,80,0,10,70,78,2,0.0,0.125,0.875,0.975,0.025
4280,119,9,110,80,39,0.07563025210084033,0.9243697478991597,0.6722689075630253,0.3277310924369748,107,0,1,106,103,4,0.0,0.009345794392523364,0.9906542056074766,0.9626168224299065,0.037383177570093455
4281,159,16,143,112,47,0.10062893081761007,0.89937106918239,0.7044025157232704,0.29559748427672955,146,1,24,121,145,1,0.00684931506849315,0.1643835616438356,0.8287671232876712,0.9931506849315068,0.00684931506849315
4282,58,10,48,27,31,0.1724137931034483,0.8275862068965517,0.46551724137931033,0.5344827586206896,142,0,0,142,139,3,0.0,0.0,1.0,0.9788732394366197,0.02112676056338028
4283,60,13,47,26,34,0.21666666666666667,0.7833333333333333,0.43333333333333335,0.5666666666666667,136,0,0,136,133,3,0.0,0.0,1.0,0.9779411764705882,0.022058823529411766
4284,119,10,109,88,31,0.08403361344537816,0.9159663865546218,0.7394957983193278,0.2605042016806723,124,0,1,123,121,3,0.0,0.008064516129032258,0.9919354838709677,0.9758064516129032,0.024193548387096774
4285,39,4,35,34,5,0.10256410256410256,0.8974358974358975,0.8717948717948718,0.1282051282051282,90,0,16,74,87,3,0.0,0.17777777777777778,0.8222222222222222,0.9666666666666667,0.03333333333333333
4286,54,6,48,25,29,0.1111111111111111,0.8888888888888888,0.46296296296296297,0.5370370370370371,145,0,0,145,143,2,0.0,0.0,1.0,0.9862068965517241,0.013793103448275862
4287,127,7,120,99,28,0.05511811023622047,0.9448818897637795,0.7795275590551181,0.2204724409448819,103,0,15,88,101,2,0.0,0.14563106796116504,0.8543689320388349,0.9805825242718447,0.019417475728155338
4288,62,15,47,26,36,0.24193548387096775,0.7580645161290323,0.41935483870967744,0.5806451612903226,135,0,1,134,132,3,0.0,0.007407407407407408,0.9925925925925926,0.9777777777777777,0.022222222222222223
4289,123,12,111,80,43,0.0975609756097561,0.9024390243902439,0.6504065040650406,0.34959349593495936,112,0,1,111,108,4,0.0,0.008928571428571428,0.9910714285714286,0.9642857142857143,0.03571428571428571
4290,159,16,143,112,47,0.10062893081761007,0.89937106918239,0.7044025157232704,0.29559748427672955,140,0,24,116,139,1,0.0,0.17142857142857143,0.8285714285714286,0.9928571428571429,0.007142857142857143
4291,47,13,34,19,28,0.2765957446808511,0.723404255319149,0.40425531914893614,0.5957446808510638,83,0,28,55,83,0,0.0,0.3373493975903614,0.6626506024096386,1.0,0.0
4292,195,15,180,156,39,0.07692307692307693,0.9230769230769231,0.8,0.2,139,0,26,113,136,3,0.0,0.18705035971223022,0.8129496402877698,0.9784172661870504,0.02158273381294964
4293,97,21,76,54,43,0.21649484536082475,0.7835051546391752,0.5567010309278351,0.44329896907216493,111,0,0,111,109,2,0.0,0.0,1.0,0.9819819819819819,0.018018018018018018
4294,194,16,178,149,45,0.08247422680412371,0.9175257731958762,0.7680412371134021,0.23195876288659795,141,0,25,116,138,3,0.0,0.1773049645390071,0.8226950354609929,0.9787234042553191,0.02127659574468085
4295,114,23,91,53,61,0.20175438596491227,0.7982456140350878,0.4649122807017544,0.5350877192982456,187,0,54,133,183,4,0.0,0.2887700534759358,0.7112299465240641,0.9786096256684492,0.0213903743315508
4296,129,8,121,98,31,0.06201550387596899,0.937984496124031,0.7596899224806202,0.24031007751937986,94,0,13,81,92,2,0.0,0.13829787234042554,0.8617021276595744,0.9787234042553191,0.02127659574468085
4297,88,12,76,56,32,0.13636363636363635,0.8636363636363636,0.6363636363636364,0.36363636363636365,111,0,0,111,108,3,0.0,0.0,1.0,0.972972972972973,0.02702702702702703
4298,93,17,76,56,37,0.1827956989247312,0.8172043010752689,0.6021505376344086,0.3978494623655914,103,0,0,103,100,3,0.0,0.0,1.0,0.970873786407767,0.02912621359223301
4299,109,18,91,57,52,0.1651376146788991,0.8348623853211009,0.5229357798165137,0.47706422018348627,178,0,54,124,175,3,0.0,0.30337078651685395,0.6966292134831461,0.9831460674157303,0.016853932584269662
4300,107,16,91,58,49,0.14953271028037382,0.8504672897196262,0.5420560747663551,0.45794392523364486,188,0,54,134,185,3,0.0,0.2872340425531915,0.7127659574468085,0.9840425531914894,0.015957446808510637
4301,116,14,102,77,39,0.1206896551724138,0.8793103448275862,0.6637931034482759,0.33620689655172414,122,0,0,122,118,4,0.0,0.0,1.0,0.9672131147540983,0.03278688524590164
4302,189,11,178,147,42,0.0582010582010582,0.9417989417989417,0.7777777777777778,0.2222222222222222,149,0,25,124,146,3,0.0,0.16778523489932887,0.8322147651006712,0.9798657718120806,0.020134228187919462
4303,68,20,48,28,40,0.29411764705882354,0.7058823529411765,0.4117647058823529,0.5882352941176471,161,0,0,161,158,3,0.0,0.0,1.0,0.9813664596273292,0.018633540372670808
4304,120,10,110,83,37,0.08333333333333333,0.9166666666666666,0.6916666666666667,0.30833333333333335,106,0,0,106,102,4,0.0,0.0,1.0,0.9622641509433962,0.03773584905660377
4305,123,13,110,82,41,0.10569105691056911,0.8943089430894309,0.6666666666666666,0.3333333333333333,112,0,2,110,108,4,0.0,0.017857142857142856,0.9821428571428571,0.9642857142857143,0.03571428571428571
4306,59,11,48,26,33,0.1864406779661017,0.8135593220338984,0.4406779661016949,0.559322033898305,150,0,0,150,148,2,0.0,0.0,1.0,0.9866666666666667,0.013333333333333334
4307,121,11,110,83,38,0.09090909090909091,0.9090909090909091,0.6859504132231405,0.3140495867768595,118,0,2,116,114,4,0.0,0.01694915254237288,0.9830508474576272,0.9661016949152542,0.03389830508474576
4308,195,14,181,155,40,0.07179487179487179,0.9282051282051282,0.7948717948717948,0.20512820512820512,141,0,26,115,139,2,0.0,0.18439716312056736,0.8156028368794326,0.9858156028368794,0.014184397163120567
4309,76,6,70,48,28,0.07894736842105263,0.9210526315789473,0.631578947368421,0.3684210526315789,81,0,0,81,77,4,0.0,0.0,1.0,0.9506172839506173,0.04938271604938271
4310,124,14,110,80,44,0.11290322580645161,0.8870967741935484,0.6451612903225806,0.3548387096774194,109,0,1,108,105,4,0.0,0.009174311926605505,0.9908256880733946,0.963302752293578,0.03669724770642202
4311,56,12,44,24,32,0.21428571428571427,0.7857142857142857,0.42857142857142855,0.5714285714285714,89,0,31,58,89,0,0.0,0.34831460674157305,0.651685393258427,1.0,0.0
4312,88,12,76,54,34,0.13636363636363635,0.8636363636363636,0.6136363636363636,0.38636363636363635,104,0,0,104,100,4,0.0,0.0,1.0,0.9615384615384616,0.038461538461538464
4313,60,12,48,28,32,0.2,0.8,0.4666666666666667,0.5333333333333333,130,0,0,130,128,2,0.0,0.0,1.0,0.9846153846153847,0.015384615384615385
4314,119,9,110,76,43,0.07563025210084033,0.9243697478991597,0.6386554621848739,0.36134453781512604,111,0,1,110,107,4,0.0,0.009009009009009009,0.990990990990991,0.963963963963964,0.036036036036036036
4315,71,7,64,49,22,0.09859154929577464,0.9014084507042254,0.6901408450704225,0.30985915492957744,69,0,0,69,65,4,0.0,0.0,1.0,0.9420289855072463,0.057971014492753624
4316,95,19,76,52,43,0.2,0.8,0.5473684210526316,0.45263157894736844,114,0,0,114,110,4,0.0,0.0,1.0,0.9649122807017544,0.03508771929824561
4317,57,10,47,24,33,0.17543859649122806,0.8245614035087719,0.42105263157894735,0.5789473684210527,139,0,0,139,136,3,0.0,0.0,1.0,0.9784172661870504,0.02158273381294964
4318,200,22,178,153,47,0.11,0.89,0.765,0.235,142,0,25,117,140,2,0.0,0.176056338028169,0.823943661971831,0.9859154929577465,0.014084507042253521
4319,126,16,110,80,46,0.12698412698412698,0.873015873015873,0.6349206349206349,0.36507936507936506,107,0,1,106,103,4,0.0,0.009345794392523364,0.9906542056074766,0.9626168224299065,0.037383177570093455
4320,58,14,44,23,35,0.2413793103448276,0.7586206896551724,0.39655172413793105,0.603448275862069,93,0,32,61,93,0,0.0,0.34408602150537637,0.6559139784946236,1.0,0.0
4321,68,14,54,28,40,0.20588235294117646,0.7941176470588235,0.4117647058823529,0.5882352941176471,104,0,30,74,104,0,0.0,0.28846153846153844,0.7115384615384616,1.0,0.0
4322,122,11,111,81,41,0.09016393442622951,0.9098360655737705,0.6639344262295082,0.3360655737704918,101,0,2,99,97,4,0.0,0.019801980198019802,0.9801980198019802,0.9603960396039604,0.039603960396039604
4323,123,13,110,74,49,0.10569105691056911,0.8943089430894309,0.6016260162601627,0.3983739837398374,116,0,1,115,112,4,0.0,0.008620689655172414,0.9913793103448276,0.9655172413793104,0.034482758620689655
4324,126,11,115,97,29,0.0873015873015873,0.9126984126984127,0.7698412698412699,0.23015873015873015,98,0,18,80,96,2,0.0,0.1836734693877551,0.8163265306122449,0.9795918367346939,0.02040816326530612
4325,121,14,107,82,39,0.11570247933884298,0.8842975206611571,0.6776859504132231,0.32231404958677684,102,0,2,100,98,4,0.0,0.0196078431372549,0.9803921568627451,0.9607843137254902,0.0392156862745098
4326,124,14,110,82,42,0.11290322580645161,0.8870967741935484,0.6612903225806451,0.3387096774193548,119,0,1,118,115,4,0.0,0.008403361344537815,0.9915966386554622,0.9663865546218487,0.03361344537815126
4327,193,13,180,154,39,0.06735751295336788,0.9326424870466321,0.7979274611398963,0.20207253886010362,131,0,25,106,128,3,0.0,0.19083969465648856,0.8091603053435115,0.9770992366412213,0.022900763358778626
4328,115,7,108,88,27,0.06086956521739131,0.9391304347826087,0.7652173913043478,0.23478260869565218,106,0,21,85,103,3,0.0,0.19811320754716982,0.8018867924528302,0.9716981132075472,0.02830188679245283
4329,217,21,196,168,49,0.0967741935483871,0.9032258064516129,0.7741935483870968,0.22580645161290322,140,0,25,115,137,3,0.0,0.17857142857142858,0.8214285714285714,0.9785714285714285,0.02142857142857143
4330,122,12,110,84,38,0.09836065573770492,0.9016393442622951,0.6885245901639344,0.3114754098360656,106,0,2,104,102,4,0.0,0.018867924528301886,0.9811320754716981,0.9622641509433962,0.03773584905660377
4331,123,13,110,84,39,0.10569105691056911,0.8943089430894309,0.6829268292682927,0.3170731707317073,104,0,1,103,100,4,0.0,0.009615384615384616,0.9903846153846154,0.9615384615384616,0.038461538461538464
4332,110,19,91,55,55,0.17272727272727273,0.8272727272727273,0.5,0.5,179,1,54,124,175,4,0.00558659217877095,0.3016759776536313,0.6927374301675978,0.9776536312849162,0.0223463687150838
4333,111,11,100,70,41,0.0990990990990991,0.9009009009009009,0.6306306306306306,0.36936936936936937,129,0,0,129,126,3,0.0,0.0,1.0,0.9767441860465116,0.023255813953488372
4334,96,2,94,79,17,0.020833333333333332,0.9791666666666666,0.8229166666666666,0.17708333333333334,98,0,17,81,96,2,0.0,0.17346938775510204,0.826530612244898,0.9795918367346939,0.02040816326530612
4335,87,11,76,52,35,0.12643678160919541,0.8735632183908046,0.5977011494252874,0.40229885057471265,103,0,0,103,100,3,0.0,0.0,1.0,0.970873786407767,0.02912621359223301
4336,80,15,65,35,45,0.1875,0.8125,0.4375,0.5625,98,0,30,68,98,0,0.0,0.30612244897959184,0.6938775510204082,1.0,0.0
4337,81,15,66,38,43,0.18518518518518517,0.8148148148148148,0.4691358024691358,0.5308641975308642,89,0,28,61,89,0,0.0,0.3146067415730337,0.6853932584269663,1.0,0.0
4338,109,19,90,54,55,0.1743119266055046,0.8256880733944955,0.4954128440366973,0.5045871559633027,186,0,54,132,183,3,0.0,0.2903225806451613,0.7096774193548387,0.9838709677419355,0.016129032258064516
4339,110,19,91,49,61,0.17272727272727273,0.8272727272727273,0.44545454545454544,0.5545454545454546,184,0,54,130,180,4,0.0,0.29347826086956524,0.7065217391304348,0.9782608695652174,0.021739130434782608
4340,123,12,111,79,44,0.0975609756097561,0.9024390243902439,0.6422764227642277,0.35772357723577236,111,0,2,109,107,4,0.0,0.018018018018018018,0.9819819819819819,0.963963963963964,0.036036036036036036
4341,89,13,76,54,35,0.14606741573033707,0.8539325842696629,0.6067415730337079,0.39325842696629215,107,0,0,107,104,3,0.0,0.0,1.0,0.9719626168224299,0.028037383177570093
4342,123,6,117,101,22,0.04878048780487805,0.9512195121951219,0.8211382113821138,0.17886178861788618,99,0,15,84,97,2,0.0,0.15151515151515152,0.8484848484848485,0.9797979797979798,0.020202020202020204
4343,60,13,47,28,32,0.21666666666666667,0.7833333333333333,0.4666666666666667,0.5333333333333333,142,0,0,142,139,3,0.0,0.0,1.0,0.9788732394366197,0.02112676056338028
4344,86,10,76,55,31,0.11627906976744186,0.8837209302325582,0.6395348837209303,0.36046511627906974,118,0,0,118,115,3,0.0,0.0,1.0,0.9745762711864406,0.025423728813559324
4345,127,17,110,78,49,0.13385826771653545,0.8661417322834646,0.6141732283464567,0.3858267716535433,98,0,1,97,94,4,0.0,0.01020408163265306,0.9897959183673469,0.9591836734693877,0.04081632653061224
4346,124,13,111,84,40,0.10483870967741936,0.8951612903225806,0.6774193548387096,0.3225806451612903,115,0,2,113,112,3,0.0,0.017391304347826087,0.9826086956521739,0.9739130434782609,0.02608695652173913
4347,107,4,103,91,16,0.037383177570093455,0.9626168224299065,0.8504672897196262,0.14953271028037382,90,0,16,74,88,2,0.0,0.17777777777777778,0.8222222222222222,0.9777777777777777,0.022222222222222223
4348,42,8,34,16,26,0.19047619047619047,0.8095238095238095,0.38095238095238093,0.6190476190476191,75,0,30,45,75,0,0.0,0.4,0.6,1.0,0.0
4349,128,18,110,82,46,0.140625,0.859375,0.640625,0.359375,111,0,1,110,108,3,0.0,0.009009009009009009,0.990990990990991,0.972972972972973,0.02702702702702703
4350,195,18,177,152,43,0.09230769230769231,0.9076923076923077,0.7794871794871795,0.2205128205128205,136,0,24,112,133,3,0.0,0.17647058823529413,0.8235294117647058,0.9779411764705882,0.022058823529411766
4351,147,15,132,108,39,0.10204081632653061,0.8979591836734694,0.7346938775510204,0.2653061224489796,130,0,24,106,129,1,0.0,0.18461538461538463,0.8153846153846154,0.9923076923076923,0.007692307692307693
4352,141,15,126,104,37,0.10638297872340426,0.8936170212765957,0.7375886524822695,0.2624113475177305,88,0,9,79,86,2,0.0,0.10227272727272728,0.8977272727272727,0.9772727272727273,0.022727272727272728
4353,62,14,48,29,33,0.22580645161290322,0.7741935483870968,0.46774193548387094,0.532258064516129,142,0,0,142,139,3,0.0,0.0,1.0,0.9788732394366197,0.02112676056338028
4354,123,17,106,78,45,0.13821138211382114,0.8617886178861789,0.6341463414634146,0.36585365853658536,107,0,1,106,104,3,0.0,0.009345794392523364,0.9906542056074766,0.9719626168224299,0.028037383177570093
4355,81,5,76,57,24,0.06172839506172839,0.9382716049382716,0.7037037037037037,0.2962962962962963,84,0,1,83,80,4,0.0,0.011904761904761904,0.9880952380952381,0.9523809523809523,0.047619047619047616
4356,106,15,91,58,48,0.14150943396226415,0.8584905660377359,0.5471698113207547,0.4528301886792453,179,0,54,125,175,4,0.0,0.3016759776536313,0.6983240223463687,0.9776536312849162,0.0223463687150838
4357,112,4,108,83,29,0.03571428571428571,0.9642857142857143,0.7410714285714286,0.25892857142857145,78,0,10,68,76,2,0.0,0.1282051282051282,0.8717948717948718,0.9743589743589743,0.02564102564102564
4358,70,16,54,28,42,0.22857142857142856,0.7714285714285715,0.4,0.6,114,0,30,84,114,0,0.0,0.2631578947368421,0.7368421052631579,1.0,0.0
4359,160,12,148,108,52,0.075,0.925,0.675,0.325,146,0,24,122,145,1,0.0,0.1643835616438356,0.8356164383561644,0.9931506849315068,0.00684931506849315
4360,79,16,63,39,40,0.20253164556962025,0.7974683544303798,0.4936708860759494,0.5063291139240507,93,0,28,65,93,0,0.0,0.3010752688172043,0.6989247311827957,1.0,0.0
4361,94,15,79,58,36,0.1595744680851064,0.8404255319148937,0.6170212765957447,0.3829787234042553,85,0,1,84,81,4,0.0,0.011764705882352941,0.9882352941176471,0.9529411764705882,0.047058823529411764
4362,168,20,148,116,52,0.11904761904761904,0.8809523809523809,0.6904761904761905,0.30952380952380953,146,0,24,122,145,1,0.0,0.1643835616438356,0.8356164383561644,0.9931506849315068,0.00684931506849315
4363,63,16,47,28,35,0.25396825396825395,0.746031746031746,0.4444444444444444,0.5555555555555556,142,0,0,142,139,3,0.0,0.0,1.0,0.9788732394366197,0.02112676056338028
4364,61,14,47,27,34,0.22950819672131148,0.7704918032786885,0.4426229508196721,0.5573770491803278,135,0,0,135,132,3,0.0,0.0,1.0,0.9777777777777777,0.022222222222222223
4365,116,12,104,85,31,0.10344827586206896,0.896551724137931,0.7327586206896551,0.2672413793103448,85,0,8,77,83,2,0.0,0.09411764705882353,0.9058823529411765,0.9764705882352941,0.023529411764705882
4366,108,5,103,91,17,0.046296296296296294,0.9537037037037037,0.8425925925925926,0.1574074074074074,93,0,17,76,91,2,0.0,0.1827956989247312,0.8172043010752689,0.978494623655914,0.021505376344086023
4367,124,13,111,86,38,0.10483870967741936,0.8951612903225806,0.6935483870967742,0.3064516129032258,113,0,2,111,110,3,0.0,0.017699115044247787,0.9823008849557522,0.9734513274336283,0.02654867256637168
4368,94,17,77,57,37,0.18085106382978725,0.8191489361702128,0.6063829787234043,0.39361702127659576,102,0,1,101,98,4,0.0,0.00980392156862745,0.9901960784313726,0.9607843137254902,0.0392156862745098
4369,108,8,100,86,22,0.07407407407407407,0.9259259259259259,0.7962962962962963,0.2037037037037037,96,0,11,85,94,2,0.0,0.11458333333333333,0.8854166666666666,0.9791666666666666,0.020833333333333332
4370,117,7,110,79,38,0.05982905982905983,0.9401709401709402,0.6752136752136753,0.3247863247863248,107,0,1,106,103,4,0.0,0.009345794392523364,0.9906542056074766,0.9626168224299065,0.037383177570093455
4371,108,7,101,89,19,0.06481481481481481,0.9351851851851852,0.8240740740740741,0.17592592592592593,94,0,14,80,92,2,0.0,0.14893617021276595,0.851063829787234,0.9787234042553191,0.02127659574468085
4372,84,19,65,38,46,0.2261904761904762,0.7738095238095238,0.4523809523809524,0.5476190476190477,101,0,30,71,101,0,0.0,0.297029702970297,0.7029702970297029,1.0,0.0
4373,112,21,91,56,56,0.1875,0.8125,0.5,0.5,184,0,54,130,180,4,0.0,0.29347826086956524,0.7065217391304348,0.9782608695652174,0.021739130434782608
4374,88,12,76,54,34,0.13636363636363635,0.8636363636363636,0.6136363636363636,0.38636363636363635,109,0,0,109,105,4,0.0,0.0,1.0,0.963302752293578,0.03669724770642202
4375,84,10,74,56,28,0.11904761904761904,0.8809523809523809,0.6666666666666666,0.3333333333333333,106,0,0,106,102,4,0.0,0.0,1.0,0.9622641509433962,0.03773584905660377
4376,113,5,108,90,23,0.04424778761061947,0.9557522123893806,0.7964601769911505,0.20353982300884957,91,0,11,80,89,2,0.0,0.12087912087912088,0.8791208791208791,0.978021978021978,0.02197802197802198
4377,40,5,35,31,9,0.125,0.875,0.775,0.225,93,0,18,75,90,3,0.0,0.1935483870967742,0.8064516129032258,0.967741935483871,0.03225806451612903
4378,125,9,116,92,33,0.072,0.928,0.736,0.264,104,0,18,86,102,2,0.0,0.17307692307692307,0.8269230769230769,0.9807692307692307,0.019230769230769232
4379,139,114,25,136,3,0.8201438848920863,0.17985611510791366,0.9784172661870504,0.02158273381294964,299,0,27,272,82,217,0.0,0.0903010033444816,0.9096989966555183,0.27424749163879597,0.725752508361204
4380,74,20,54,31,43,0.2702702702702703,0.7297297297297297,0.4189189189189189,0.581081081081081,102,0,30,72,102,0,0.0,0.29411764705882354,0.7058823529411765,1.0,0.0
4381,108,8,100,86,22,0.07407407407407407,0.9259259259259259,0.7962962962962963,0.2037037037037037,90,0,16,74,88,2,0.0,0.17777777777777778,0.8222222222222222,0.9777777777777777,0.022222222222222223
4382,120,11,109,76,44,0.09166666666666666,0.9083333333333333,0.6333333333333333,0.36666666666666664,99,0,1,98,95,4,0.0,0.010101010101010102,0.98989898989899,0.9595959595959596,0.04040404040404041
4383,68,20,48,25,43,0.29411764705882354,0.7058823529411765,0.36764705882352944,0.6323529411764706,142,0,0,142,139,3,0.0,0.0,1.0,0.9788732394366197,0.02112676056338028
4384,124,14,110,80,44,0.11290322580645161,0.8870967741935484,0.6451612903225806,0.3548387096774194,101,0,1,100,97,4,0.0,0.009900990099009901,0.9900990099009901,0.9603960396039604,0.039603960396039604
4385,167,19,148,113,54,0.11377245508982035,0.8862275449101796,0.6766467065868264,0.32335329341317365,139,0,24,115,138,1,0.0,0.17266187050359713,0.8273381294964028,0.9928057553956835,0.007194244604316547
4386,63,9,54,29,34,0.14285714285714285,0.8571428571428571,0.4603174603174603,0.5396825396825397,110,0,32,78,110,0,0.0,0.2909090909090909,0.7090909090909091,1.0,0.0
4387,92,17,75,52,40,0.18478260869565216,0.8152173913043478,0.5652173913043478,0.43478260869565216,115,0,1,114,112,3,0.0,0.008695652173913044,0.991304347826087,0.9739130434782609,0.02608695652173913
4388,56,9,47,23,33,0.16071428571428573,0.8392857142857143,0.4107142857142857,0.5892857142857143,139,0,0,139,136,3,0.0,0.0,1.0,0.9784172661870504,0.02158273381294964
4389,58,11,47,25,33,0.1896551724137931,0.8103448275862069,0.43103448275862066,0.5689655172413793,135,0,0,135,133,2,0.0,0.0,1.0,0.9851851851851852,0.014814814814814815
4390,120,9,111,82,38,0.075,0.925,0.6833333333333333,0.31666666666666665,109,0,2,107,105,4,0.0,0.01834862385321101,0.981651376146789,0.963302752293578,0.03669724770642202
4391,194,14,180,152,42,0.07216494845360824,0.9278350515463918,0.7835051546391752,0.21649484536082475,131,0,27,104,128,3,0.0,0.20610687022900764,0.7938931297709924,0.9770992366412213,0.022900763358778626
4392,193,14,179,157,36,0.07253886010362694,0.927461139896373,0.8134715025906736,0.18652849740932642,140,0,27,113,137,3,0.0,0.19285714285714287,0.8071428571428572,0.9785714285714285,0.02142857142857143
4393,60,16,44,22,38,0.26666666666666666,0.7333333333333333,0.36666666666666664,0.6333333333333333,90,0,30,60,90,0,0.0,0.3333333333333333,0.6666666666666666,1.0,0.0
4394,125,14,111,88,37,0.112,0.888,0.704,0.296,104,0,2,102,100,4,0.0,0.019230769230769232,0.9807692307692307,0.9615384615384616,0.038461538461538464
4395,125,15,110,80,45,0.12,0.88,0.64,0.36,122,0,1,121,118,4,0.0,0.00819672131147541,0.9918032786885246,0.9672131147540983,0.03278688524590164
4396,92,16,76,52,40,0.17391304347826086,0.8260869565217391,0.5652173913043478,0.43478260869565216,112,0,0,112,109,3,0.0,0.0,1.0,0.9732142857142857,0.026785714285714284
4397,64,16,48,26,38,0.25,0.75,0.40625,0.59375,144,0,0,144,141,3,0.0,0.0,1.0,0.9791666666666666,0.020833333333333332
4398,126,7,119,97,29,0.05555555555555555,0.9444444444444444,0.7698412698412699,0.23015873015873015,104,0,14,90,101,3,0.0,0.1346153846153846,0.8653846153846154,0.9711538461538461,0.028846153846153848
4399,61,14,47,23,38,0.22950819672131148,0.7704918032786885,0.3770491803278688,0.6229508196721312,145,0,0,145,142,3,0.0,0.0,1.0,0.9793103448275862,0.020689655172413793
4400,65,5,60,45,20,0.07692307692307693,0.9230769230769231,0.6923076923076923,0.3076923076923077,83,0,0,83,80,3,0.0,0.0,1.0,0.963855421686747,0.03614457831325301
4401,111,9,102,88,23,0.08108108108108109,0.918918918918919,0.7927927927927928,0.2072072072072072,87,0,15,72,85,2,0.0,0.1724137931034483,0.8275862068965517,0.9770114942528736,0.022988505747126436
4402,125,15,110,80,45,0.12,0.88,0.64,0.36,107,0,1,106,103,4,0.0,0.009345794392523364,0.9906542056074766,0.9626168224299065,0.037383177570093455
4403,57,10,47,27,30,0.17543859649122806,0.8245614035087719,0.47368421052631576,0.5263157894736842,150,0,0,150,148,2,0.0,0.0,1.0,0.9866666666666667,0.013333333333333334
4404,88,9,79,64,24,0.10227272727272728,0.8977272727272727,0.7272727272727273,0.2727272727272727,82,0,1,81,78,4,0.0,0.012195121951219513,0.9878048780487805,0.9512195121951219,0.04878048780487805
4405,122,12,110,83,39,0.09836065573770492,0.9016393442622951,0.680327868852459,0.319672131147541,108,0,1,107,104,4,0.0,0.009259259259259259,0.9907407407407407,0.9629629629629629,0.037037037037037035
4406,118,20,98,71,47,0.1694915254237288,0.8305084745762712,0.6016949152542372,0.3983050847457627,127,0,0,127,124,3,0.0,0.0,1.0,0.9763779527559056,0.023622047244094488
4407,124,14,110,77,47,0.11290322580645161,0.8870967741935484,0.6209677419354839,0.3790322580645161,106,0,1,105,102,4,0.0,0.009433962264150943,0.9905660377358491,0.9622641509433962,0.03773584905660377
4408,129,10,119,100,29,0.07751937984496124,0.9224806201550387,0.7751937984496124,0.2248062015503876,104,0,14,90,102,2,0.0,0.1346153846153846,0.8653846153846154,0.9807692307692307,0.019230769230769232
4409,49,15,34,18,31,0.30612244897959184,0.6938775510204082,0.3673469387755102,0.6326530612244898,96,0,30,66,96,0,0.0,0.3125,0.6875,1.0,0.0
4410,88,9,79,53,35,0.10227272727272728,0.8977272727272727,0.6022727272727273,0.3977272727272727,73,0,1,72,69,4,0.0,0.0136986301369863,0.9863013698630136,0.9452054794520548,0.0547945205479452
4411,62,15,47,24,38,0.24193548387096775,0.7580645161290323,0.3870967741935484,0.6129032258064516,139,0,0,139,136,3,0.0,0.0,1.0,0.9784172661870504,0.02158273381294964
4412,89,13,76,54,35,0.14606741573033707,0.8539325842696629,0.6067415730337079,0.39325842696629215,123,0,0,123,119,4,0.0,0.0,1.0,0.967479674796748,0.032520325203252036
4413,41,6,35,33,8,0.14634146341463414,0.8536585365853658,0.8048780487804879,0.1951219512195122,85,0,17,68,82,3,0.0,0.2,0.8,0.9647058823529412,0.03529411764705882
4414,126,16,110,81,45,0.12698412698412698,0.873015873015873,0.6428571428571429,0.35714285714285715,109,0,1,108,106,3,0.0,0.009174311926605505,0.9908256880733946,0.9724770642201835,0.027522935779816515
4415,77,14,63,38,39,0.18181818181818182,0.8181818181818182,0.4935064935064935,0.5064935064935064,102,0,32,70,102,0,0.0,0.3137254901960784,0.6862745098039216,1.0,0.0
4416,103,6,97,85,18,0.05825242718446602,0.941747572815534,0.8252427184466019,0.17475728155339806,93,0,18,75,91,2,0.0,0.1935483870967742,0.8064516129032258,0.978494623655914,0.021505376344086023
4417,123,12,111,81,42,0.0975609756097561,0.9024390243902439,0.6585365853658537,0.34146341463414637,107,0,2,105,103,4,0.0,0.018691588785046728,0.9813084112149533,0.9626168224299065,0.037383177570093455
4418,79,13,66,41,38,0.16455696202531644,0.8354430379746836,0.5189873417721519,0.4810126582278481,92,0,29,63,92,0,0.0,0.31521739130434784,0.6847826086956522,1.0,0.0
4419,84,21,63,40,44,0.25,0.75,0.47619047619047616,0.5238095238095238,91,0,30,61,91,0,0.0,0.32967032967032966,0.6703296703296703,1.0,0.0
4420,58,11,47,29,29,0.1896551724137931,0.8103448275862069,0.5,0.5,132,0,0,132,129,3,0.0,0.0,1.0,0.9772727272727273,0.022727272727272728
4421,195,15,180,154,41,0.07692307692307693,0.9230769230769231,0.7897435897435897,0.21025641025641026,147,0,26,121,144,3,0.0,0.17687074829931973,0.8231292517006803,0.9795918367346939,0.02040816326530612
4422,80,17,63,34,46,0.2125,0.7875,0.425,0.575,87,0,30,57,87,0,0.0,0.3448275862068966,0.6551724137931034,1.0,0.0
4423,121,10,111,83,38,0.08264462809917356,0.9173553719008265,0.6859504132231405,0.3140495867768595,127,0,2,125,123,4,0.0,0.015748031496062992,0.984251968503937,0.968503937007874,0.031496062992125984
4424,127,9,118,95,32,0.07086614173228346,0.9291338582677166,0.7480314960629921,0.25196850393700787,95,0,16,79,93,2,0.0,0.16842105263157894,0.8315789473684211,0.9789473684210527,0.021052631578947368
4425,107,7,100,85,22,0.06542056074766354,0.9345794392523364,0.794392523364486,0.205607476635514,93,0,11,82,91,2,0.0,0.11827956989247312,0.8817204301075269,0.978494623655914,0.021505376344086023
4426,170,22,148,105,65,0.12941176470588237,0.8705882352941177,0.6176470588235294,0.38235294117647056,136,0,24,112,135,1,0.0,0.17647058823529413,0.8235294117647058,0.9926470588235294,0.007352941176470588
4427,129,7,122,109,20,0.05426356589147287,0.9457364341085271,0.8449612403100775,0.15503875968992248,100,0,12,88,98,2,0.0,0.12,0.88,0.98,0.02
4428,103,4,99,83,20,0.038834951456310676,0.9611650485436893,0.8058252427184466,0.1941747572815534,93,0,17,76,90,3,0.0,0.1827956989247312,0.8172043010752689,0.967741935483871,0.03225806451612903
4429,70,16,54,30,40,0.22857142857142856,0.7714285714285715,0.42857142857142855,0.5714285714285714,116,0,30,86,116,0,0.0,0.25862068965517243,0.7413793103448276,1.0,0.0
4430,122,12,110,75,47,0.09836065573770492,0.9016393442622951,0.6147540983606558,0.38524590163934425,110,0,1,109,107,3,0.0,0.00909090909090909,0.990909090909091,0.9727272727272728,0.02727272727272727
4431,75,8,67,55,20,0.10666666666666667,0.8933333333333333,0.7333333333333333,0.26666666666666666,80,0,0,80,77,3,0.0,0.0,1.0,0.9625,0.0375
4432,200,24,176,149,51,0.12,0.88,0.745,0.255,146,0,27,119,143,3,0.0,0.18493150684931506,0.815068493150685,0.9794520547945206,0.02054794520547945
4433,120,10,110,75,45,0.08333333333333333,0.9166666666666666,0.625,0.375,105,0,2,103,102,3,0.0,0.01904761904761905,0.9809523809523809,0.9714285714285714,0.02857142857142857
4434,123,12,111,78,45,0.0975609756097561,0.9024390243902439,0.6341463414634146,0.36585365853658536,109,0,1,108,106,3,0.0,0.009174311926605505,0.9908256880733946,0.9724770642201835,0.027522935779816515
4435,89,13,76,59,30,0.14606741573033707,0.8539325842696629,0.6629213483146067,0.33707865168539325,111,0,0,111,107,4,0.0,0.0,1.0,0.963963963963964,0.036036036036036036
4436,110,9,101,89,21,0.08181818181818182,0.9181818181818182,0.8090909090909091,0.19090909090909092,91,0,15,76,89,2,0.0,0.16483516483516483,0.8351648351648352,0.978021978021978,0.02197802197802198
4437,93,17,76,58,35,0.1827956989247312,0.8172043010752689,0.6236559139784946,0.3763440860215054,115,0,0,115,113,2,0.0,0.0,1.0,0.9826086956521739,0.017391304347826087
4438,79,13,66,40,39,0.16455696202531644,0.8354430379746836,0.5063291139240507,0.4936708860759494,94,0,30,64,94,0,0.0,0.3191489361702128,0.6808510638297872,1.0,0.0
4439,122,12,110,85,37,0.09836065573770492,0.9016393442622951,0.6967213114754098,0.30327868852459017,102,0,1,101,98,4,0.0,0.00980392156862745,0.9901960784313726,0.9607843137254902,0.0392156862745098
4440,113,8,105,92,21,0.07079646017699115,0.9292035398230089,0.8141592920353983,0.18584070796460178,88,0,12,76,86,2,0.0,0.13636363636363635,0.8636363636363636,0.9772727272727273,0.022727272727272728
4441,113,6,107,97,16,0.05309734513274336,0.9469026548672567,0.8584070796460177,0.1415929203539823,79,0,7,72,77,2,0.0,0.08860759493670886,0.9113924050632911,0.9746835443037974,0.02531645569620253
4442,86,12,74,52,34,0.13953488372093023,0.8604651162790697,0.6046511627906976,0.3953488372093023,111,0,0,111,108,3,0.0,0.0,1.0,0.972972972972973,0.02702702702702703
4443,39,6,33,31,8,0.15384615384615385,0.8461538461538461,0.7948717948717948,0.20512820512820512,81,0,13,68,78,3,0.0,0.16049382716049382,0.8395061728395061,0.9629629629629629,0.037037037037037035
4444,157,14,143,106,51,0.08917197452229299,0.910828025477707,0.6751592356687898,0.3248407643312102,135,0,24,111,134,1,0.0,0.17777777777777778,0.8222222222222222,0.9925925925925926,0.007407407407407408
4445,83,7,76,53,30,0.08433734939759036,0.9156626506024096,0.6385542168674698,0.3614457831325301,99,0,0,99,96,3,0.0,0.0,1.0,0.9696969696969697,0.030303030303030304
4446,106,5,101,81,25,0.04716981132075472,0.9528301886792453,0.7641509433962265,0.2358490566037736,84,0,14,70,82,2,0.0,0.16666666666666666,0.8333333333333334,0.9761904761904762,0.023809523809523808
4447,79,5,74,53,26,0.06329113924050633,0.9367088607594937,0.6708860759493671,0.3291139240506329,120,0,0,120,117,3,0.0,0.0,1.0,0.975,0.025
4448,118,6,112,97,21,0.05084745762711865,0.9491525423728814,0.8220338983050848,0.17796610169491525,91,0,16,75,89,2,0.0,0.17582417582417584,0.8241758241758241,0.978021978021978,0.02197802197802198
4449,61,13,48,26,35,0.21311475409836064,0.7868852459016393,0.4262295081967213,0.5737704918032787,140,0,0,140,137,3,0.0,0.0,1.0,0.9785714285714285,0.02142857142857143
4450,205,14,191,166,39,0.06829268292682927,0.9317073170731708,0.8097560975609757,0.1902439024390244,143,0,27,116,140,3,0.0,0.1888111888111888,0.8111888111888111,0.9790209790209791,0.02097902097902098
4451,56,12,44,23,33,0.21428571428571427,0.7857142857142857,0.4107142857142857,0.5892857142857143,90,0,30,60,90,0,0.0,0.3333333333333333,0.6666666666666666,1.0,0.0
4452,196,17,179,153,43,0.08673469387755102,0.9132653061224489,0.7806122448979592,0.2193877551020408,132,0,28,104,129,3,0.0,0.21212121212121213,0.7878787878787878,0.9772727272727273,0.022727272727272728
4453,129,19,110,89,40,0.14728682170542637,0.8527131782945736,0.689922480620155,0.31007751937984496,117,0,1,116,113,4,0.0,0.008547008547008548,0.9914529914529915,0.9658119658119658,0.03418803418803419
4454,60,12,48,27,33,0.2,0.8,0.45,0.55,141,0,0,141,138,3,0.0,0.0,1.0,0.9787234042553191,0.02127659574468085
4455,198,17,181,149,49,0.08585858585858586,0.9141414141414141,0.7525252525252525,0.2474747474747475,141,0,27,114,138,3,0.0,0.19148936170212766,0.8085106382978723,0.9787234042553191,0.02127659574468085
4456,122,11,111,79,43,0.09016393442622951,0.9098360655737705,0.6475409836065574,0.3524590163934426,110,0,2,108,107,3,0.0,0.01818181818181818,0.9818181818181818,0.9727272727272728,0.02727272727272727
4457,125,16,109,85,40,0.128,0.872,0.68,0.32,123,0,1,122,119,4,0.0,0.008130081300813009,0.991869918699187,0.967479674796748,0.032520325203252036
4458,89,13,76,53,36,0.14606741573033707,0.8539325842696629,0.5955056179775281,0.4044943820224719,104,0,0,104,102,2,0.0,0.0,1.0,0.9807692307692307,0.019230769230769232
4459,122,12,110,84,38,0.09836065573770492,0.9016393442622951,0.6885245901639344,0.3114754098360656,121,0,1,120,117,4,0.0,0.008264462809917356,0.9917355371900827,0.9669421487603306,0.03305785123966942
4460,212,15,197,170,42,0.07075471698113207,0.9292452830188679,0.8018867924528302,0.19811320754716982,142,0,26,116,139,3,0.0,0.18309859154929578,0.8169014084507042,0.9788732394366197,0.02112676056338028
4461,63,9,54,30,33,0.14285714285714285,0.8571428571428571,0.47619047619047616,0.5238095238095238,116,0,30,86,116,0,0.0,0.25862068965517243,0.7413793103448276,1.0,0.0
4462,108,5,103,86,22,0.046296296296296294,0.9537037037037037,0.7962962962962963,0.2037037037037037,88,0,16,72,86,2,0.0,0.18181818181818182,0.8181818181818182,0.9772727272727273,0.022727272727272728
4463,123,13,110,78,45,0.10569105691056911,0.8943089430894309,0.6341463414634146,0.36585365853658536,99,0,1,98,95,4,0.0,0.010101010101010102,0.98989898989899,0.9595959595959596,0.04040404040404041
4464,106,5,101,90,16,0.04716981132075472,0.9528301886792453,0.8490566037735849,0.1509433962264151,91,0,15,76,89,2,0.0,0.16483516483516483,0.8351648351648352,0.978021978021978,0.02197802197802198
4465,106,7,99,80,26,0.0660377358490566,0.9339622641509434,0.7547169811320755,0.24528301886792453,85,0,12,73,83,2,0.0,0.1411764705882353,0.8588235294117647,0.9764705882352941,0.023529411764705882
4466,124,14,110,87,37,0.11290322580645161,0.8870967741935484,0.7016129032258065,0.29838709677419356,117,0,2,115,113,4,0.0,0.017094017094017096,0.9829059829059829,0.9658119658119658,0.03418803418803419
4467,124,8,116,95,29,0.06451612903225806,0.9354838709677419,0.7661290322580645,0.23387096774193547,105,0,16,89,103,2,0.0,0.1523809523809524,0.8476190476190476,0.9809523809523809,0.01904761904761905
4468,194,14,180,153,41,0.07216494845360824,0.9278350515463918,0.788659793814433,0.211340206185567,143,0,26,117,140,3,0.0,0.18181818181818182,0.8181818181818182,0.9790209790209791,0.02097902097902098
4469,194,14,180,153,41,0.07216494845360824,0.9278350515463918,0.788659793814433,0.211340206185567,142,0,28,114,139,3,0.0,0.19718309859154928,0.8028169014084507,0.9788732394366197,0.02112676056338028
4470,38,4,34,31,7,0.10526315789473684,0.8947368421052632,0.8157894736842105,0.18421052631578946,87,0,15,72,84,3,0.0,0.1724137931034483,0.8275862068965517,0.9655172413793104,0.034482758620689655
4471,151,18,133,110,41,0.11920529801324503,0.8807947019867549,0.7284768211920529,0.271523178807947,135,0,24,111,134,1,0.0,0.17777777777777778,0.8222222222222222,0.9925925925925926,0.007407407407407408
4472,124,15,109,82,42,0.12096774193548387,0.8790322580645161,0.6612903225806451,0.3387096774193548,105,0,1,104,101,4,0.0,0.009523809523809525,0.9904761904761905,0.9619047619047619,0.0380952380952381
4473,196,16,180,154,42,0.08163265306122448,0.9183673469387755,0.7857142857142857,0.21428571428571427,142,0,27,115,139,3,0.0,0.19014084507042253,0.8098591549295775,0.9788732394366197,0.02112676056338028
4474,39,6,33,30,9,0.15384615384615385,0.8461538461538461,0.7692307692307693,0.23076923076923078,87,0,15,72,84,3,0.0,0.1724137931034483,0.8275862068965517,0.9655172413793104,0.034482758620689655
4475,111,8,103,88,23,0.07207207207207207,0.9279279279279279,0.7927927927927928,0.2072072072072072,91,0,16,75,89,2,0.0,0.17582417582417584,0.8241758241758241,0.978021978021978,0.02197802197802198
4476,142,121,21,139,3,0.852112676056338,0.14788732394366197,0.9788732394366197,0.02112676056338028,312,0,31,281,85,227,0.0,0.09935897435897435,0.9006410256410257,0.2724358974358974,0.7275641025641025
4477,119,9,110,80,39,0.07563025210084033,0.9243697478991597,0.6722689075630253,0.3277310924369748,105,0,1,104,102,3,0.0,0.009523809523809525,0.9904761904761905,0.9714285714285714,0.02857142857142857
4478,118,8,110,85,33,0.06779661016949153,0.9322033898305084,0.7203389830508474,0.2796610169491525,101,0,2,99,97,4,0.0,0.019801980198019802,0.9801980198019802,0.9603960396039604,0.039603960396039604
4479,163,15,148,119,44,0.09202453987730061,0.9079754601226994,0.7300613496932515,0.26993865030674846,132,0,24,108,131,1,0.0,0.18181818181818182,0.8181818181818182,0.9924242424242424,0.007575757575757576
4480,123,13,110,76,47,0.10569105691056911,0.8943089430894309,0.6178861788617886,0.3821138211382114,110,0,1,109,106,4,0.0,0.00909090909090909,0.990909090909091,0.9636363636363636,0.03636363636363636
4481,66,12,54,28,38,0.18181818181818182,0.8181818181818182,0.42424242424242425,0.5757575757575758,109,0,30,79,109,0,0.0,0.27522935779816515,0.7247706422018348,1.0,0.0
4482,179,139,40,176,3,0.776536312849162,0.22346368715083798,0.9832402234636871,0.01675977653631285,407,0,34,373,108,299,0.0,0.08353808353808354,0.9164619164619164,0.26535626535626533,0.7346437346437347
4483,200,19,181,159,41,0.095,0.905,0.795,0.205,139,0,27,112,136,3,0.0,0.19424460431654678,0.8057553956834532,0.9784172661870504,0.02158273381294964
4484,59,12,47,24,35,0.2033898305084746,0.7966101694915254,0.4067796610169492,0.5932203389830508,139,0,0,139,136,3,0.0,0.0,1.0,0.9784172661870504,0.02158273381294964
4485,108,6,102,93,15,0.05555555555555555,0.9444444444444444,0.8611111111111112,0.1388888888888889,97,0,17,80,95,2,0.0,0.17525773195876287,0.8247422680412371,0.979381443298969,0.020618556701030927
4486,86,8,78,64,22,0.09302325581395349,0.9069767441860465,0.7441860465116279,0.2558139534883721,84,0,1,83,80,4,0.0,0.011904761904761904,0.9880952380952381,0.9523809523809523,0.047619047619047616
4487,113,8,105,90,23,0.07079646017699115,0.9292035398230089,0.7964601769911505,0.20353982300884957,85,0,13,72,83,2,0.0,0.15294117647058825,0.8470588235294118,0.9764705882352941,0.023529411764705882
4488,47,13,34,18,29,0.2765957446808511,0.723404255319149,0.3829787234042553,0.6170212765957447,87,0,32,55,87,0,0.0,0.367816091954023,0.632183908045977,1.0,0.0
4489,91,15,76,57,34,0.16483516483516483,0.8351648351648352,0.6263736263736264,0.37362637362637363,108,0,0,108,105,3,0.0,0.0,1.0,0.9722222222222222,0.027777777777777776
4490,62,15,47,28,34,0.24193548387096775,0.7580645161290323,0.45161290322580644,0.5483870967741935,130,0,0,130,127,3,0.0,0.0,1.0,0.9769230769230769,0.023076923076923078
4491,115,7,108,89,26,0.06086956521739131,0.9391304347826087,0.7739130434782608,0.22608695652173913,84,0,10,74,82,2,0.0,0.11904761904761904,0.8809523809523809,0.9761904761904762,0.023809523809523808
4492,216,20,196,167,49,0.09259259259259259,0.9074074074074074,0.7731481481481481,0.22685185185185186,151,0,26,125,148,3,0.0,0.17218543046357615,0.8278145695364238,0.9801324503311258,0.019867549668874173
4493,127,16,111,84,43,0.12598425196850394,0.8740157480314961,0.6614173228346457,0.33858267716535434,101,0,2,99,98,3,0.0,0.019801980198019802,0.9801980198019802,0.9702970297029703,0.0297029702970297
4494,129,23,106,78,51,0.17829457364341086,0.8217054263565892,0.6046511627906976,0.3953488372093023,132,0,0,132,128,4,0.0,0.0,1.0,0.9696969696969697,0.030303030303030304
4495,157,25,132,105,52,0.1592356687898089,0.8407643312101911,0.6687898089171974,0.33121019108280253,124,0,24,100,123,1,0.0,0.1935483870967742,0.8064516129032258,0.9919354838709677,0.008064516129032258
4496,169,143,26,166,3,0.8461538461538461,0.15384615384615385,0.9822485207100592,0.01775147928994083,375,0,56,319,108,267,0.0,0.14933333333333335,0.8506666666666667,0.288,0.712
4497,61,14,47,27,34,0.22950819672131148,0.7704918032786885,0.4426229508196721,0.5573770491803278,139,0,0,139,136,3,0.0,0.0,1.0,0.9784172661870504,0.02158273381294964
4498,121,11,110,87,34,0.09090909090909091,0.9090909090909091,0.71900826446281,0.2809917355371901,111,0,1,110,107,4,0.0,0.009009009009009009,0.990990990990991,0.963963963963964,0.036036036036036036
4499,55,8,47,26,29,0.14545454545454545,0.8545454545454545,0.4727272727272727,0.5272727272727272,149,0,0,149,146,3,0.0,0.0,1.0,0.9798657718120806,0.020134228187919462
4500,86,21,65,39,47,0.2441860465116279,0.7558139534883721,0.45348837209302323,0.5465116279069767,104,0,28,76,104,0,0.0,0.2692307692307692,0.7307692307692307,1.0,0.0
4501,195,17,178,151,44,0.08717948717948718,0.9128205128205128,0.7743589743589744,0.22564102564102564,139,0,27,112,136,3,0.0,0.19424460431654678,0.8057553956834532,0.9784172661870504,0.02158273381294964
4502,122,13,109,81,41,0.10655737704918032,0.8934426229508197,0.6639344262295082,0.3360655737704918,120,0,1,119,117,3,0.0,0.008333333333333333,0.9916666666666667,0.975,0.025
4503,144,11,133,104,40,0.0763888888888889,0.9236111111111112,0.7222222222222222,0.2777777777777778,130,0,24,106,129,1,0.0,0.18461538461538463,0.8153846153846154,0.9923076923076923,0.007692307692307693
4504,68,14,54,29,39,0.20588235294117646,0.7941176470588235,0.4264705882352941,0.5735294117647058,109,0,32,77,109,0,0.0,0.29357798165137616,0.7064220183486238,1.0,0.0
4505,119,9,110,78,41,0.07563025210084033,0.9243697478991597,0.6554621848739496,0.3445378151260504,111,0,1,110,107,4,0.0,0.009009009009009009,0.990990990990991,0.963963963963964,0.036036036036036036
4506,39,4,35,32,7,0.10256410256410256,0.8974358974358975,0.8205128205128205,0.1794871794871795,82,0,17,65,79,3,0.0,0.2073170731707317,0.7926829268292683,0.9634146341463414,0.036585365853658534
4507,85,9,76,56,29,0.10588235294117647,0.8941176470588236,0.6588235294117647,0.3411764705882353,102,0,0,102,100,2,0.0,0.0,1.0,0.9803921568627451,0.0196078431372549
4508,128,18,110,84,44,0.140625,0.859375,0.65625,0.34375,114,0,1,113,110,4,0.0,0.008771929824561403,0.9912280701754386,0.9649122807017544,0.03508771929824561
4509,194,15,179,151,43,0.07731958762886598,0.9226804123711341,0.7783505154639175,0.22164948453608246,133,0,25,108,130,3,0.0,0.18796992481203006,0.8120300751879699,0.9774436090225563,0.022556390977443608
4510,108,6,102,84,24,0.05555555555555555,0.9444444444444444,0.7777777777777778,0.2222222222222222,90,0,13,77,88,2,0.0,0.14444444444444443,0.8555555555555555,0.9777777777777777,0.022222222222222223
4511,112,5,107,94,18,0.044642857142857144,0.9553571428571429,0.8392857142857143,0.16071428571428573,86,0,12,74,84,2,0.0,0.13953488372093023,0.8604651162790697,0.9767441860465116,0.023255813953488372
4512,165,138,27,162,3,0.8363636363636363,0.16363636363636364,0.9818181818181818,0.01818181818181818,336,0,66,270,122,214,0.0,0.19642857142857142,0.8035714285714286,0.3630952380952381,0.6369047619047619
4513,129,18,111,79,50,0.13953488372093023,0.8604651162790697,0.6124031007751938,0.3875968992248062,100,0,2,98,96,4,0.0,0.02,0.98,0.96,0.04
4514,59,12,47,23,36,0.2033898305084746,0.7966101694915254,0.3898305084745763,0.6101694915254238,141,0,0,141,139,2,0.0,0.0,1.0,0.9858156028368794,0.014184397163120567
4515,73,19,54,29,44,0.2602739726027397,0.7397260273972602,0.3972602739726027,0.6027397260273972,108,0,31,77,108,0,0.0,0.28703703703703703,0.7129629629629629,1.0,0.0
4516,122,12,110,82,40,0.09836065573770492,0.9016393442622951,0.6721311475409836,0.32786885245901637,107,0,1,106,103,4,0.0,0.009345794392523364,0.9906542056074766,0.9626168224299065,0.037383177570093455
4517,121,10,111,82,39,0.08264462809917356,0.9173553719008265,0.6776859504132231,0.32231404958677684,116,0,2,114,112,4,0.0,0.017241379310344827,0.9827586206896551,0.9655172413793104,0.034482758620689655
4518,121,11,110,84,37,0.09090909090909091,0.9090909090909091,0.6942148760330579,0.30578512396694213,115,0,0,115,112,3,0.0,0.0,1.0,0.9739130434782609,0.02608695652173913
4519,120,10,110,79,41,0.08333333333333333,0.9166666666666666,0.6583333333333333,0.3416666666666667,106,0,1,105,102,4,0.0,0.009433962264150943,0.9905660377358491,0.9622641509433962,0.03773584905660377
4520,124,14,110,80,44,0.11290322580645161,0.8870967741935484,0.6451612903225806,0.3548387096774194,118,0,1,117,115,3,0.0,0.00847457627118644,0.9915254237288136,0.9745762711864406,0.025423728813559324
4521,139,14,125,105,34,0.10071942446043165,0.8992805755395683,0.7553956834532374,0.2446043165467626,98,0,10,88,96,2,0.0,0.10204081632653061,0.8979591836734694,0.9795918367346939,0.02040816326530612
4522,103,7,96,80,23,0.06796116504854369,0.9320388349514563,0.7766990291262136,0.22330097087378642,95,0,16,79,93,2,0.0,0.16842105263157894,0.8315789473684211,0.9789473684210527,0.021052631578947368
4523,126,17,109,80,46,0.1349206349206349,0.8650793650793651,0.6349206349206349,0.36507936507936506,109,0,1,108,105,4,0.0,0.009174311926605505,0.9908256880733946,0.963302752293578,0.03669724770642202
4524,191,15,176,148,43,0.07853403141361257,0.9214659685863874,0.774869109947644,0.225130890052356,141,0,26,115,139,2,0.0,0.18439716312056736,0.8156028368794326,0.9858156028368794,0.014184397163120567
4525,39,5,34,34,5,0.1282051282051282,0.8717948717948718,0.8717948717948718,0.1282051282051282,91,0,19,72,88,3,0.0,0.2087912087912088,0.7912087912087912,0.967032967032967,0.03296703296703297
4526,106,11,95,71,35,0.10377358490566038,0.8962264150943396,0.6698113207547169,0.330188679245283,113,0,0,113,110,3,0.0,0.0,1.0,0.9734513274336283,0.02654867256637168
4527,124,14,110,85,39,0.11290322580645161,0.8870967741935484,0.6854838709677419,0.31451612903225806,109,0,1,108,105,4,0.0,0.009174311926605505,0.9908256880733946,0.963302752293578,0.03669724770642202
4528,87,11,76,53,34,0.12643678160919541,0.8735632183908046,0.6091954022988506,0.39080459770114945,122,0,0,122,118,4,0.0,0.0,1.0,0.9672131147540983,0.03278688524590164
4529,101,8,93,80,21,0.07920792079207921,0.9207920792079208,0.7920792079207921,0.2079207920792079,85,0,14,71,83,2,0.0,0.16470588235294117,0.8352941176470589,0.9764705882352941,0.023529411764705882
4530,145,12,133,106,39,0.08275862068965517,0.9172413793103448,0.7310344827586207,0.2689655172413793,135,0,24,111,134,1,0.0,0.17777777777777778,0.8222222222222222,0.9925925925925926,0.007407407407407408
4531,113,7,106,92,21,0.061946902654867256,0.9380530973451328,0.8141592920353983,0.18584070796460178,83,0,11,72,81,2,0.0,0.13253012048192772,0.8674698795180723,0.9759036144578314,0.024096385542168676
4532,93,17,76,52,41,0.1827956989247312,0.8172043010752689,0.5591397849462365,0.44086021505376344,102,0,0,102,98,4,0.0,0.0,1.0,0.9607843137254902,0.0392156862745098
4533,106,5,101,88,18,0.04716981132075472,0.9528301886792453,0.8301886792452831,0.16981132075471697,86,0,13,73,84,2,0.0,0.1511627906976744,0.8488372093023255,0.9767441860465116,0.023255813953488372
4534,190,11,179,153,37,0.05789473684210526,0.9421052631578948,0.8052631578947368,0.19473684210526315,148,0,26,122,145,3,0.0,0.17567567567567569,0.8243243243243243,0.9797297297297297,0.02027027027027027
4535,197,19,178,147,50,0.09644670050761421,0.9035532994923858,0.7461928934010152,0.25380710659898476,144,0,24,120,141,3,0.0,0.16666666666666666,0.8333333333333334,0.9791666666666666,0.020833333333333332
4536,107,6,101,84,23,0.056074766355140186,0.9439252336448598,0.7850467289719626,0.21495327102803738,91,0,19,72,89,2,0.0,0.2087912087912088,0.7912087912087912,0.978021978021978,0.02197802197802198
4537,109,5,104,87,22,0.045871559633027525,0.9541284403669725,0.7981651376146789,0.2018348623853211,81,0,12,69,79,2,0.0,0.14814814814814814,0.8518518518518519,0.9753086419753086,0.024691358024691357
4538,93,10,83,65,28,0.10752688172043011,0.8924731182795699,0.6989247311827957,0.3010752688172043,81,0,1,80,77,4,0.0,0.012345679012345678,0.9876543209876543,0.9506172839506173,0.04938271604938271
4539,120,10,110,82,38,0.08333333333333333,0.9166666666666666,0.6833333333333333,0.31666666666666665,117,0,1,116,113,4,0.0,0.008547008547008548,0.9914529914529915,0.9658119658119658,0.03418803418803419
4540,59,12,47,28,31,0.2033898305084746,0.7966101694915254,0.4745762711864407,0.5254237288135594,154,0,0,154,151,3,0.0,0.0,1.0,0.9805194805194806,0.01948051948051948
4541,121,11,110,82,39,0.09090909090909091,0.9090909090909091,0.6776859504132231,0.32231404958677684,113,0,1,112,110,3,0.0,0.008849557522123894,0.9911504424778761,0.9734513274336283,0.02654867256637168
4542,123,7,116,81,42,0.056910569105691054,0.943089430894309,0.6585365853658537,0.34146341463414637,101,0,16,85,99,2,0.0,0.15841584158415842,0.8415841584158416,0.9801980198019802,0.019801980198019802
4543,57,10,47,28,29,0.17543859649122806,0.8245614035087719,0.49122807017543857,0.5087719298245614,141,0,0,141,139,2,0.0,0.0,1.0,0.9858156028368794,0.014184397163120567
4544,134,9,125,100,34,0.06716417910447761,0.9328358208955224,0.746268656716418,0.2537313432835821,102,0,11,91,100,2,0.0,0.10784313725490197,0.8921568627450981,0.9803921568627451,0.0196078431372549
4545,108,17,91,56,52,0.1574074074074074,0.8425925925925926,0.5185185185185185,0.48148148148148145,175,0,54,121,171,4,0.0,0.30857142857142855,0.6914285714285714,0.9771428571428571,0.022857142857142857
4546,76,14,62,34,42,0.18421052631578946,0.8157894736842105,0.4473684210526316,0.5526315789473685,94,0,30,64,94,0,0.0,0.3191489361702128,0.6808510638297872,1.0,0.0
4547,83,5,78,56,27,0.060240963855421686,0.9397590361445783,0.6746987951807228,0.3253012048192771,84,0,0,84,80,4,0.0,0.0,1.0,0.9523809523809523,0.047619047619047616
4548,110,19,91,58,52,0.17272727272727273,0.8272727272727273,0.5272727272727272,0.4727272727272727,183,0,54,129,180,3,0.0,0.29508196721311475,0.7049180327868853,0.9836065573770492,0.01639344262295082
4549,195,15,180,156,39,0.07692307692307693,0.9230769230769231,0.8,0.2,140,0,27,113,138,2,0.0,0.19285714285714287,0.8071428571428572,0.9857142857142858,0.014285714285714285
4550,124,14,110,87,37,0.11290322580645161,0.8870967741935484,0.7016129032258065,0.29838709677419356,107,0,1,106,103,4,0.0,0.009345794392523364,0.9906542056074766,0.9626168224299065,0.037383177570093455
4551,127,17,110,82,45,0.13385826771653545,0.8661417322834646,0.6456692913385826,0.3543307086614173,103,0,1,102,99,4,0.0,0.009708737864077669,0.9902912621359223,0.9611650485436893,0.038834951456310676
4552,125,15,110,78,47,0.12,0.88,0.624,0.376,117,0,1,116,114,3,0.0,0.008547008547008548,0.9914529914529915,0.9743589743589743,0.02564102564102564
4553,196,15,181,156,40,0.07653061224489796,0.923469387755102,0.7959183673469388,0.20408163265306123,142,0,27,115,139,3,0.0,0.19014084507042253,0.8098591549295775,0.9788732394366197,0.02112676056338028
4554,42,8,34,31,11,0.19047619047619047,0.8095238095238095,0.7380952380952381,0.2619047619047619,89,0,18,71,86,3,0.0,0.20224719101123595,0.797752808988764,0.9662921348314607,0.033707865168539325
4555,118,12,106,76,42,0.1016949152542373,0.8983050847457628,0.6440677966101694,0.3559322033898305,101,0,1,100,98,3,0.0,0.009900990099009901,0.9900990099009901,0.9702970297029703,0.0297029702970297
4556,91,15,76,54,37,0.16483516483516483,0.8351648351648352,0.5934065934065934,0.4065934065934066,101,0,0,101,97,4,0.0,0.0,1.0,0.9603960396039604,0.039603960396039604
4557,73,19,54,24,49,0.2602739726027397,0.7397260273972602,0.3287671232876712,0.6712328767123288,92,0,30,62,92,0,0.0,0.32608695652173914,0.6739130434782609,1.0,0.0
4558,112,6,106,95,17,0.05357142857142857,0.9464285714285714,0.8482142857142857,0.15178571428571427,76,0,5,71,74,2,0.0,0.06578947368421052,0.9342105263157895,0.9736842105263158,0.02631578947368421
4559,119,9,110,80,39,0.07563025210084033,0.9243697478991597,0.6722689075630253,0.3277310924369748,125,0,1,124,121,4,0.0,0.008,0.992,0.968,0.032
4560,40,5,35,33,7,0.125,0.875,0.825,0.175,85,0,14,71,82,3,0.0,0.16470588235294117,0.8352941176470589,0.9647058823529412,0.03529411764705882
4561,117,9,108,85,32,0.07692307692307693,0.9230769230769231,0.7264957264957265,0.27350427350427353,81,0,11,70,79,2,0.0,0.13580246913580246,0.8641975308641975,0.9753086419753086,0.024691358024691357
4562,71,7,64,51,20,0.09859154929577464,0.9014084507042254,0.7183098591549296,0.28169014084507044,73,0,0,73,69,4,0.0,0.0,1.0,0.9452054794520548,0.0547945205479452
4563,83,20,63,36,47,0.24096385542168675,0.7590361445783133,0.43373493975903615,0.5662650602409639,106,0,30,76,106,0,0.0,0.2830188679245283,0.7169811320754716,1.0,0.0
4564,94,18,76,55,39,0.19148936170212766,0.8085106382978723,0.5851063829787234,0.4148936170212766,101,0,0,101,97,4,0.0,0.0,1.0,0.9603960396039604,0.039603960396039604
4565,62,15,47,27,35,0.24193548387096775,0.7580645161290323,0.43548387096774194,0.5645161290322581,136,0,0,136,134,2,0.0,0.0,1.0,0.9852941176470589,0.014705882352941176
4566,45,11,34,18,27,0.24444444444444444,0.7555555555555555,0.4,0.6,82,0,28,54,82,0,0.0,0.34146341463414637,0.6585365853658537,1.0,0.0
4567,110,19,91,61,49,0.17272727272727273,0.8272727272727273,0.5545454545454546,0.44545454545454544,177,0,54,123,173,4,0.0,0.3050847457627119,0.6949152542372882,0.9774011299435028,0.022598870056497175
4568,147,14,133,101,46,0.09523809523809523,0.9047619047619048,0.6870748299319728,0.3129251700680272,132,0,24,108,131,1,0.0,0.18181818181818182,0.8181818181818182,0.9924242424242424,0.007575757575757576
4569,57,10,47,24,33,0.17543859649122806,0.8245614035087719,0.42105263157894735,0.5789473684210527,144,0,0,144,141,3,0.0,0.0,1.0,0.9791666666666666,0.020833333333333332
4570,191,12,179,153,38,0.06282722513089005,0.93717277486911,0.8010471204188482,0.19895287958115182,82,0,27,55,79,3,0.0,0.32926829268292684,0.6707317073170732,0.9634146341463414,0.036585365853658534
4571,124,14,110,83,41,0.11290322580645161,0.8870967741935484,0.6693548387096774,0.33064516129032256,112,0,1,111,108,4,0.0,0.008928571428571428,0.9910714285714286,0.9642857142857143,0.03571428571428571
4572,66,19,47,22,44,0.2878787878787879,0.7121212121212122,0.3333333333333333,0.6666666666666666,150,0,0,150,147,3,0.0,0.0,1.0,0.98,0.02
4573,121,11,110,77,44,0.09090909090909091,0.9090909090909091,0.6363636363636364,0.36363636363636365,104,0,1,103,101,3,0.0,0.009615384615384616,0.9903846153846154,0.9711538461538461,0.028846153846153848
4574,129,19,110,80,49,0.14728682170542637,0.8527131782945736,0.6201550387596899,0.3798449612403101,115,0,2,113,111,4,0.0,0.017391304347826087,0.9826086956521739,0.9652173913043478,0.034782608695652174
4575,40,6,34,31,9,0.15,0.85,0.775,0.225,82,0,11,71,79,3,0.0,0.13414634146341464,0.8658536585365854,0.9634146341463414,0.036585365853658534
4576,119,5,114,90,29,0.04201680672268908,0.957983193277311,0.7563025210084033,0.24369747899159663,109,0,19,90,107,2,0.0,0.1743119266055046,0.8256880733944955,0.981651376146789,0.01834862385321101
4577,198,20,178,151,47,0.10101010101010101,0.898989898989899,0.7626262626262627,0.23737373737373738,151,0,28,123,148,3,0.0,0.18543046357615894,0.8145695364238411,0.9801324503311258,0.019867549668874173
4578,127,15,112,94,33,0.11811023622047244,0.8818897637795275,0.7401574803149606,0.25984251968503935,97,0,20,77,95,2,0.0,0.20618556701030927,0.7938144329896907,0.979381443298969,0.020618556701030927
4579,195,13,182,157,38,0.06666666666666667,0.9333333333333333,0.8051282051282052,0.19487179487179487,137,0,25,112,135,2,0.0,0.18248175182481752,0.8175182481751825,0.9854014598540146,0.014598540145985401
4580,122,12,110,84,38,0.09836065573770492,0.9016393442622951,0.6885245901639344,0.3114754098360656,100,0,1,99,96,4,0.0,0.01,0.99,0.96,0.04
4581,125,14,111,77,48,0.112,0.888,0.616,0.384,108,0,2,106,104,4,0.0,0.018518518518518517,0.9814814814814815,0.9629629629629629,0.037037037037037035
4582,129,19,110,83,46,0.14728682170542637,0.8527131782945736,0.6434108527131783,0.35658914728682173,106,0,1,105,102,4,0.0,0.009433962264150943,0.9905660377358491,0.9622641509433962,0.03773584905660377
4583,106,5,101,93,13,0.04716981132075472,0.9528301886792453,0.8773584905660378,0.12264150943396226,84,0,15,69,82,2,0.0,0.17857142857142858,0.8214285714285714,0.9761904761904762,0.023809523809523808
4584,102,26,76,58,44,0.2549019607843137,0.7450980392156863,0.5686274509803921,0.43137254901960786,112,0,0,112,108,4,0.0,0.0,1.0,0.9642857142857143,0.03571428571428571
4585,92,14,78,66,26,0.15217391304347827,0.8478260869565217,0.717391304347826,0.2826086956521739,80,0,1,79,76,4,0.0,0.0125,0.9875,0.95,0.05
4586,110,5,105,96,14,0.045454545454545456,0.9545454545454546,0.8727272727272727,0.12727272727272726,83,0,13,70,81,2,0.0,0.1566265060240964,0.8433734939759037,0.9759036144578314,0.024096385542168676
4587,94,18,76,57,37,0.19148936170212766,0.8085106382978723,0.6063829787234043,0.39361702127659576,109,0,0,109,106,3,0.0,0.0,1.0,0.9724770642201835,0.027522935779816515
4588,126,16,110,74,52,0.12698412698412698,0.873015873015873,0.5873015873015873,0.4126984126984127,106,0,1,105,102,4,0.0,0.009433962264150943,0.9905660377358491,0.9622641509433962,0.03773584905660377
4589,120,10,110,75,45,0.08333333333333333,0.9166666666666666,0.625,0.375,120,0,1,119,116,4,0.0,0.008333333333333333,0.9916666666666667,0.9666666666666667,0.03333333333333333
4590,127,17,110,83,44,0.13385826771653545,0.8661417322834646,0.6535433070866141,0.3464566929133858,108,0,1,107,104,4,0.0,0.009259259259259259,0.9907407407407407,0.9629629629629629,0.037037037037037035
4591,59,11,48,23,36,0.1864406779661017,0.8135593220338984,0.3898305084745763,0.6101694915254238,145,0,0,145,142,3,0.0,0.0,1.0,0.9793103448275862,0.020689655172413793
4592,61,13,48,28,33,0.21311475409836064,0.7868852459016393,0.45901639344262296,0.5409836065573771,136,0,0,136,134,2,0.0,0.0,1.0,0.9852941176470589,0.014705882352941176
4593,105,14,91,58,47,0.13333333333333333,0.8666666666666667,0.5523809523809524,0.44761904761904764,179,0,54,125,175,4,0.0,0.3016759776536313,0.6983240223463687,0.9776536312849162,0.0223463687150838
4594,86,6,80,66,20,0.06976744186046512,0.9302325581395349,0.7674418604651163,0.23255813953488372,80,0,1,79,76,4,0.0,0.0125,0.9875,0.95,0.05
4595,149,16,133,103,46,0.10738255033557047,0.8926174496644296,0.6912751677852349,0.3087248322147651,126,0,24,102,125,1,0.0,0.19047619047619047,0.8095238095238095,0.9920634920634921,0.007936507936507936
4596,59,15,44,23,36,0.2542372881355932,0.7457627118644068,0.3898305084745763,0.6101694915254238,98,0,30,68,98,0,0.0,0.30612244897959184,0.6938775510204082,1.0,0.0
4597,74,20,54,31,43,0.2702702702702703,0.7297297297297297,0.4189189189189189,0.581081081081081,100,0,32,68,100,0,0.0,0.32,0.68,1.0,0.0
4598,75,6,69,52,23,0.08,0.92,0.6933333333333334,0.30666666666666664,83,0,0,83,79,4,0.0,0.0,1.0,0.9518072289156626,0.04819277108433735
4599,87,11,76,51,36,0.12643678160919541,0.8735632183908046,0.5862068965517241,0.41379310344827586,112,0,0,112,109,3,0.0,0.0,1.0,0.9732142857142857,0.026785714285714284
4600,72,4,68,55,17,0.05555555555555555,0.9444444444444444,0.7638888888888888,0.2361111111111111,74,0,0,74,71,3,0.0,0.0,1.0,0.9594594594594594,0.04054054054054054
4601,218,19,199,173,45,0.0871559633027523,0.9128440366972477,0.7935779816513762,0.20642201834862386,139,0,27,112,136,3,0.0,0.19424460431654678,0.8057553956834532,0.9784172661870504,0.02158273381294964
4602,148,15,133,101,47,0.10135135135135136,0.8986486486486487,0.6824324324324325,0.31756756756756754,137,0,24,113,136,1,0.0,0.17518248175182483,0.8248175182481752,0.9927007299270073,0.0072992700729927005
4603,89,13,76,57,32,0.14606741573033707,0.8539325842696629,0.6404494382022472,0.3595505617977528,114,0,0,114,111,3,0.0,0.0,1.0,0.9736842105263158,0.02631578947368421
4604,123,13,110,89,34,0.10569105691056911,0.8943089430894309,0.7235772357723578,0.2764227642276423,113,0,1,112,109,4,0.0,0.008849557522123894,0.9911504424778761,0.9646017699115044,0.035398230088495575
4605,124,14,110,73,51,0.11290322580645161,0.8870967741935484,0.5887096774193549,0.4112903225806452,116,0,1,115,113,3,0.0,0.008620689655172414,0.9913793103448276,0.9741379310344828,0.02586206896551724
4606,121,12,109,79,42,0.09917355371900827,0.9008264462809917,0.6528925619834711,0.34710743801652894,114,0,1,113,110,4,0.0,0.008771929824561403,0.9912280701754386,0.9649122807017544,0.03508771929824561
4607,195,13,182,155,40,0.06666666666666667,0.9333333333333333,0.7948717948717948,0.20512820512820512,138,0,25,113,135,3,0.0,0.18115942028985507,0.8188405797101449,0.9782608695652174,0.021739130434782608
4608,126,16,110,78,48,0.12698412698412698,0.873015873015873,0.6190476190476191,0.38095238095238093,101,0,1,100,97,4,0.0,0.009900990099009901,0.9900990099009901,0.9603960396039604,0.039603960396039604
4609,198,19,179,154,44,0.09595959595959595,0.9040404040404041,0.7777777777777778,0.2222222222222222,152,0,25,127,149,3,0.0,0.16447368421052633,0.8355263157894737,0.9802631578947368,0.019736842105263157
4610,134,13,121,97,37,0.09701492537313433,0.9029850746268657,0.7238805970149254,0.27611940298507465,107,0,15,92,105,2,0.0,0.14018691588785046,0.8598130841121495,0.9813084112149533,0.018691588785046728
4611,196,18,178,152,44,0.09183673469387756,0.9081632653061225,0.7755102040816326,0.22448979591836735,140,0,26,114,137,3,0.0,0.18571428571428572,0.8142857142857143,0.9785714285714285,0.02142857142857143
4612,163,15,148,109,54,0.09202453987730061,0.9079754601226994,0.6687116564417178,0.3312883435582822,149,0,24,125,148,1,0.0,0.1610738255033557,0.8389261744966443,0.9932885906040269,0.006711409395973154
4613,120,6,114,89,31,0.05,0.95,0.7416666666666667,0.25833333333333336,103,0,16,87,100,3,0.0,0.1553398058252427,0.8446601941747572,0.970873786407767,0.02912621359223301
4614,61,13,48,26,35,0.21311475409836064,0.7868852459016393,0.4262295081967213,0.5737704918032787,135,0,0,135,132,3,0.0,0.0,1.0,0.9777777777777777,0.022222222222222223
4615,58,10,48,28,30,0.1724137931034483,0.8275862068965517,0.4827586206896552,0.5172413793103449,134,0,0,134,132,2,0.0,0.0,1.0,0.9850746268656716,0.014925373134328358
4616,106,4,102,85,21,0.03773584905660377,0.9622641509433962,0.8018867924528302,0.19811320754716982,86,0,10,76,83,3,0.0,0.11627906976744186,0.8837209302325582,0.9651162790697675,0.03488372093023256
4617,110,13,97,71,39,0.11818181818181818,0.8818181818181818,0.6454545454545455,0.35454545454545455,108,0,0,108,105,3,0.0,0.0,1.0,0.9722222222222222,0.027777777777777776
4618,59,12,47,24,35,0.2033898305084746,0.7966101694915254,0.4067796610169492,0.5932203389830508,126,0,0,126,123,3,0.0,0.0,1.0,0.9761904761904762,0.023809523809523808
4619,108,17,91,61,47,0.1574074074074074,0.8425925925925926,0.5648148148148148,0.4351851851851852,173,0,54,119,169,4,0.0,0.31213872832369943,0.6878612716763006,0.976878612716763,0.023121387283236993
4620,195,17,178,151,44,0.08717948717948718,0.9128205128205128,0.7743589743589744,0.22564102564102564,141,0,26,115,138,3,0.0,0.18439716312056736,0.8156028368794326,0.9787234042553191,0.02127659574468085
4621,127,7,120,98,29,0.05511811023622047,0.9448818897637795,0.7716535433070866,0.2283464566929134,102,0,15,87,100,2,0.0,0.14705882352941177,0.8529411764705882,0.9803921568627451,0.0196078431372549
4622,111,16,95,68,43,0.14414414414414414,0.8558558558558559,0.6126126126126126,0.38738738738738737,117,0,0,117,114,3,0.0,0.0,1.0,0.9743589743589743,0.02564102564102564
4623,119,9,110,84,35,0.07563025210084033,0.9243697478991597,0.7058823529411765,0.29411764705882354,106,0,1,105,103,3,0.0,0.009433962264150943,0.9905660377358491,0.9716981132075472,0.02830188679245283
4624,70,6,64,49,21,0.08571428571428572,0.9142857142857143,0.7,0.3,87,0,0,87,83,4,0.0,0.0,1.0,0.9540229885057471,0.04597701149425287
4625,118,5,113,94,24,0.0423728813559322,0.9576271186440678,0.7966101694915254,0.2033898305084746,100,0,16,84,98,2,0.0,0.16,0.84,0.98,0.02
4626,128,6,122,99,29,0.046875,0.953125,0.7734375,0.2265625,101,0,13,88,99,2,0.0,0.12871287128712872,0.8712871287128713,0.9801980198019802,0.019801980198019802
4627,200,20,180,154,46,0.1,0.9,0.77,0.23,144,0,28,116,142,2,0.0,0.19444444444444445,0.8055555555555556,0.9861111111111112,0.013888888888888888
4628,124,15,109,88,36,0.12096774193548387,0.8790322580645161,0.7096774193548387,0.2903225806451613,105,0,1,104,102,3,0.0,0.009523809523809525,0.9904761904761905,0.9714285714285714,0.02857142857142857
4629,198,15,183,157,41,0.07575757575757576,0.9242424242424242,0.7929292929292929,0.20707070707070707,136,0,25,111,134,2,0.0,0.18382352941176472,0.8161764705882353,0.9852941176470589,0.014705882352941176
4630,88,12,76,56,32,0.13636363636363635,0.8636363636363636,0.6363636363636364,0.36363636363636365,106,0,0,106,102,4,0.0,0.0,1.0,0.9622641509433962,0.03773584905660377
4631,111,5,106,98,13,0.04504504504504504,0.954954954954955,0.8828828828828829,0.11711711711711711,84,0,12,72,82,2,0.0,0.14285714285714285,0.8571428571428571,0.9761904761904762,0.023809523809523808
4632,123,14,109,77,46,0.11382113821138211,0.8861788617886179,0.6260162601626016,0.37398373983739835,107,0,1,106,103,4,0.0,0.009345794392523364,0.9906542056074766,0.9626168224299065,0.037383177570093455
4633,121,11,110,76,45,0.09090909090909091,0.9090909090909091,0.628099173553719,0.371900826446281,114,0,1,113,110,4,0.0,0.008771929824561403,0.9912280701754386,0.9649122807017544,0.03508771929824561
4634,73,19,54,30,43,0.2602739726027397,0.7397260273972602,0.410958904109589,0.589041095890411,107,0,30,77,107,0,0.0,0.2803738317757009,0.719626168224299,1.0,0.0
4635,120,6,114,96,24,0.05,0.95,0.8,0.2,101,0,11,90,99,2,0.0,0.10891089108910891,0.8910891089108911,0.9801980198019802,0.019801980198019802
4636,146,17,129,103,43,0.11643835616438356,0.8835616438356164,0.7054794520547946,0.2945205479452055,132,0,25,107,131,1,0.0,0.1893939393939394,0.8106060606060606,0.9924242424242424,0.007575757575757576
4637,193,182,11,190,3,0.9430051813471503,0.05699481865284974,0.9844559585492227,0.015544041450777202,344,0,65,279,122,222,0.0,0.18895348837209303,0.811046511627907,0.3546511627906977,0.6453488372093024
4638,60,13,47,25,35,0.21666666666666667,0.7833333333333333,0.4166666666666667,0.5833333333333334,131,0,0,131,129,2,0.0,0.0,1.0,0.9847328244274809,0.015267175572519083
4639,126,15,111,81,45,0.11904761904761904,0.8809523809523809,0.6428571428571429,0.35714285714285715,103,0,2,101,100,3,0.0,0.019417475728155338,0.9805825242718447,0.970873786407767,0.02912621359223301
4640,39,5,34,31,8,0.1282051282051282,0.8717948717948718,0.7948717948717948,0.20512820512820512,95,0,18,77,92,3,0.0,0.18947368421052632,0.8105263157894737,0.968421052631579,0.031578947368421054
4641,125,15,110,78,47,0.12,0.88,0.624,0.376,115,0,1,114,111,4,0.0,0.008695652173913044,0.991304347826087,0.9652173913043478,0.034782608695652174
4642,71,8,63,35,36,0.11267605633802817,0.8873239436619719,0.49295774647887325,0.5070422535211268,99,0,28,71,99,0,0.0,0.2828282828282828,0.7171717171717171,1.0,0.0
4643,73,10,63,34,39,0.136986301369863,0.863013698630137,0.4657534246575342,0.5342465753424658,88,0,28,60,88,0,0.0,0.3181818181818182,0.6818181818181818,1.0,0.0
4644,122,12,110,76,46,0.09836065573770492,0.9016393442622951,0.6229508196721312,0.3770491803278688,104,0,1,103,100,4,0.0,0.009615384615384616,0.9903846153846154,0.9615384615384616,0.038461538461538464
4645,94,18,76,57,37,0.19148936170212766,0.8085106382978723,0.6063829787234043,0.39361702127659576,109,0,0,109,106,3,0.0,0.0,1.0,0.9724770642201835,0.027522935779816515
4646,122,12,110,75,47,0.09836065573770492,0.9016393442622951,0.6147540983606558,0.38524590163934425,111,0,0,111,108,3,0.0,0.0,1.0,0.972972972972973,0.02702702702702703
4647,147,14,133,109,38,0.09523809523809523,0.9047619047619048,0.7414965986394558,0.2585034013605442,134,0,24,110,133,1,0.0,0.1791044776119403,0.8208955223880597,0.9925373134328358,0.007462686567164179
4648,122,6,116,97,25,0.04918032786885246,0.9508196721311475,0.7950819672131147,0.20491803278688525,103,0,17,86,101,2,0.0,0.1650485436893204,0.8349514563106796,0.9805825242718447,0.019417475728155338
4649,62,15,47,29,33,0.24193548387096775,0.7580645161290323,0.46774193548387094,0.532258064516129,134,0,0,134,132,2,0.0,0.0,1.0,0.9850746268656716,0.014925373134328358
4650,134,13,121,99,35,0.09701492537313433,0.9029850746268657,0.7388059701492538,0.26119402985074625,98,0,11,87,96,2,0.0,0.11224489795918367,0.8877551020408163,0.9795918367346939,0.02040816326530612
4651,58,11,47,28,30,0.1896551724137931,0.8103448275862069,0.4827586206896552,0.5172413793103449,140,0,0,140,137,3,0.0,0.0,1.0,0.9785714285714285,0.02142857142857143
4652,66,19,47,25,41,0.2878787878787879,0.7121212121212122,0.3787878787878788,0.6212121212121212,134,0,0,134,131,3,0.0,0.0,1.0,0.9776119402985075,0.022388059701492536
4653,52,8,44,26,26,0.15384615384615385,0.8461538461538461,0.5,0.5,106,0,30,76,106,0,0.0,0.2830188679245283,0.7169811320754716,1.0,0.0
4654,76,10,66,41,35,0.13157894736842105,0.868421052631579,0.5394736842105263,0.4605263157894737,95,0,28,67,95,0,0.0,0.29473684210526313,0.7052631578947368,1.0,0.0
4655,121,9,112,91,30,0.0743801652892562,0.9256198347107438,0.7520661157024794,0.24793388429752067,108,0,20,88,106,2,0.0,0.18518518518518517,0.8148148148148148,0.9814814814814815,0.018518518518518517
4656,86,10,76,54,32,0.11627906976744186,0.8837209302325582,0.627906976744186,0.37209302325581395,110,0,0,110,107,3,0.0,0.0,1.0,0.9727272727272728,0.02727272727272727
4657,117,11,106,80,37,0.09401709401709402,0.905982905982906,0.6837606837606838,0.3162393162393162,111,0,18,93,109,2,0.0,0.16216216216216217,0.8378378378378378,0.9819819819819819,0.018018018018018018
4658,197,17,180,156,41,0.08629441624365482,0.9137055837563451,0.7918781725888325,0.20812182741116753,140,0,25,115,137,3,0.0,0.17857142857142858,0.8214285714285714,0.9785714285714285,0.02142857142857143
4659,93,17,76,54,39,0.1827956989247312,0.8172043010752689,0.5806451612903226,0.41935483870967744,107,0,0,107,103,4,0.0,0.0,1.0,0.9626168224299065,0.037383177570093455
4660,68,14,54,25,43,0.20588235294117646,0.7941176470588235,0.36764705882352944,0.6323529411764706,103,0,32,71,103,0,0.0,0.3106796116504854,0.6893203883495146,1.0,0.0
4661,73,10,63,50,23,0.136986301369863,0.863013698630137,0.684931506849315,0.3150684931506849,75,0,0,75,71,4,0.0,0.0,1.0,0.9466666666666667,0.05333333333333334
4662,94,18,76,53,41,0.19148936170212766,0.8085106382978723,0.5638297872340425,0.43617021276595747,117,0,0,117,114,3,0.0,0.0,1.0,0.9743589743589743,0.02564102564102564
4663,128,18,110,81,47,0.140625,0.859375,0.6328125,0.3671875,110,0,0,110,107,3,0.0,0.0,1.0,0.9727272727272728,0.02727272727272727
4664,121,11,110,73,48,0.09090909090909091,0.9090909090909091,0.6033057851239669,0.39669421487603307,94,0,1,93,90,4,0.0,0.010638297872340425,0.9893617021276596,0.9574468085106383,0.0425531914893617
4665,70,16,54,28,42,0.22857142857142856,0.7714285714285715,0.4,0.6,111,0,32,79,111,0,0.0,0.2882882882882883,0.7117117117117117,1.0,0.0
4666,90,14,76,55,35,0.15555555555555556,0.8444444444444444,0.6111111111111112,0.3888888888888889,109,0,0,109,105,4,0.0,0.0,1.0,0.963302752293578,0.03669724770642202
4667,195,15,180,149,46,0.07692307692307693,0.9230769230769231,0.764102564102564,0.2358974358974359,140,0,26,114,137,3,0.0,0.18571428571428572,0.8142857142857143,0.9785714285714285,0.02142857142857143
4668,125,15,110,84,41,0.12,0.88,0.672,0.328,109,0,1,108,105,4,0.0,0.009174311926605505,0.9908256880733946,0.963302752293578,0.03669724770642202
4669,105,5,100,85,20,0.047619047619047616,0.9523809523809523,0.8095238095238095,0.19047619047619047,89,0,14,75,87,2,0.0,0.15730337078651685,0.8426966292134831,0.9775280898876404,0.02247191011235955
4670,198,18,180,156,42,0.09090909090909091,0.9090909090909091,0.7878787878787878,0.21212121212121213,138,0,24,114,136,2,0.0,0.17391304347826086,0.8260869565217391,0.9855072463768116,0.014492753623188406
4671,123,13,110,72,51,0.10569105691056911,0.8943089430894309,0.5853658536585366,0.4146341463414634,123,0,1,122,119,4,0.0,0.008130081300813009,0.991869918699187,0.967479674796748,0.032520325203252036
4672,63,16,47,26,37,0.25396825396825395,0.746031746031746,0.4126984126984127,0.5873015873015873,132,0,0,132,130,2,0.0,0.0,1.0,0.9848484848484849,0.015151515151515152
4673,115,7,108,97,18,0.06086956521739131,0.9391304347826087,0.8434782608695652,0.1565217391304348,80,0,7,73,78,2,0.0,0.0875,0.9125,0.975,0.025
4674,113,3,110,93,20,0.02654867256637168,0.9734513274336283,0.8230088495575221,0.17699115044247787,86,0,10,76,84,2,0.0,0.11627906976744186,0.8837209302325582,0.9767441860465116,0.023255813953488372
4675,47,13,34,16,31,0.2765957446808511,0.723404255319149,0.3404255319148936,0.6595744680851063,85,0,30,55,85,0,0.0,0.35294117647058826,0.6470588235294118,1.0,0.0
4676,56,9,47,26,30,0.16071428571428573,0.8392857142857143,0.4642857142857143,0.5357142857142857,141,0,0,141,139,2,0.0,0.0,1.0,0.9858156028368794,0.014184397163120567
4677,172,24,148,107,65,0.13953488372093023,0.8604651162790697,0.622093023255814,0.37790697674418605,146,0,24,122,145,1,0.0,0.1643835616438356,0.8356164383561644,0.9931506849315068,0.00684931506849315
4678,115,19,96,69,46,0.16521739130434782,0.8347826086956521,0.6,0.4,112,0,0,112,109,3,0.0,0.0,1.0,0.9732142857142857,0.026785714285714284
4679,86,10,76,60,26,0.11627906976744186,0.8837209302325582,0.6976744186046512,0.3023255813953488,106,0,0,106,103,3,0.0,0.0,1.0,0.9716981132075472,0.02830188679245283
4680,119,9,110,86,33,0.07563025210084033,0.9243697478991597,0.7226890756302521,0.2773109243697479,111,0,1,110,107,4,0.0,0.009009009009009009,0.990990990990991,0.963963963963964,0.036036036036036036
4681,60,12,48,25,35,0.2,0.8,0.4166666666666667,0.5833333333333334,144,0,0,144,141,3,0.0,0.0,1.0,0.9791666666666666,0.020833333333333332
4682,125,15,110,80,45,0.12,0.88,0.64,0.36,105,0,1,104,102,3,0.0,0.009523809523809525,0.9904761904761905,0.9714285714285714,0.02857142857142857
4683,74,10,64,37,37,0.13513513513513514,0.8648648648648649,0.5,0.5,94,0,31,63,94,0,0.0,0.32978723404255317,0.6702127659574468,1.0,0.0
4684,111,7,104,84,27,0.06306306306306306,0.9369369369369369,0.7567567567567568,0.24324324324324326,89,0,14,75,87,2,0.0,0.15730337078651685,0.8426966292134831,0.9775280898876404,0.02247191011235955
4685,121,11,110,79,42,0.09090909090909091,0.9090909090909091,0.6528925619834711,0.34710743801652894,106,0,1,105,103,3,0.0,0.009433962264150943,0.9905660377358491,0.9716981132075472,0.02830188679245283
4686,130,21,109,82,48,0.16153846153846155,0.8384615384615385,0.6307692307692307,0.36923076923076925,114,0,1,113,110,4,0.0,0.008771929824561403,0.9912280701754386,0.9649122807017544,0.03508771929824561
4687,125,15,110,81,44,0.12,0.88,0.648,0.352,111,0,1,110,108,3,0.0,0.009009009009009009,0.990990990990991,0.972972972972973,0.02702702702702703
4688,63,9,54,27,36,0.14285714285714285,0.8571428571428571,0.42857142857142855,0.5714285714285714,98,0,30,68,98,0,0.0,0.30612244897959184,0.6938775510204082,1.0,0.0
4689,124,14,110,75,49,0.11290322580645161,0.8870967741935484,0.6048387096774194,0.3951612903225806,127,0,1,126,123,4,0.0,0.007874015748031496,0.9921259842519685,0.968503937007874,0.031496062992125984
4690,73,9,64,41,32,0.1232876712328767,0.8767123287671232,0.5616438356164384,0.4383561643835616,100,0,30,70,100,0,0.0,0.3,0.7,1.0,0.0
4691,115,6,109,93,22,0.05217391304347826,0.9478260869565217,0.808695652173913,0.19130434782608696,81,0,9,72,79,2,0.0,0.1111111111111111,0.8888888888888888,0.9753086419753086,0.024691358024691357
4692,69,15,54,31,38,0.21739130434782608,0.782608695652174,0.4492753623188406,0.5507246376811594,99,0,30,69,99,0,0.0,0.30303030303030304,0.696969696969697,1.0,0.0
4693,195,15,180,153,42,0.07692307692307693,0.9230769230769231,0.7846153846153846,0.2153846153846154,139,0,28,111,136,3,0.0,0.2014388489208633,0.7985611510791367,0.9784172661870504,0.02158273381294964
4694,126,16,110,77,49,0.12698412698412698,0.873015873015873,0.6111111111111112,0.3888888888888889,112,0,1,111,108,4,0.0,0.008928571428571428,0.9910714285714286,0.9642857142857143,0.03571428571428571
4695,110,11,99,82,28,0.1,0.9,0.7454545454545455,0.2545454545454545,87,0,18,69,85,2,0.0,0.20689655172413793,0.7931034482758621,0.9770114942528736,0.022988505747126436
4696,113,13,100,72,41,0.11504424778761062,0.8849557522123894,0.6371681415929203,0.36283185840707965,131,0,0,131,128,3,0.0,0.0,1.0,0.9770992366412213,0.022900763358778626
4697,123,12,111,78,45,0.0975609756097561,0.9024390243902439,0.6341463414634146,0.36585365853658536,110,0,2,108,106,4,0.0,0.01818181818181818,0.9818181818181818,0.9636363636363636,0.03636363636363636
4698,120,10,110,81,39,0.08333333333333333,0.9166666666666666,0.675,0.325,106,0,1,105,102,4,0.0,0.009433962264150943,0.9905660377358491,0.9622641509433962,0.03773584905660377
4699,109,6,103,86,23,0.05504587155963303,0.944954128440367,0.7889908256880734,0.21100917431192662,92,0,12,80,90,2,0.0,0.13043478260869565,0.8695652173913043,0.9782608695652174,0.021739130434782608
4700,121,11,110,79,42,0.09090909090909091,0.9090909090909091,0.6528925619834711,0.34710743801652894,100,0,1,99,97,3,0.0,0.01,0.99,0.97,0.03
4701,201,21,180,156,45,0.1044776119402985,0.8955223880597015,0.7761194029850746,0.22388059701492538,140,0,29,111,137,3,0.0,0.20714285714285716,0.7928571428571428,0.9785714285714285,0.02142857142857143
4702,125,14,111,88,37,0.112,0.888,0.704,0.296,112,0,2,110,108,4,0.0,0.017857142857142856,0.9821428571428571,0.9642857142857143,0.03571428571428571
4703,83,18,65,41,42,0.21686746987951808,0.7831325301204819,0.4939759036144578,0.5060240963855421,96,0,30,66,96,0,0.0,0.3125,0.6875,1.0,0.0
4704,109,18,91,63,46,0.1651376146788991,0.8348623853211009,0.5779816513761468,0.42201834862385323,171,0,54,117,168,3,0.0,0.3157894736842105,0.6842105263157895,0.9824561403508771,0.017543859649122806
4705,92,16,76,54,38,0.17391304347826086,0.8260869565217391,0.5869565217391305,0.41304347826086957,116,0,0,116,113,3,0.0,0.0,1.0,0.9741379310344828,0.02586206896551724
4706,91,15,76,53,38,0.16483516483516483,0.8351648351648352,0.5824175824175825,0.4175824175824176,117,0,0,117,113,4,0.0,0.0,1.0,0.9658119658119658,0.03418803418803419
4707,123,8,115,88,35,0.06504065040650407,0.9349593495934959,0.7154471544715447,0.2845528455284553,102,0,17,85,100,2,0.0,0.16666666666666666,0.8333333333333334,0.9803921568627451,0.0196078431372549
4708,90,14,76,53,37,0.15555555555555556,0.8444444444444444,0.5888888888888889,0.4111111111111111,99,0,0,99,96,3,0.0,0.0,1.0,0.9696969696969697,0.030303030303030304
4709,72,18,54,28,44,0.25,0.75,0.3888888888888889,0.6111111111111112,106,0,30,76,106,0,0.0,0.2830188679245283,0.7169811320754716,1.0,0.0
4710,126,16,110,79,47,0.12698412698412698,0.873015873015873,0.626984126984127,0.373015873015873,108,0,1,107,104,4,0.0,0.009259259259259259,0.9907407407407407,0.9629629629629629,0.037037037037037035
4711,123,13,110,86,37,0.10569105691056911,0.8943089430894309,0.6991869918699187,0.3008130081300813,116,0,1,115,112,4,0.0,0.008620689655172414,0.9913793103448276,0.9655172413793104,0.034482758620689655
4712,135,120,15,132,3,0.8888888888888888,0.1111111111111111,0.9777777777777777,0.022222222222222223,316,0,30,286,86,230,0.0,0.0949367088607595,0.9050632911392406,0.2721518987341772,0.7278481012658228
4713,121,11,110,80,41,0.09090909090909091,0.9090909090909091,0.6611570247933884,0.33884297520661155,103,0,1,102,99,4,0.0,0.009708737864077669,0.9902912621359223,0.9611650485436893,0.038834951456310676
4714,75,21,54,28,47,0.28,0.72,0.37333333333333335,0.6266666666666667,103,0,31,72,103,0,0.0,0.30097087378640774,0.6990291262135923,1.0,0.0
4715,192,11,181,150,42,0.057291666666666664,0.9427083333333334,0.78125,0.21875,143,0,28,115,140,3,0.0,0.1958041958041958,0.8041958041958042,0.9790209790209791,0.02097902097902098
4716,122,12,110,81,41,0.09836065573770492,0.9016393442622951,0.6639344262295082,0.3360655737704918,113,0,0,113,110,3,0.0,0.0,1.0,0.9734513274336283,0.02654867256637168
4717,60,13,47,29,31,0.21666666666666667,0.7833333333333333,0.48333333333333334,0.5166666666666667,151,0,0,151,148,3,0.0,0.0,1.0,0.9801324503311258,0.019867549668874173
4718,122,12,110,79,43,0.09836065573770492,0.9016393442622951,0.6475409836065574,0.3524590163934426,110,0,1,109,106,4,0.0,0.00909090909090909,0.990909090909091,0.9636363636363636,0.03636363636363636
4719,109,8,101,92,17,0.07339449541284404,0.926605504587156,0.8440366972477065,0.1559633027522936,89,0,15,74,87,2,0.0,0.16853932584269662,0.8314606741573034,0.9775280898876404,0.02247191011235955
4720,77,23,54,31,46,0.2987012987012987,0.7012987012987013,0.4025974025974026,0.5974025974025974,100,0,30,70,100,0,0.0,0.3,0.7,1.0,0.0
4721,116,16,100,71,45,0.13793103448275862,0.8620689655172413,0.6120689655172413,0.3879310344827586,130,0,0,130,126,4,0.0,0.0,1.0,0.9692307692307692,0.03076923076923077
4722,117,18,99,72,45,0.15384615384615385,0.8461538461538461,0.6153846153846154,0.38461538461538464,122,0,1,121,118,4,0.0,0.00819672131147541,0.9918032786885246,0.9672131147540983,0.03278688524590164
4723,93,9,84,60,33,0.0967741935483871,0.9032258064516129,0.6451612903225806,0.3548387096774194,88,0,1,87,84,4,0.0,0.011363636363636364,0.9886363636363636,0.9545454545454546,0.045454545454545456
4724,121,11,110,73,48,0.09090909090909091,0.9090909090909091,0.6033057851239669,0.39669421487603307,95,0,1,94,91,4,0.0,0.010526315789473684,0.9894736842105263,0.9578947368421052,0.042105263157894736
4725,127,16,111,84,43,0.12598425196850394,0.8740157480314961,0.6614173228346457,0.33858267716535434,109,0,2,107,105,4,0.0,0.01834862385321101,0.981651376146789,0.963302752293578,0.03669724770642202
4726,125,14,111,78,47,0.112,0.888,0.624,0.376,111,0,2,109,107,4,0.0,0.018018018018018018,0.9819819819819819,0.963963963963964,0.036036036036036036
4727,39,5,34,32,7,0.1282051282051282,0.8717948717948718,0.8205128205128205,0.1794871794871795,84,0,16,68,81,3,0.0,0.19047619047619047,0.8095238095238095,0.9642857142857143,0.03571428571428571
4728,111,8,103,88,23,0.07207207207207207,0.9279279279279279,0.7927927927927928,0.2072072072072072,92,0,16,76,90,2,0.0,0.17391304347826086,0.8260869565217391,0.9782608695652174,0.021739130434782608
4729,121,6,115,90,31,0.049586776859504134,0.9504132231404959,0.743801652892562,0.256198347107438,98,0,17,81,96,2,0.0,0.17346938775510204,0.826530612244898,0.9795918367346939,0.02040816326530612
4730,0,0,0,0,0,0.0,0.0,0.0,0.0,0,0,0,0,0,0,0.0,0.0,0.0,0.0,0.0
4731,57,10,47,25,32,0.17543859649122806,0.8245614035087719,0.43859649122807015,0.5614035087719298,128,0,0,128,125,3,0.0,0.0,1.0,0.9765625,0.0234375
4732,62,8,54,27,35,0.12903225806451613,0.8709677419354839,0.43548387096774194,0.5645161290322581,101,0,30,71,101,0,0.0,0.297029702970297,0.7029702970297029,1.0,0.0
4733,109,6,103,85,24,0.05504587155963303,0.944954128440367,0.7798165137614679,0.22018348623853212,94,0,14,80,92,2,0.0,0.14893617021276595,0.851063829787234,0.9787234042553191,0.02127659574468085
4734,214,19,195,168,46,0.08878504672897196,0.9112149532710281,0.7850467289719626,0.21495327102803738,142,0,26,116,139,3,0.0,0.18309859154929578,0.8169014084507042,0.9788732394366197,0.02112676056338028
4735,194,13,181,155,39,0.06701030927835051,0.9329896907216495,0.7989690721649485,0.20103092783505155,134,0,26,108,132,2,0.0,0.19402985074626866,0.8059701492537313,0.9850746268656716,0.014925373134328358
4736,57,10,47,24,33,0.17543859649122806,0.8245614035087719,0.42105263157894735,0.5789473684210527,148,0,0,148,145,3,0.0,0.0,1.0,0.9797297297297297,0.02027027027027027
4737,119,9,110,83,36,0.07563025210084033,0.9243697478991597,0.6974789915966386,0.3025210084033613,111,0,1,110,107,4,0.0,0.009009009009009009,0.990990990990991,0.963963963963964,0.036036036036036036
4738,108,12,96,68,40,0.1111111111111111,0.8888888888888888,0.6296296296296297,0.37037037037037035,118,0,0,118,115,3,0.0,0.0,1.0,0.9745762711864406,0.025423728813559324
4739,124,14,110,81,43,0.11290322580645161,0.8870967741935484,0.6532258064516129,0.3467741935483871,115,0,1,114,111,4,0.0,0.008695652173913044,0.991304347826087,0.9652173913043478,0.034782608695652174
4740,127,17,110,80,47,0.13385826771653545,0.8661417322834646,0.6299212598425197,0.3700787401574803,107,0,0,107,103,4,0.0,0.0,1.0,0.9626168224299065,0.037383177570093455
4741,61,14,47,25,36,0.22950819672131148,0.7704918032786885,0.4098360655737705,0.5901639344262295,145,0,0,145,142,3,0.0,0.0,1.0,0.9793103448275862,0.020689655172413793
4742,160,17,143,110,50,0.10625,0.89375,0.6875,0.3125,143,0,24,119,142,1,0.0,0.16783216783216784,0.8321678321678322,0.993006993006993,0.006993006993006993
4743,126,15,111,78,48,0.11904761904761904,0.8809523809523809,0.6190476190476191,0.38095238095238093,108,0,2,106,104,4,0.0,0.018518518518518517,0.9814814814814815,0.9629629629629629,0.037037037037037035
4744,125,15,110,84,41,0.12,0.88,0.672,0.328,113,0,1,112,109,4,0.0,0.008849557522123894,0.9911504424778761,0.9646017699115044,0.035398230088495575
4745,76,22,54,27,49,0.2894736842105263,0.7105263157894737,0.35526315789473684,0.6447368421052632,104,0,30,74,104,0,0.0,0.28846153846153844,0.7115384615384616,1.0,0.0
4746,199,16,183,157,42,0.08040201005025126,0.9195979899497487,0.7889447236180904,0.21105527638190955,152,0,26,126,149,3,0.0,0.17105263157894737,0.8289473684210527,0.9802631578947368,0.019736842105263157
4747,131,8,123,99,32,0.061068702290076333,0.9389312977099237,0.7557251908396947,0.24427480916030533,92,0,11,81,90,2,0.0,0.11956521739130435,0.8804347826086957,0.9782608695652174,0.021739130434782608
4748,164,21,143,112,52,0.12804878048780488,0.8719512195121951,0.6829268292682927,0.3170731707317073,144,0,24,120,143,1,0.0,0.16666666666666666,0.8333333333333334,0.9930555555555556,0.006944444444444444
4749,62,14,48,23,39,0.22580645161290322,0.7741935483870968,0.3709677419354839,0.6290322580645161,130,0,0,130,128,2,0.0,0.0,1.0,0.9846153846153847,0.015384615384615385
4750,111,17,94,67,44,0.15315315315315314,0.8468468468468469,0.6036036036036037,0.3963963963963964,115,0,0,115,112,3,0.0,0.0,1.0,0.9739130434782609,0.02608695652173913
4751,107,10,97,75,32,0.09345794392523364,0.9065420560747663,0.7009345794392523,0.29906542056074764,111,0,0,111,107,4,0.0,0.0,1.0,0.963963963963964,0.036036036036036036
4752,111,11,100,74,37,0.0990990990990991,0.9009009009009009,0.6666666666666666,0.3333333333333333,130,0,0,130,128,2,0.0,0.0,1.0,0.9846153846153847,0.015384615384615385
4753,39,5,34,31,8,0.1282051282051282,0.8717948717948718,0.7948717948717948,0.20512820512820512,86,0,17,69,83,3,0.0,0.19767441860465115,0.8023255813953488,0.9651162790697675,0.03488372093023256
4754,91,15,76,55,36,0.16483516483516483,0.8351648351648352,0.6043956043956044,0.3956043956043956,110,0,0,110,107,3,0.0,0.0,1.0,0.9727272727272728,0.02727272727272727
4755,91,15,76,56,35,0.16483516483516483,0.8351648351648352,0.6153846153846154,0.38461538461538464,125,0,0,125,122,3,0.0,0.0,1.0,0.976,0.024
4756,124,6,118,105,19,0.04838709677419355,0.9516129032258065,0.8467741935483871,0.1532258064516129,100,0,14,86,98,2,0.0,0.14,0.86,0.98,0.02
4757,83,16,67,40,43,0.1927710843373494,0.8072289156626506,0.4819277108433735,0.5180722891566265,102,0,32,70,102,0,0.0,0.3137254901960784,0.6862745098039216,1.0,0.0
4758,116,6,110,91,25,0.05172413793103448,0.9482758620689655,0.7844827586206896,0.21551724137931033,82,0,9,73,80,2,0.0,0.10975609756097561,0.8902439024390244,0.975609756097561,0.024390243902439025
4759,166,18,148,114,52,0.10843373493975904,0.891566265060241,0.6867469879518072,0.3132530120481928,142,1,24,117,141,1,0.007042253521126761,0.16901408450704225,0.823943661971831,0.9929577464788732,0.007042253521126761
4760,149,16,133,108,41,0.10738255033557047,0.8926174496644296,0.7248322147651006,0.2751677852348993,129,0,24,105,128,1,0.0,0.18604651162790697,0.813953488372093,0.9922480620155039,0.007751937984496124
4761,146,13,133,103,43,0.08904109589041095,0.910958904109589,0.7054794520547946,0.2945205479452055,142,0,24,118,141,1,0.0,0.16901408450704225,0.8309859154929577,0.9929577464788732,0.007042253521126761
4762,143,11,132,105,38,0.07692307692307693,0.9230769230769231,0.7342657342657343,0.26573426573426573,140,0,24,116,139,1,0.0,0.17142857142857143,0.8285714285714286,0.9928571428571429,0.007142857142857143
4763,122,12,110,82,40,0.09836065573770492,0.9016393442622951,0.6721311475409836,0.32786885245901637,111,0,1,110,108,3,0.0,0.009009009009009009,0.990990990990991,0.972972972972973,0.02702702702702703
4764,88,12,76,56,32,0.13636363636363635,0.8636363636363636,0.6363636363636364,0.36363636363636365,104,0,0,104,101,3,0.0,0.0,1.0,0.9711538461538461,0.028846153846153848
4765,93,17,76,54,39,0.1827956989247312,0.8172043010752689,0.5806451612903226,0.41935483870967744,113,0,0,113,109,4,0.0,0.0,1.0,0.9646017699115044,0.035398230088495575
4766,58,11,47,24,34,0.1896551724137931,0.8103448275862069,0.41379310344827586,0.5862068965517241,139,0,0,139,136,3,0.0,0.0,1.0,0.9784172661870504,0.02158273381294964
4767,166,18,148,117,49,0.10843373493975904,0.891566265060241,0.7048192771084337,0.29518072289156627,145,0,24,121,144,1,0.0,0.16551724137931034,0.8344827586206897,0.993103448275862,0.006896551724137931
4768,92,16,76,55,37,0.17391304347826086,0.8260869565217391,0.5978260869565217,0.40217391304347827,106,0,0,106,102,4,0.0,0.0,1.0,0.9622641509433962,0.03773584905660377
4769,123,12,111,82,41,0.0975609756097561,0.9024390243902439,0.6666666666666666,0.3333333333333333,116,0,1,115,112,4,0.0,0.008620689655172414,0.9913793103448276,0.9655172413793104,0.034482758620689655
4770,197,16,181,154,43,0.08121827411167512,0.9187817258883249,0.7817258883248731,0.2182741116751269,140,0,26,114,137,3,0.0,0.18571428571428572,0.8142857142857143,0.9785714285714285,0.02142857142857143
4771,89,13,76,57,32,0.14606741573033707,0.8539325842696629,0.6404494382022472,0.3595505617977528,109,0,0,109,105,4,0.0,0.0,1.0,0.963302752293578,0.03669724770642202
4772,169,21,148,112,57,0.1242603550295858,0.8757396449704142,0.6627218934911243,0.33727810650887574,153,0,24,129,152,1,0.0,0.1568627450980392,0.8431372549019608,0.9934640522875817,0.006535947712418301
4773,118,9,109,77,41,0.07627118644067797,0.923728813559322,0.652542372881356,0.3474576271186441,123,0,1,122,119,4,0.0,0.008130081300813009,0.991869918699187,0.967479674796748,0.032520325203252036
4774,122,9,113,95,27,0.07377049180327869,0.9262295081967213,0.7786885245901639,0.22131147540983606,101,0,14,87,99,2,0.0,0.13861386138613863,0.8613861386138614,0.9801980198019802,0.019801980198019802
4775,189,8,181,152,37,0.042328042328042326,0.9576719576719577,0.8042328042328042,0.19576719576719576,142,0,25,117,139,3,0.0,0.176056338028169,0.823943661971831,0.9788732394366197,0.02112676056338028
4776,57,10,47,28,29,0.17543859649122806,0.8245614035087719,0.49122807017543857,0.5087719298245614,145,0,0,145,143,2,0.0,0.0,1.0,0.9862068965517241,0.013793103448275862
4777,136,12,124,99,37,0.08823529411764706,0.9117647058823529,0.7279411764705882,0.27205882352941174,99,0,11,88,97,2,0.0,0.1111111111111111,0.8888888888888888,0.9797979797979798,0.020202020202020204
4778,194,16,178,152,42,0.08247422680412371,0.9175257731958762,0.7835051546391752,0.21649484536082475,144,0,26,118,141,3,0.0,0.18055555555555555,0.8194444444444444,0.9791666666666666,0.020833333333333332
4779,122,12,110,82,40,0.09836065573770492,0.9016393442622951,0.6721311475409836,0.32786885245901637,112,0,1,111,108,4,0.0,0.008928571428571428,0.9910714285714286,0.9642857142857143,0.03571428571428571
4780,129,9,120,99,30,0.06976744186046512,0.9302325581395349,0.7674418604651163,0.23255813953488372,95,0,8,87,93,2,0.0,0.08421052631578947,0.9157894736842105,0.9789473684210527,0.021052631578947368
4781,123,14,109,89,34,0.11382113821138211,0.8861788617886179,0.7235772357723578,0.2764227642276423,108,0,1,107,104,4,0.0,0.009259259259259259,0.9907407407407407,0.9629629629629629,0.037037037037037035
4782,74,20,54,27,47,0.2702702702702703,0.7297297297297297,0.36486486486486486,0.6351351351351351,108,0,30,78,108,0,0.0,0.2777777777777778,0.7222222222222222,1.0,0.0
4783,120,10,110,80,40,0.08333333333333333,0.9166666666666666,0.6666666666666666,0.3333333333333333,109,0,1,108,105,4,0.0,0.009174311926605505,0.9908256880733946,0.963302752293578,0.03669724770642202
4784,109,6,103,86,23,0.05504587155963303,0.944954128440367,0.7889908256880734,0.21100917431192662,97,0,14,83,95,2,0.0,0.14432989690721648,0.8556701030927835,0.979381443298969,0.020618556701030927
4785,90,8,82,59,31,0.08888888888888889,0.9111111111111111,0.6555555555555556,0.34444444444444444,83,0,1,82,79,4,0.0,0.012048192771084338,0.9879518072289156,0.9518072289156626,0.04819277108433735
4786,112,21,91,63,49,0.1875,0.8125,0.5625,0.4375,182,0,54,128,180,2,0.0,0.2967032967032967,0.7032967032967034,0.989010989010989,0.01098901098901099
4787,74,20,54,28,46,0.2702702702702703,0.7297297297297297,0.3783783783783784,0.6216216216216216,99,0,32,67,99,0,0.0,0.32323232323232326,0.6767676767676768,1.0,0.0
4788,122,12,110,72,50,0.09836065573770492,0.9016393442622951,0.5901639344262295,0.4098360655737705,94,0,1,93,90,4,0.0,0.010638297872340425,0.9893617021276596,0.9574468085106383,0.0425531914893617
4789,111,14,97,75,36,0.12612612612612611,0.8738738738738738,0.6756756756756757,0.32432432432432434,111,0,0,111,108,3,0.0,0.0,1.0,0.972972972972973,0.02702702702702703
4790,114,12,102,74,40,0.10526315789473684,0.8947368421052632,0.6491228070175439,0.3508771929824561,122,0,0,122,120,2,0.0,0.0,1.0,0.9836065573770492,0.01639344262295082
4791,197,18,179,155,42,0.09137055837563451,0.9086294416243654,0.7868020304568528,0.2131979695431472,137,0,24,113,135,2,0.0,0.17518248175182483,0.8248175182481752,0.9854014598540146,0.014598540145985401
4792,115,24,91,49,66,0.20869565217391303,0.7913043478260869,0.4260869565217391,0.5739130434782609,181,0,54,127,178,3,0.0,0.2983425414364641,0.7016574585635359,0.9834254143646409,0.016574585635359115
4793,88,12,76,59,29,0.13636363636363635,0.8636363636363636,0.6704545454545454,0.32954545454545453,89,0,1,88,85,4,0.0,0.011235955056179775,0.9887640449438202,0.9550561797752809,0.0449438202247191
4794,83,16,67,43,40,0.1927710843373494,0.8072289156626506,0.5180722891566265,0.4819277108433735,94,0,28,66,94,0,0.0,0.2978723404255319,0.7021276595744681,1.0,0.0
4795,77,14,63,40,37,0.18181818181818182,0.8181818181818182,0.5194805194805194,0.4805194805194805,98,0,28,70,98,0,0.0,0.2857142857142857,0.7142857142857143,1.0,0.0
4796,42,6,36,34,8,0.14285714285714285,0.8571428571428571,0.8095238095238095,0.19047619047619047,84,0,17,67,81,3,0.0,0.20238095238095238,0.7976190476190477,0.9642857142857143,0.03571428571428571
4797,121,11,110,77,44,0.09090909090909091,0.9090909090909091,0.6363636363636364,0.36363636363636365,94,0,1,93,91,3,0.0,0.010638297872340425,0.9893617021276596,0.9680851063829787,0.031914893617021274
4798,105,15,90,54,51,0.14285714285714285,0.8571428571428571,0.5142857142857142,0.4857142857142857,184,0,54,130,181,3,0.0,0.29347826086956524,0.7065217391304348,0.9836956521739131,0.016304347826086956
4799,68,14,54,28,40,0.20588235294117646,0.7941176470588235,0.4117647058823529,0.5882352941176471,98,0,30,68,98,0,0.0,0.30612244897959184,0.6938775510204082,1.0,0.0
4800,76,8,68,48,28,0.10526315789473684,0.8947368421052632,0.631578947368421,0.3684210526315789,78,0,0,78,74,4,0.0,0.0,1.0,0.9487179487179487,0.05128205128205128
4801,113,22,91,59,54,0.19469026548672566,0.8053097345132744,0.5221238938053098,0.4778761061946903,180,0,54,126,178,2,0.0,0.3,0.7,0.9888888888888889,0.011111111111111112
4802,195,12,183,154,41,0.06153846153846154,0.9384615384615385,0.7897435897435897,0.21025641025641026,128,0,25,103,125,3,0.0,0.1953125,0.8046875,0.9765625,0.0234375
4803,129,18,111,88,41,0.13953488372093023,0.8604651162790697,0.6821705426356589,0.3178294573643411,113,0,2,111,110,3,0.0,0.017699115044247787,0.9823008849557522,0.9734513274336283,0.02654867256637168
4804,127,6,121,99,28,0.047244094488188976,0.952755905511811,0.7795275590551181,0.2204724409448819,96,0,9,87,94,2,0.0,0.09375,0.90625,0.9791666666666666,0.020833333333333332
4805,70,5,65,50,20,0.07142857142857142,0.9285714285714286,0.7142857142857143,0.2857142857142857,79,0,0,79,75,4,0.0,0.0,1.0,0.9493670886075949,0.05063291139240506
4806,219,21,198,171,48,0.0958904109589041,0.9041095890410958,0.7808219178082192,0.2191780821917808,139,0,24,115,136,3,0.0,0.17266187050359713,0.8273381294964028,0.9784172661870504,0.02158273381294964
4807,115,15,100,70,45,0.13043478260869565,0.8695652173913043,0.6086956521739131,0.391304347826087,118,0,0,118,115,3,0.0,0.0,1.0,0.9745762711864406,0.025423728813559324
4808,75,14,61,35,40,0.18666666666666668,0.8133333333333334,0.4666666666666667,0.5333333333333333,98,0,30,68,98,0,0.0,0.30612244897959184,0.6938775510204082,1.0,0.0
4809,120,11,109,80,40,0.09166666666666666,0.9083333333333333,0.6666666666666666,0.3333333333333333,108,0,1,107,104,4,0.0,0.009259259259259259,0.9907407407407407,0.9629629629629629,0.037037037037037035
4810,37,3,34,30,7,0.08108108108108109,0.918918918918919,0.8108108108108109,0.1891891891891892,87,0,12,75,84,3,0.0,0.13793103448275862,0.8620689655172413,0.9655172413793104,0.034482758620689655
4811,111,8,103,90,21,0.07207207207207207,0.9279279279279279,0.8108108108108109,0.1891891891891892,83,0,9,74,81,2,0.0,0.10843373493975904,0.891566265060241,0.9759036144578314,0.024096385542168676
4812,185,8,177,154,31,0.043243243243243246,0.9567567567567568,0.8324324324324325,0.16756756756756758,150,0,28,122,147,3,0.0,0.18666666666666668,0.8133333333333334,0.98,0.02
4813,120,11,109,83,37,0.09166666666666666,0.9083333333333333,0.6916666666666667,0.30833333333333335,110,0,1,109,106,4,0.0,0.00909090909090909,0.990909090909091,0.9636363636363636,0.03636363636363636
4814,206,22,184,158,48,0.10679611650485436,0.8932038834951457,0.7669902912621359,0.23300970873786409,137,0,24,113,134,3,0.0,0.17518248175182483,0.8248175182481752,0.9781021897810219,0.021897810218978103
4815,103,12,91,59,44,0.11650485436893204,0.883495145631068,0.5728155339805825,0.42718446601941745,184,0,54,130,181,3,0.0,0.29347826086956524,0.7065217391304348,0.9836956521739131,0.016304347826086956
4816,167,138,29,163,4,0.8263473053892215,0.17365269461077845,0.9760479041916168,0.023952095808383235,324,0,49,275,103,221,0.0,0.15123456790123457,0.8487654320987654,0.31790123456790126,0.6820987654320988
4817,75,11,64,34,41,0.14666666666666667,0.8533333333333334,0.4533333333333333,0.5466666666666666,99,0,30,69,99,0,0.0,0.30303030303030304,0.696969696969697,1.0,0.0
4818,79,12,67,45,34,0.1518987341772152,0.8481012658227848,0.569620253164557,0.43037974683544306,97,0,30,67,97,0,0.0,0.30927835051546393,0.6907216494845361,1.0,0.0
4819,150,18,132,104,46,0.12,0.88,0.6933333333333334,0.30666666666666664,128,0,24,104,127,1,0.0,0.1875,0.8125,0.9921875,0.0078125
4820,121,11,110,78,43,0.09090909090909091,0.9090909090909091,0.6446280991735537,0.35537190082644626,106,0,1,105,103,3,0.0,0.009433962264150943,0.9905660377358491,0.9716981132075472,0.02830188679245283
4821,90,14,76,53,37,0.15555555555555556,0.8444444444444444,0.5888888888888889,0.4111111111111111,107,0,0,107,104,3,0.0,0.0,1.0,0.9719626168224299,0.028037383177570093
4822,129,14,115,97,32,0.10852713178294573,0.8914728682170543,0.751937984496124,0.24806201550387597,104,0,16,88,102,2,0.0,0.15384615384615385,0.8461538461538461,0.9807692307692307,0.019230769230769232
4823,204,19,185,156,48,0.09313725490196079,0.9068627450980392,0.7647058823529411,0.23529411764705882,135,0,27,108,132,3,0.0,0.2,0.8,0.9777777777777777,0.022222222222222223
4824,129,9,120,94,35,0.06976744186046512,0.9302325581395349,0.7286821705426356,0.2713178294573643,99,0,13,86,96,3,0.0,0.13131313131313133,0.8686868686868687,0.9696969696969697,0.030303030303030304
4825,221,22,199,170,51,0.09954751131221719,0.9004524886877828,0.7692307692307693,0.23076923076923078,142,0,25,117,140,2,0.0,0.176056338028169,0.823943661971831,0.9859154929577465,0.014084507042253521
4826,106,8,98,75,31,0.07547169811320754,0.9245283018867925,0.7075471698113207,0.29245283018867924,94,0,18,76,92,2,0.0,0.19148936170212766,0.8085106382978723,0.9787234042553191,0.02127659574468085
4827,77,7,70,52,25,0.09090909090909091,0.9090909090909091,0.6753246753246753,0.3246753246753247,78,0,0,78,74,4,0.0,0.0,1.0,0.9487179487179487,0.05128205128205128
4828,60,13,47,28,32,0.21666666666666667,0.7833333333333333,0.4666666666666667,0.5333333333333333,139,0,0,139,136,3,0.0,0.0,1.0,0.9784172661870504,0.02158273381294964
4829,90,14,76,51,39,0.15555555555555556,0.8444444444444444,0.5666666666666667,0.43333333333333335,104,0,0,104,101,3,0.0,0.0,1.0,0.9711538461538461,0.028846153846153848
4830,64,17,47,27,37,0.265625,0.734375,0.421875,0.578125,134,0,0,134,132,2,0.0,0.0,1.0,0.9850746268656716,0.014925373134328358
4831,59,12,47,25,34,0.2033898305084746,0.7966101694915254,0.423728813559322,0.576271186440678,143,0,0,143,141,2,0.0,0.0,1.0,0.986013986013986,0.013986013986013986
4832,111,9,102,84,27,0.08108108108108109,0.918918918918919,0.7567567567567568,0.24324324324324326,86,0,9,77,84,2,0.0,0.10465116279069768,0.8953488372093024,0.9767441860465116,0.023255813953488372
4833,92,16,76,56,36,0.17391304347826086,0.8260869565217391,0.6086956521739131,0.391304347826087,105,0,0,105,101,4,0.0,0.0,1.0,0.9619047619047619,0.0380952380952381
4834,184,36,148,108,76,0.1956521739130435,0.8043478260869565,0.5869565217391305,0.41304347826086957,144,0,24,120,143,1,0.0,0.16666666666666666,0.8333333333333334,0.9930555555555556,0.006944444444444444
4835,89,13,76,58,31,0.14606741573033707,0.8539325842696629,0.651685393258427,0.34831460674157305,113,0,0,113,110,3,0.0,0.0,1.0,0.9734513274336283,0.02654867256637168
4836,202,19,183,154,48,0.09405940594059406,0.905940594059406,0.7623762376237624,0.2376237623762376,136,0,27,109,133,3,0.0,0.19852941176470587,0.8014705882352942,0.9779411764705882,0.022058823529411766
4837,59,12,47,28,31,0.2033898305084746,0.7966101694915254,0.4745762711864407,0.5254237288135594,141,0,0,141,138,3,0.0,0.0,1.0,0.9787234042553191,0.02127659574468085
4838,123,12,111,79,44,0.0975609756097561,0.9024390243902439,0.6422764227642277,0.35772357723577236,114,0,2,112,110,4,0.0,0.017543859649122806,0.9824561403508771,0.9649122807017544,0.03508771929824561
4839,126,17,109,81,45,0.1349206349206349,0.8650793650793651,0.6428571428571429,0.35714285714285715,106,0,1,105,102,4,0.0,0.009433962264150943,0.9905660377358491,0.9622641509433962,0.03773584905660377
4840,191,16,175,150,41,0.08376963350785341,0.9162303664921466,0.7853403141361257,0.21465968586387435,128,0,25,103,126,2,0.0,0.1953125,0.8046875,0.984375,0.015625
4841,70,7,63,31,39,0.1,0.9,0.44285714285714284,0.5571428571428572,96,0,28,68,96,0,0.0,0.2916666666666667,0.7083333333333334,1.0,0.0
4842,113,22,91,53,60,0.19469026548672566,0.8053097345132744,0.4690265486725664,0.5309734513274337,175,0,54,121,172,3,0.0,0.30857142857142855,0.6914285714285714,0.9828571428571429,0.017142857142857144
4843,73,19,54,29,44,0.2602739726027397,0.7397260273972602,0.3972602739726027,0.6027397260273972,112,0,31,81,112,0,0.0,0.2767857142857143,0.7232142857142857,1.0,0.0
4844,192,11,181,156,36,0.057291666666666664,0.9427083333333334,0.8125,0.1875,138,0,27,111,135,3,0.0,0.1956521739130435,0.8043478260869565,0.9782608695652174,0.021739130434782608
4845,120,10,110,80,40,0.08333333333333333,0.9166666666666666,0.6666666666666666,0.3333333333333333,105,0,1,104,101,4,0.0,0.009523809523809525,0.9904761904761905,0.9619047619047619,0.0380952380952381
4846,120,6,114,93,27,0.05,0.95,0.775,0.225,98,0,15,83,96,2,0.0,0.15306122448979592,0.8469387755102041,0.9795918367346939,0.02040816326530612
4847,87,11,76,58,29,0.12643678160919541,0.8735632183908046,0.6666666666666666,0.3333333333333333,117,0,0,117,114,3,0.0,0.0,1.0,0.9743589743589743,0.02564102564102564
4848,88,12,76,55,33,0.13636363636363635,0.8636363636363636,0.625,0.375,105,0,0,105,103,2,0.0,0.0,1.0,0.9809523809523809,0.01904761904761905
4849,126,16,110,87,39,0.12698412698412698,0.873015873015873,0.6904761904761905,0.30952380952380953,122,0,1,121,118,4,0.0,0.00819672131147541,0.9918032786885246,0.9672131147540983,0.03278688524590164
4850,82,10,72,58,24,0.12195121951219512,0.8780487804878049,0.7073170731707317,0.2926829268292683,71,0,0,71,67,4,0.0,0.0,1.0,0.9436619718309859,0.056338028169014086
4851,125,15,110,82,43,0.12,0.88,0.656,0.344,112,0,1,111,108,4,0.0,0.008928571428571428,0.9910714285714286,0.9642857142857143,0.03571428571428571
4852,119,10,109,76,43,0.08403361344537816,0.9159663865546218,0.6386554621848739,0.36134453781512604,99,0,1,98,95,4,0.0,0.010101010101010102,0.98989898989899,0.9595959595959596,0.04040404040404041
4853,215,19,196,167,48,0.08837209302325581,0.9116279069767442,0.7767441860465116,0.22325581395348837,148,0,26,122,145,3,0.0,0.17567567567567569,0.8243243243243243,0.9797297297297297,0.02027027027027027
4854,87,11,76,53,34,0.12643678160919541,0.8735632183908046,0.6091954022988506,0.39080459770114945,113,0,0,113,109,4,0.0,0.0,1.0,0.9646017699115044,0.035398230088495575
4855,63,16,47,25,38,0.25396825396825395,0.746031746031746,0.3968253968253968,0.6031746031746031,137,0,0,137,134,3,0.0,0.0,1.0,0.9781021897810219,0.021897810218978103
4856,93,17,76,57,36,0.1827956989247312,0.8172043010752689,0.6129032258064516,0.3870967741935484,111,0,0,111,109,2,0.0,0.0,1.0,0.9819819819819819,0.018018018018018018
4857,131,21,110,79,52,0.16030534351145037,0.8396946564885496,0.6030534351145038,0.3969465648854962,97,0,1,96,93,4,0.0,0.010309278350515464,0.9896907216494846,0.9587628865979382,0.041237113402061855
4858,79,25,54,30,49,0.31645569620253167,0.6835443037974683,0.379746835443038,0.620253164556962,103,0,33,70,103,0,0.0,0.32038834951456313,0.6796116504854369,1.0,0.0
4859,123,13,110,85,38,0.10569105691056911,0.8943089430894309,0.6910569105691057,0.3089430894308943,113,0,1,112,109,4,0.0,0.008849557522123894,0.9911504424778761,0.9646017699115044,0.035398230088495575
4860,63,16,47,26,37,0.25396825396825395,0.746031746031746,0.4126984126984127,0.5873015873015873,142,0,0,142,140,2,0.0,0.0,1.0,0.9859154929577465,0.014084507042253521
4861,42,8,34,18,24,0.19047619047619047,0.8095238095238095,0.42857142857142855,0.5714285714285714,85,0,30,55,85,0,0.0,0.35294117647058826,0.6470588235294118,1.0,0.0
4862,72,18,54,28,44,0.25,0.75,0.3888888888888889,0.6111111111111112,100,0,30,70,100,0,0.0,0.3,0.7,1.0,0.0
4863,126,16,110,79,47,0.12698412698412698,0.873015873015873,0.626984126984127,0.373015873015873,119,0,1,118,115,4,0.0,0.008403361344537815,0.9915966386554622,0.9663865546218487,0.03361344537815126
4864,62,15,47,25,37,0.24193548387096775,0.7580645161290323,0.4032258064516129,0.5967741935483871,136,0,0,136,134,2,0.0,0.0,1.0,0.9852941176470589,0.014705882352941176
4865,111,8,103,88,23,0.07207207207207207,0.9279279279279279,0.7927927927927928,0.2072072072072072,86,0,12,74,84,2,0.0,0.13953488372093023,0.8604651162790697,0.9767441860465116,0.023255813953488372
4866,120,10,110,86,34,0.08333333333333333,0.9166666666666666,0.7166666666666667,0.2833333333333333,123,0,1,122,119,4,0.0,0.008130081300813009,0.991869918699187,0.967479674796748,0.032520325203252036
4867,122,12,110,78,44,0.09836065573770492,0.9016393442622951,0.639344262295082,0.36065573770491804,97,0,1,96,93,4,0.0,0.010309278350515464,0.9896907216494846,0.9587628865979382,0.041237113402061855
4868,76,22,54,26,50,0.2894736842105263,0.7105263157894737,0.34210526315789475,0.6578947368421053,108,0,30,78,108,0,0.0,0.2777777777777778,0.7222222222222222,1.0,0.0
4869,77,13,64,40,37,0.16883116883116883,0.8311688311688312,0.5194805194805194,0.4805194805194805,101,0,30,71,101,0,0.0,0.297029702970297,0.7029702970297029,1.0,0.0
4870,92,16,76,56,36,0.17391304347826086,0.8260869565217391,0.6086956521739131,0.391304347826087,100,0,0,100,97,3,0.0,0.0,1.0,0.97,0.03
4871,162,14,148,112,50,0.08641975308641975,0.9135802469135802,0.691358024691358,0.30864197530864196,158,1,24,133,157,1,0.006329113924050633,0.1518987341772152,0.8417721518987342,0.9936708860759493,0.006329113924050633
4872,69,7,62,44,25,0.10144927536231885,0.8985507246376812,0.6376811594202898,0.36231884057971014,74,0,0,74,70,4,0.0,0.0,1.0,0.9459459459459459,0.05405405405405406
4873,88,8,80,54,34,0.09090909090909091,0.9090909090909091,0.6136363636363636,0.38636363636363635,84,0,1,83,80,4,0.0,0.011904761904761904,0.9880952380952381,0.9523809523809523,0.047619047619047616
4874,124,14,110,84,40,0.11290322580645161,0.8870967741935484,0.6774193548387096,0.3225806451612903,116,0,1,115,113,3,0.0,0.008620689655172414,0.9913793103448276,0.9741379310344828,0.02586206896551724
4875,110,6,104,86,24,0.05454545454545454,0.9454545454545454,0.7818181818181819,0.21818181818181817,90,0,14,76,88,2,0.0,0.15555555555555556,0.8444444444444444,0.9777777777777777,0.022222222222222223
4876,88,12,76,51,37,0.13636363636363635,0.8636363636363636,0.5795454545454546,0.42045454545454547,110,0,0,110,107,3,0.0,0.0,1.0,0.9727272727272728,0.02727272727272727
4877,57,10,47,30,27,0.17543859649122806,0.8245614035087719,0.5263157894736842,0.47368421052631576,141,0,0,141,139,2,0.0,0.0,1.0,0.9858156028368794,0.014184397163120567
4878,59,15,44,22,37,0.2542372881355932,0.7457627118644068,0.3728813559322034,0.6271186440677966,95,0,32,63,95,0,0.0,0.3368421052631579,0.6631578947368421,1.0,0.0
4879,94,18,76,55,39,0.19148936170212766,0.8085106382978723,0.5851063829787234,0.4148936170212766,103,0,0,103,99,4,0.0,0.0,1.0,0.9611650485436893,0.038834951456310676
4880,115,19,96,76,39,0.16521739130434782,0.8347826086956521,0.6608695652173913,0.3391304347826087,124,0,0,124,121,3,0.0,0.0,1.0,0.9758064516129032,0.024193548387096774
4881,115,20,95,65,50,0.17391304347826086,0.8260869565217391,0.5652173913043478,0.43478260869565216,120,0,0,120,117,3,0.0,0.0,1.0,0.975,0.025
4882,159,11,148,111,48,0.06918238993710692,0.9308176100628931,0.6981132075471698,0.3018867924528302,150,0,24,126,149,1,0.0,0.16,0.84,0.9933333333333333,0.006666666666666667
4883,96,13,83,63,33,0.13541666666666666,0.8645833333333334,0.65625,0.34375,84,0,1,83,80,4,0.0,0.011904761904761904,0.9880952380952381,0.9523809523809523,0.047619047619047616
4884,122,5,117,94,28,0.040983606557377046,0.9590163934426229,0.7704918032786885,0.22950819672131148,106,0,15,91,104,2,0.0,0.14150943396226415,0.8584905660377359,0.9811320754716981,0.018867924528301886
4885,199,21,178,153,46,0.10552763819095477,0.8944723618090452,0.7688442211055276,0.23115577889447236,136,0,25,111,133,3,0.0,0.18382352941176472,0.8161764705882353,0.9779411764705882,0.022058823529411766
4886,193,16,177,150,43,0.08290155440414508,0.917098445595855,0.7772020725388601,0.22279792746113988,144,0,26,118,141,3,0.0,0.18055555555555555,0.8194444444444444,0.9791666666666666,0.020833333333333332
4887,79,10,69,54,25,0.12658227848101267,0.8734177215189873,0.6835443037974683,0.31645569620253167,78,0,1,77,74,4,0.0,0.01282051282051282,0.9871794871794872,0.9487179487179487,0.05128205128205128
4888,74,20,54,26,48,0.2702702702702703,0.7297297297297297,0.35135135135135137,0.6486486486486487,99,0,30,69,99,0,0.0,0.30303030303030304,0.696969696969697,1.0,0.0
4889,125,15,110,79,46,0.12,0.88,0.632,0.368,110,0,1,109,106,4,0.0,0.00909090909090909,0.990909090909091,0.9636363636363636,0.03636363636363636
4890,119,8,111,85,34,0.06722689075630252,0.9327731092436975,0.7142857142857143,0.2857142857142857,102,0,2,100,98,4,0.0,0.0196078431372549,0.9803921568627451,0.9607843137254902,0.0392156862745098
4891,82,8,74,55,27,0.0975609756097561,0.9024390243902439,0.6707317073170732,0.32926829268292684,109,0,0,109,107,2,0.0,0.0,1.0,0.981651376146789,0.01834862385321101
4892,195,15,180,158,37,0.07692307692307693,0.9230769230769231,0.8102564102564103,0.18974358974358974,131,0,26,105,129,2,0.0,0.1984732824427481,0.8015267175572519,0.9847328244274809,0.015267175572519083
4893,197,17,180,156,41,0.08629441624365482,0.9137055837563451,0.7918781725888325,0.20812182741116753,139,0,25,114,136,3,0.0,0.17985611510791366,0.8201438848920863,0.9784172661870504,0.02158273381294964
4894,117,13,104,77,40,0.1111111111111111,0.8888888888888888,0.6581196581196581,0.3418803418803419,122,0,0,122,119,3,0.0,0.0,1.0,0.9754098360655737,0.02459016393442623
4895,79,16,63,41,38,0.20253164556962025,0.7974683544303798,0.5189873417721519,0.4810126582278481,93,0,30,63,93,0,0.0,0.3225806451612903,0.6774193548387096,1.0,0.0
4896,83,18,65,38,45,0.21686746987951808,0.7831325301204819,0.4578313253012048,0.5421686746987951,90,0,29,61,90,0,0.0,0.32222222222222224,0.6777777777777778,1.0,0.0
4897,193,12,181,152,41,0.06217616580310881,0.9378238341968912,0.7875647668393783,0.21243523316062177,139,0,27,112,136,3,0.0,0.19424460431654678,0.8057553956834532,0.9784172661870504,0.02158273381294964
4898,152,19,133,109,43,0.125,0.875,0.7171052631578947,0.28289473684210525,131,0,24,107,130,1,0.0,0.183206106870229,0.816793893129771,0.9923664122137404,0.007633587786259542
4899,114,23,91,49,65,0.20175438596491227,0.7982456140350878,0.4298245614035088,0.5701754385964912,184,1,54,129,181,3,0.005434782608695652,0.29347826086956524,0.7010869565217391,0.9836956521739131,0.016304347826086956
4900,80,17,63,39,41,0.2125,0.7875,0.4875,0.5125,92,0,30,62,92,0,0.0,0.32608695652173914,0.6739130434782609,1.0,0.0
4901,86,10,76,53,33,0.11627906976744186,0.8837209302325582,0.6162790697674418,0.38372093023255816,101,0,0,101,98,3,0.0,0.0,1.0,0.9702970297029703,0.0297029702970297
4902,124,9,115,100,24,0.07258064516129033,0.9274193548387096,0.8064516129032258,0.1935483870967742,95,0,12,83,93,2,0.0,0.12631578947368421,0.8736842105263158,0.9789473684210527,0.021052631578947368
4903,111,8,103,84,27,0.07207207207207207,0.9279279279279279,0.7567567567567568,0.24324324324324326,85,0,14,71,83,2,0.0,0.16470588235294117,0.8352941176470589,0.9764705882352941,0.023529411764705882
4904,120,7,113,93,27,0.058333333333333334,0.9416666666666667,0.775,0.225,102,0,20,82,100,2,0.0,0.19607843137254902,0.803921568627451,0.9803921568627451,0.0196078431372549
4905,121,6,115,91,30,0.049586776859504134,0.9504132231404959,0.7520661157024794,0.24793388429752067,100,0,13,87,98,2,0.0,0.13,0.87,0.98,0.02
4906,68,4,64,49,19,0.058823529411764705,0.9411764705882353,0.7205882352941176,0.27941176470588236,75,0,0,75,71,4,0.0,0.0,1.0,0.9466666666666667,0.05333333333333334
4907,122,12,110,82,40,0.09836065573770492,0.9016393442622951,0.6721311475409836,0.32786885245901637,108,0,1,107,104,4,0.0,0.009259259259259259,0.9907407407407407,0.9629629629629629,0.037037037037037035
4908,103,5,98,81,22,0.04854368932038835,0.9514563106796117,0.7864077669902912,0.21359223300970873,81,0,13,68,79,2,0.0,0.16049382716049382,0.8395061728395061,0.9753086419753086,0.024691358024691357
4909,128,11,117,93,35,0.0859375,0.9140625,0.7265625,0.2734375,95,0,17,78,93,2,0.0,0.17894736842105263,0.8210526315789474,0.9789473684210527,0.021052631578947368
4910,195,16,179,151,44,0.08205128205128205,0.9179487179487179,0.7743589743589744,0.22564102564102564,141,0,26,115,138,3,0.0,0.18439716312056736,0.8156028368794326,0.9787234042553191,0.02127659574468085
4911,225,214,11,222,3,0.9511111111111111,0.04888888888888889,0.9866666666666667,0.013333333333333334,409,0,70,339,119,290,0.0,0.17114914425427874,0.8288508557457213,0.29095354523227385,0.7090464547677262
4912,87,11,76,54,33,0.12643678160919541,0.8735632183908046,0.6206896551724138,0.3793103448275862,116,0,0,116,114,2,0.0,0.0,1.0,0.9827586206896551,0.017241379310344827
4913,115,102,13,111,4,0.8869565217391304,0.11304347826086956,0.9652173913043478,0.034782608695652174,341,0,25,316,89,252,0.0,0.07331378299120235,0.9266862170087976,0.26099706744868034,0.7390029325513197
4914,92,16,76,52,40,0.17391304347826086,0.8260869565217391,0.5652173913043478,0.43478260869565216,106,0,0,106,102,4,0.0,0.0,1.0,0.9622641509433962,0.03773584905660377
4915,190,13,177,149,41,0.06842105263157895,0.9315789473684211,0.7842105263157895,0.21578947368421053,136,0,25,111,133,3,0.0,0.18382352941176472,0.8161764705882353,0.9779411764705882,0.022058823529411766
4916,78,24,54,27,51,0.3076923076923077,0.6923076923076923,0.34615384615384615,0.6538461538461539,98,0,30,68,98,0,0.0,0.30612244897959184,0.6938775510204082,1.0,0.0
4917,126,16,110,75,51,0.12698412698412698,0.873015873015873,0.5952380952380952,0.40476190476190477,117,0,1,116,113,4,0.0,0.008547008547008548,0.9914529914529915,0.9658119658119658,0.03418803418803419
4918,121,11,110,80,41,0.09090909090909091,0.9090909090909091,0.6611570247933884,0.33884297520661155,111,0,1,110,107,4,0.0,0.009009009009009009,0.990990990990991,0.963963963963964,0.036036036036036036
4919,94,18,76,56,38,0.19148936170212766,0.8085106382978723,0.5957446808510638,0.40425531914893614,105,0,0,105,102,3,0.0,0.0,1.0,0.9714285714285714,0.02857142857142857
4920,62,14,48,27,35,0.22580645161290322,0.7741935483870968,0.43548387096774194,0.5645161290322581,151,0,0,151,148,3,0.0,0.0,1.0,0.9801324503311258,0.019867549668874173
4921,86,10,76,56,30,0.11627906976744186,0.8837209302325582,0.6511627906976745,0.3488372093023256,108,0,0,108,105,3,0.0,0.0,1.0,0.9722222222222222,0.027777777777777776
4922,89,12,77,57,32,0.1348314606741573,0.8651685393258427,0.6404494382022472,0.3595505617977528,86,0,1,85,82,4,0.0,0.011627906976744186,0.9883720930232558,0.9534883720930233,0.046511627906976744
4923,64,17,47,25,39,0.265625,0.734375,0.390625,0.609375,137,0,0,137,134,3,0.0,0.0,1.0,0.9781021897810219,0.021897810218978103
4924,107,8,99,84,23,0.07476635514018691,0.9252336448598131,0.7850467289719626,0.21495327102803738,91,0,14,77,89,2,0.0,0.15384615384615385,0.8461538461538461,0.978021978021978,0.02197802197802198
4925,198,17,181,155,43,0.08585858585858586,0.9141414141414141,0.7828282828282829,0.21717171717171718,146,0,24,122,143,3,0.0,0.1643835616438356,0.8356164383561644,0.9794520547945206,0.02054794520547945
4926,124,6,118,99,25,0.04838709677419355,0.9516129032258065,0.7983870967741935,0.20161290322580644,104,0,16,88,102,2,0.0,0.15384615384615385,0.8461538461538461,0.9807692307692307,0.019230769230769232
4927,72,18,54,26,46,0.25,0.75,0.3611111111111111,0.6388888888888888,100,0,31,69,100,0,0.0,0.31,0.69,1.0,0.0
4928,77,13,64,38,39,0.16883116883116883,0.8311688311688312,0.4935064935064935,0.5064935064935064,97,0,28,69,97,0,0.0,0.28865979381443296,0.711340206185567,1.0,0.0
4929,126,5,121,93,33,0.03968253968253968,0.9603174603174603,0.7380952380952381,0.2619047619047619,100,0,14,86,98,2,0.0,0.14,0.86,0.98,0.02
4930,114,8,106,93,21,0.07017543859649122,0.9298245614035088,0.8157894736842105,0.18421052631578946,93,0,13,80,91,2,0.0,0.13978494623655913,0.8602150537634409,0.978494623655914,0.021505376344086023
4931,120,6,114,93,27,0.05,0.95,0.775,0.225,106,0,16,90,104,2,0.0,0.1509433962264151,0.8490566037735849,0.9811320754716981,0.018867924528301886
4932,126,7,119,95,31,0.05555555555555555,0.9444444444444444,0.753968253968254,0.24603174603174602,100,0,14,86,98,2,0.0,0.14,0.86,0.98,0.02
4933,109,7,102,86,23,0.06422018348623854,0.9357798165137615,0.7889908256880734,0.21100917431192662,90,0,12,78,88,2,0.0,0.13333333333333333,0.8666666666666667,0.9777777777777777,0.022222222222222223
4934,87,11,76,54,33,0.12643678160919541,0.8735632183908046,0.6206896551724138,0.3793103448275862,113,0,0,113,110,3,0.0,0.0,1.0,0.9734513274336283,0.02654867256637168
4935,62,14,48,24,38,0.22580645161290322,0.7741935483870968,0.3870967741935484,0.6129032258064516,133,0,0,133,130,3,0.0,0.0,1.0,0.9774436090225563,0.022556390977443608
4936,109,18,91,57,52,0.1651376146788991,0.8348623853211009,0.5229357798165137,0.47706422018348627,181,0,54,127,178,3,0.0,0.2983425414364641,0.7016574585635359,0.9834254143646409,0.016574585635359115
4937,203,22,181,155,48,0.10837438423645321,0.8916256157635468,0.7635467980295566,0.23645320197044334,139,0,25,114,136,3,0.0,0.17985611510791366,0.8201438848920863,0.9784172661870504,0.02158273381294964
4938,120,14,106,78,42,0.11666666666666667,0.8833333333333333,0.65,0.35,124,0,1,123,120,4,0.0,0.008064516129032258,0.9919354838709677,0.967741935483871,0.03225806451612903
4939,191,11,180,149,42,0.05759162303664921,0.9424083769633508,0.7801047120418848,0.2198952879581152,143,0,26,117,140,3,0.0,0.18181818181818182,0.8181818181818182,0.9790209790209791,0.02097902097902098
4940,84,18,66,42,42,0.21428571428571427,0.7857142857142857,0.5,0.5,95,0,31,64,95,0,0.0,0.3263157894736842,0.6736842105263158,1.0,0.0
4941,121,9,112,90,31,0.0743801652892562,0.9256198347107438,0.743801652892562,0.256198347107438,104,0,11,93,102,2,0.0,0.10576923076923077,0.8942307692307693,0.9807692307692307,0.019230769230769232
4942,88,12,76,53,35,0.13636363636363635,0.8636363636363636,0.6022727272727273,0.3977272727272727,115,0,0,115,111,4,0.0,0.0,1.0,0.9652173913043478,0.034782608695652174
4943,113,13,100,80,33,0.11504424778761062,0.8849557522123894,0.7079646017699115,0.2920353982300885,127,0,0,127,123,4,0.0,0.0,1.0,0.968503937007874,0.031496062992125984
4944,115,5,110,79,36,0.043478260869565216,0.9565217391304348,0.6869565217391305,0.3130434782608696,115,0,1,114,111,4,0.0,0.008695652173913044,0.991304347826087,0.9652173913043478,0.034782608695652174
4945,118,8,110,76,42,0.06779661016949153,0.9322033898305084,0.6440677966101694,0.3559322033898305,113,0,1,112,109,4,0.0,0.008849557522123894,0.9911504424778761,0.9646017699115044,0.035398230088495575
4946,88,9,79,58,30,0.10227272727272728,0.8977272727272727,0.6590909090909091,0.3409090909090909,78,0,1,77,74,4,0.0,0.01282051282051282,0.9871794871794872,0.9487179487179487,0.05128205128205128
4947,120,10,110,77,43,0.08333333333333333,0.9166666666666666,0.6416666666666667,0.35833333333333334,99,0,1,98,95,4,0.0,0.010101010101010102,0.98989898989899,0.9595959595959596,0.04040404040404041
4948,90,14,76,55,35,0.15555555555555556,0.8444444444444444,0.6111111111111112,0.3888888888888889,104,0,0,104,101,3,0.0,0.0,1.0,0.9711538461538461,0.028846153846153848
4949,79,25,54,30,49,0.31645569620253167,0.6835443037974683,0.379746835443038,0.620253164556962,106,0,30,76,106,0,0.0,0.2830188679245283,0.7169811320754716,1.0,0.0
4950,87,13,74,52,35,0.14942528735632185,0.8505747126436781,0.5977011494252874,0.40229885057471265,107,0,0,107,105,2,0.0,0.0,1.0,0.9813084112149533,0.018691588785046728
4951,86,10,76,55,31,0.11627906976744186,0.8837209302325582,0.6395348837209303,0.36046511627906974,108,0,0,108,105,3,0.0,0.0,1.0,0.9722222222222222,0.027777777777777776
4952,112,8,104,89,23,0.07142857142857142,0.9285714285714286,0.7946428571428571,0.20535714285714285,85,0,11,74,83,2,0.0,0.12941176470588237,0.8705882352941177,0.9764705882352941,0.023529411764705882
4953,123,10,113,94,29,0.08130081300813008,0.9186991869918699,0.7642276422764228,0.23577235772357724,104,0,16,88,102,2,0.0,0.15384615384615385,0.8461538461538461,0.9807692307692307,0.019230769230769232
4954,127,16,111,82,45,0.12598425196850394,0.8740157480314961,0.6456692913385826,0.3543307086614173,113,0,2,111,110,3,0.0,0.017699115044247787,0.9823008849557522,0.9734513274336283,0.02654867256637168
4955,122,11,111,85,37,0.09016393442622951,0.9098360655737705,0.6967213114754098,0.30327868852459017,107,0,2,105,103,4,0.0,0.018691588785046728,0.9813084112149533,0.9626168224299065,0.037383177570093455
4956,88,12,76,56,32,0.13636363636363635,0.8636363636363636,0.6363636363636364,0.36363636363636365,106,0,0,106,104,2,0.0,0.0,1.0,0.9811320754716981,0.018867924528301886
4957,114,8,106,77,37,0.07017543859649122,0.9298245614035088,0.6754385964912281,0.32456140350877194,108,0,1,107,104,4,0.0,0.009259259259259259,0.9907407407407407,0.9629629629629629,0.037037037037037035
4958,122,12,110,86,36,0.09836065573770492,0.9016393442622951,0.7049180327868853,0.29508196721311475,100,0,2,98,96,4,0.0,0.02,0.98,0.96,0.04
4959,123,14,109,76,47,0.11382113821138211,0.8861788617886179,0.6178861788617886,0.3821138211382114,119,0,0,119,115,4,0.0,0.0,1.0,0.9663865546218487,0.03361344537815126
4960,89,13,76,58,31,0.14606741573033707,0.8539325842696629,0.651685393258427,0.34831460674157305,113,0,0,113,111,2,0.0,0.0,1.0,0.9823008849557522,0.017699115044247787
4961,88,12,76,58,30,0.13636363636363635,0.8636363636363636,0.6590909090909091,0.3409090909090909,119,0,0,119,116,3,0.0,0.0,1.0,0.9747899159663865,0.025210084033613446
4962,84,8,76,58,26,0.09523809523809523,0.9047619047619048,0.6904761904761905,0.30952380952380953,108,0,0,108,105,3,0.0,0.0,1.0,0.9722222222222222,0.027777777777777776
4963,38,5,33,31,7,0.13157894736842105,0.868421052631579,0.8157894736842105,0.18421052631578946,87,0,15,72,84,3,0.0,0.1724137931034483,0.8275862068965517,0.9655172413793104,0.034482758620689655
4964,141,126,15,138,3,0.8936170212765957,0.10638297872340426,0.9787234042553191,0.02127659574468085,322,0,39,283,101,221,0.0,0.12111801242236025,0.8788819875776398,0.3136645962732919,0.6863354037267081
4965,59,12,47,26,33,0.2033898305084746,0.7966101694915254,0.4406779661016949,0.559322033898305,141,0,0,141,138,3,0.0,0.0,1.0,0.9787234042553191,0.02127659574468085
4966,151,8,143,107,44,0.052980132450331126,0.9470198675496688,0.7086092715231788,0.2913907284768212,139,0,24,115,138,1,0.0,0.17266187050359713,0.8273381294964028,0.9928057553956835,0.007194244604316547
4967,70,16,54,25,45,0.22857142857142856,0.7714285714285715,0.35714285714285715,0.6428571428571429,115,0,32,83,115,0,0.0,0.2782608695652174,0.7217391304347827,1.0,0.0
4968,168,20,148,119,49,0.11904761904761904,0.8809523809523809,0.7083333333333334,0.2916666666666667,147,0,24,123,146,1,0.0,0.16326530612244897,0.8367346938775511,0.9931972789115646,0.006802721088435374
4969,124,14,110,79,45,0.11290322580645161,0.8870967741935484,0.6370967741935484,0.3629032258064516,109,0,1,108,105,4,0.0,0.009174311926605505,0.9908256880733946,0.963302752293578,0.03669724770642202
4970,211,17,194,168,43,0.08056872037914692,0.919431279620853,0.7962085308056872,0.2037914691943128,146,0,26,120,143,3,0.0,0.1780821917808219,0.821917808219178,0.9794520547945206,0.02054794520547945
4971,61,14,47,26,35,0.22950819672131148,0.7704918032786885,0.4262295081967213,0.5737704918032787,149,0,0,149,147,2,0.0,0.0,1.0,0.9865771812080537,0.013422818791946308
4972,106,4,102,85,21,0.03773584905660377,0.9622641509433962,0.8018867924528302,0.19811320754716982,85,0,15,70,83,2,0.0,0.17647058823529413,0.8235294117647058,0.9764705882352941,0.023529411764705882
4973,116,13,103,74,42,0.11206896551724138,0.8879310344827587,0.6379310344827587,0.3620689655172414,123,0,0,123,120,3,0.0,0.0,1.0,0.975609756097561,0.024390243902439025
4974,86,10,76,55,31,0.11627906976744186,0.8837209302325582,0.6395348837209303,0.36046511627906974,112,0,0,112,108,4,0.0,0.0,1.0,0.9642857142857143,0.03571428571428571
4975,108,17,91,62,46,0.1574074074074074,0.8425925925925926,0.5740740740740741,0.42592592592592593,185,0,54,131,181,4,0.0,0.2918918918918919,0.7081081081081081,0.9783783783783784,0.021621621621621623
4976,125,9,116,92,33,0.072,0.928,0.736,0.264,99,0,16,83,97,2,0.0,0.16161616161616163,0.8383838383838383,0.9797979797979798,0.020202020202020204
4977,119,9,110,84,35,0.07563025210084033,0.9243697478991597,0.7058823529411765,0.29411764705882354,119,0,1,118,115,4,0.0,0.008403361344537815,0.9915966386554622,0.9663865546218487,0.03361344537815126
4978,192,15,177,151,41,0.078125,0.921875,0.7864583333333334,0.21354166666666666,130,0,26,104,127,3,0.0,0.2,0.8,0.9769230769230769,0.023076923076923078
4979,117,6,111,93,24,0.05128205128205128,0.9487179487179487,0.7948717948717948,0.20512820512820512,87,0,9,78,85,2,0.0,0.10344827586206896,0.896551724137931,0.9770114942528736,0.022988505747126436
4980,168,20,148,115,53,0.11904761904761904,0.8809523809523809,0.6845238095238095,0.31547619047619047,161,0,24,137,160,1,0.0,0.14906832298136646,0.8509316770186336,0.9937888198757764,0.006211180124223602
4981,117,9,108,85,32,0.07692307692307693,0.9230769230769231,0.7264957264957265,0.27350427350427353,110,0,1,109,106,4,0.0,0.00909090909090909,0.990909090909091,0.9636363636363636,0.03636363636363636
4982,123,13,110,66,57,0.10569105691056911,0.8943089430894309,0.5365853658536586,0.4634146341463415,111,0,1,110,107,4,0.0,0.009009009009009009,0.990990990990991,0.963963963963964,0.036036036036036036
4983,123,9,114,96,27,0.07317073170731707,0.926829268292683,0.7804878048780488,0.21951219512195122,108,0,17,91,106,2,0.0,0.1574074074074074,0.8425925925925926,0.9814814814814815,0.018518518518518517
4984,114,17,97,73,41,0.14912280701754385,0.8508771929824561,0.6403508771929824,0.35964912280701755,117,0,0,117,115,2,0.0,0.0,1.0,0.9829059829059829,0.017094017094017096
4985,171,23,148,117,54,0.13450292397660818,0.8654970760233918,0.6842105263157895,0.3157894736842105,148,0,24,124,147,1,0.0,0.16216216216216217,0.8378378378378378,0.9932432432432432,0.006756756756756757
4986,60,13,47,26,34,0.21666666666666667,0.7833333333333333,0.43333333333333335,0.5666666666666667,134,0,0,134,131,3,0.0,0.0,1.0,0.9776119402985075,0.022388059701492536
4987,64,10,54,31,33,0.15625,0.84375,0.484375,0.515625,97,0,30,67,97,0,0.0,0.30927835051546393,0.6907216494845361,1.0,0.0
4988,126,17,109,77,49,0.1349206349206349,0.8650793650793651,0.6111111111111112,0.3888888888888889,105,0,1,104,101,4,0.0,0.009523809523809525,0.9904761904761905,0.9619047619047619,0.0380952380952381
4989,126,9,117,100,26,0.07142857142857142,0.9285714285714286,0.7936507936507936,0.20634920634920634,107,0,16,91,104,3,0.0,0.14953271028037382,0.8504672897196262,0.9719626168224299,0.028037383177570093
4990,124,15,109,83,41,0.12096774193548387,0.8790322580645161,0.6693548387096774,0.33064516129032256,105,0,1,104,102,3,0.0,0.009523809523809525,0.9904761904761905,0.9714285714285714,0.02857142857142857
4991,125,6,119,99,26,0.048,0.952,0.792,0.208,111,0,15,96,109,2,0.0,0.13513513513513514,0.8648648648648649,0.9819819819819819,0.018018018018018018
4992,112,21,91,64,48,0.1875,0.8125,0.5714285714285714,0.42857142857142855,182,0,54,128,178,4,0.0,0.2967032967032967,0.7032967032967034,0.978021978021978,0.02197802197802198
4993,199,18,181,153,46,0.09045226130653267,0.9095477386934674,0.7688442211055276,0.23115577889447236,131,0,25,106,128,3,0.0,0.19083969465648856,0.8091603053435115,0.9770992366412213,0.022900763358778626
4994,124,13,111,82,42,0.10483870967741936,0.8951612903225806,0.6612903225806451,0.3387096774193548,109,0,2,107,105,4,0.0,0.01834862385321101,0.981651376146789,0.963302752293578,0.03669724770642202
4995,119,5,114,97,22,0.04201680672268908,0.957983193277311,0.8151260504201681,0.18487394957983194,96,0,9,87,92,4,0.0,0.09375,0.90625,0.9583333333333334,0.041666666666666664
4996,123,14,109,80,43,0.11382113821138211,0.8861788617886179,0.6504065040650406,0.34959349593495936,107,0,1,106,103,4,0.0,0.009345794392523364,0.9906542056074766,0.9626168224299065,0.037383177570093455
4997,124,13,111,86,38,0.10483870967741936,0.8951612903225806,0.6935483870967742,0.3064516129032258,114,0,1,113,111,3,0.0,0.008771929824561403,0.9912280701754386,0.9736842105263158,0.02631578947368421
4998,171,23,148,119,52,0.13450292397660818,0.8654970760233918,0.695906432748538,0.30409356725146197,159,0,24,135,158,1,0.0,0.1509433962264151,0.8490566037735849,0.9937106918238994,0.006289308176100629
4999,124,13,111,81,43,0.10483870967741936,0.8951612903225806,0.6532258064516129,0.3467741935483871,108,0,1,107,104,4,0.0,0.009259259259259259,0.9907407407407407,0.9629629629629629,0.037037037037037035
5000,191,16,175,146,45,0.08376963350785341,0.9162303664921466,0.7643979057591623,0.2356020942408377,143,0,25,118,140,3,0.0,0.17482517482517482,0.8251748251748252,0.9790209790209791,0.02097902097902098
5001,67,13,54,27,40,0.19402985074626866,0.8059701492537313,0.40298507462686567,0.5970149253731343,105,0,30,75,105,0,0.0,0.2857142857142857,0.7142857142857143,1.0,0.0
5002,63,16,47,26,37,0.25396825396825395,0.746031746031746,0.4126984126984127,0.5873015873015873,134,0,0,134,131,3,0.0,0.0,1.0,0.9776119402985075,0.022388059701492536
5003,200,24,176,155,45,0.12,0.88,0.775,0.225,137,0,27,110,134,3,0.0,0.19708029197080293,0.8029197080291971,0.9781021897810219,0.021897810218978103
5004,91,15,76,52,39,0.16483516483516483,0.8351648351648352,0.5714285714285714,0.42857142857142855,124,0,0,124,121,3,0.0,0.0,1.0,0.9758064516129032,0.024193548387096774
5005,167,19,148,112,55,0.11377245508982035,0.8862275449101796,0.6706586826347305,0.32934131736526945,151,0,24,127,150,1,0.0,0.15894039735099338,0.8410596026490066,0.9933774834437086,0.006622516556291391
5006,121,10,111,83,38,0.08264462809917356,0.9173553719008265,0.6859504132231405,0.3140495867768595,123,0,2,121,119,4,0.0,0.016260162601626018,0.983739837398374,0.967479674796748,0.032520325203252036
5007,129,19,110,81,48,0.14728682170542637,0.8527131782945736,0.627906976744186,0.37209302325581395,120,0,1,119,117,3,0.0,0.008333333333333333,0.9916666666666667,0.975,0.025
5008,86,12,74,54,32,0.13953488372093023,0.8604651162790697,0.627906976744186,0.37209302325581395,103,0,0,103,100,3,0.0,0.0,1.0,0.970873786407767,0.02912621359223301
5009,72,6,66,51,21,0.08333333333333333,0.9166666666666666,0.7083333333333334,0.2916666666666667,81,0,0,81,77,4,0.0,0.0,1.0,0.9506172839506173,0.04938271604938271
5010,186,10,176,150,36,0.053763440860215055,0.946236559139785,0.8064516129032258,0.1935483870967742,143,0,26,117,140,3,0.0,0.18181818181818182,0.8181818181818182,0.9790209790209791,0.02097902097902098
5011,193,10,183,156,37,0.05181347150259067,0.9481865284974094,0.8082901554404145,0.19170984455958548,135,0,26,109,132,3,0.0,0.1925925925925926,0.8074074074074075,0.9777777777777777,0.022222222222222223
5012,127,11,116,96,31,0.08661417322834646,0.9133858267716536,0.7559055118110236,0.2440944881889764,92,0,10,82,90,2,0.0,0.10869565217391304,0.8913043478260869,0.9782608695652174,0.021739130434782608
5013,60,13,47,26,34,0.21666666666666667,0.7833333333333333,0.43333333333333335,0.5666666666666667,146,0,0,146,143,3,0.0,0.0,1.0,0.9794520547945206,0.02054794520547945
5014,121,5,116,90,31,0.04132231404958678,0.9586776859504132,0.743801652892562,0.256198347107438,102,0,13,89,100,2,0.0,0.12745098039215685,0.8725490196078431,0.9803921568627451,0.0196078431372549
5015,199,20,179,151,48,0.10050251256281408,0.8994974874371859,0.7587939698492462,0.24120603015075376,147,0,28,119,144,3,0.0,0.19047619047619047,0.8095238095238095,0.9795918367346939,0.02040816326530612
5016,201,21,180,153,48,0.1044776119402985,0.8955223880597015,0.7611940298507462,0.23880597014925373,138,0,25,113,135,3,0.0,0.18115942028985507,0.8188405797101449,0.9782608695652174,0.021739130434782608
5017,123,13,110,81,42,0.10569105691056911,0.8943089430894309,0.6585365853658537,0.34146341463414637,108,0,1,107,104,4,0.0,0.009259259259259259,0.9907407407407407,0.9629629629629629,0.037037037037037035
5018,120,9,111,83,37,0.075,0.925,0.6916666666666667,0.30833333333333335,100,0,2,98,96,4,0.0,0.02,0.98,0.96,0.04
5019,93,17,76,52,41,0.1827956989247312,0.8172043010752689,0.5591397849462365,0.44086021505376344,103,0,0,103,100,3,0.0,0.0,1.0,0.970873786407767,0.02912621359223301
5020,143,10,133,104,39,0.06993006993006994,0.9300699300699301,0.7272727272727273,0.2727272727272727,132,0,24,108,131,1,0.0,0.18181818181818182,0.8181818181818182,0.9924242424242424,0.007575757575757576
5021,132,8,124,103,29,0.06060606060606061,0.9393939393939394,0.7803030303030303,0.2196969696969697,96,0,12,84,94,2,0.0,0.125,0.875,0.9791666666666666,0.020833333333333332
5022,120,9,111,96,24,0.075,0.925,0.8,0.2,85,0,7,78,83,2,0.0,0.08235294117647059,0.9176470588235294,0.9764705882352941,0.023529411764705882
5023,87,11,76,59,28,0.12643678160919541,0.8735632183908046,0.6781609195402298,0.3218390804597701,114,0,0,114,110,4,0.0,0.0,1.0,0.9649122807017544,0.03508771929824561
5024,86,10,76,51,35,0.11627906976744186,0.8837209302325582,0.5930232558139535,0.4069767441860465,113,0,0,113,110,3,0.0,0.0,1.0,0.9734513274336283,0.02654867256637168
5025,128,18,110,80,48,0.140625,0.859375,0.625,0.375,113,0,1,112,109,4,0.0,0.008849557522123894,0.9911504424778761,0.9646017699115044,0.035398230088495575
5026,123,8,115,95,28,0.06504065040650407,0.9349593495934959,0.7723577235772358,0.22764227642276422,106,0,18,88,104,2,0.0,0.16981132075471697,0.8301886792452831,0.9811320754716981,0.018867924528301886
5027,191,13,178,148,43,0.06806282722513089,0.9319371727748691,0.774869109947644,0.225130890052356,143,0,25,118,140,3,0.0,0.17482517482517482,0.8251748251748252,0.9790209790209791,0.02097902097902098
5028,116,10,106,80,36,0.08620689655172414,0.9137931034482759,0.6896551724137931,0.3103448275862069,106,0,1,105,102,4,0.0,0.009433962264150943,0.9905660377358491,0.9622641509433962,0.03773584905660377
5029,193,16,177,151,42,0.08290155440414508,0.917098445595855,0.7823834196891192,0.21761658031088082,134,0,24,110,131,3,0.0,0.1791044776119403,0.8208955223880597,0.9776119402985075,0.022388059701492536
5030,198,21,177,153,45,0.10606060606060606,0.8939393939393939,0.7727272727272727,0.22727272727272727,147,0,26,121,144,3,0.0,0.17687074829931973,0.8231292517006803,0.9795918367346939,0.02040816326530612
5031,65,17,48,24,41,0.26153846153846155,0.7384615384615385,0.36923076923076925,0.6307692307692307,146,0,0,146,144,2,0.0,0.0,1.0,0.9863013698630136,0.0136986301369863
5032,132,23,109,84,48,0.17424242424242425,0.8257575757575758,0.6363636363636364,0.36363636363636365,105,0,1,104,101,4,0.0,0.009523809523809525,0.9904761904761905,0.9619047619047619,0.0380952380952381
5033,163,15,148,112,51,0.09202453987730061,0.9079754601226994,0.6871165644171779,0.3128834355828221,145,1,24,120,144,1,0.006896551724137931,0.16551724137931034,0.8275862068965517,0.993103448275862,0.006896551724137931
5034,124,9,115,93,31,0.07258064516129033,0.9274193548387096,0.75,0.25,98,0,15,83,95,3,0.0,0.15306122448979592,0.8469387755102041,0.9693877551020408,0.030612244897959183
5035,95,19,76,58,37,0.2,0.8,0.6105263157894737,0.3894736842105263,114,0,0,114,111,3,0.0,0.0,1.0,0.9736842105263158,0.02631578947368421
5036,213,18,195,167,46,0.08450704225352113,0.9154929577464789,0.784037558685446,0.215962441314554,147,0,24,123,144,3,0.0,0.16326530612244897,0.8367346938775511,0.9795918367346939,0.02040816326530612
5037,125,15,110,77,48,0.12,0.88,0.616,0.384,111,0,1,110,108,3,0.0,0.009009009009009009,0.990990990990991,0.972972972972973,0.02702702702702703
5038,164,16,148,121,43,0.0975609756097561,0.9024390243902439,0.7378048780487805,0.2621951219512195,148,0,24,124,147,1,0.0,0.16216216216216217,0.8378378378378378,0.9932432432432432,0.006756756756756757
5039,129,9,120,93,36,0.06976744186046512,0.9302325581395349,0.7209302325581395,0.27906976744186046,97,0,15,82,95,2,0.0,0.15463917525773196,0.845360824742268,0.979381443298969,0.020618556701030927
5040,126,7,119,103,23,0.05555555555555555,0.9444444444444444,0.8174603174603174,0.18253968253968253,100,0,12,88,98,2,0.0,0.12,0.88,0.98,0.02
5041,177,29,148,119,58,0.1638418079096045,0.8361581920903954,0.672316384180791,0.327683615819209,149,0,24,125,148,1,0.0,0.1610738255033557,0.8389261744966443,0.9932885906040269,0.006711409395973154
5042,197,16,181,157,40,0.08121827411167512,0.9187817258883249,0.7969543147208121,0.20304568527918782,142,0,26,116,139,3,0.0,0.18309859154929578,0.8169014084507042,0.9788732394366197,0.02112676056338028
5043,126,16,110,79,47,0.12698412698412698,0.873015873015873,0.626984126984127,0.373015873015873,113,0,1,112,109,4,0.0,0.008849557522123894,0.9911504424778761,0.9646017699115044,0.035398230088495575
5044,69,15,54,29,40,0.21739130434782608,0.782608695652174,0.42028985507246375,0.5797101449275363,110,0,30,80,110,0,0.0,0.2727272727272727,0.7272727272727273,1.0,0.0
5045,123,12,111,82,41,0.0975609756097561,0.9024390243902439,0.6666666666666666,0.3333333333333333,105,0,1,104,101,4,0.0,0.009523809523809525,0.9904761904761905,0.9619047619047619,0.0380952380952381
5046,110,6,104,90,20,0.05454545454545454,0.9454545454545454,0.8181818181818182,0.18181818181818182,92,0,16,76,90,2,0.0,0.17391304347826086,0.8260869565217391,0.9782608695652174,0.021739130434782608
5047,164,16,148,109,55,0.0975609756097561,0.9024390243902439,0.6646341463414634,0.3353658536585366,148,1,24,123,147,1,0.006756756756756757,0.16216216216216217,0.831081081081081,0.9932432432432432,0.006756756756756757
5048,107,8,99,59,48,0.07476635514018691,0.9252336448598131,0.5514018691588785,0.4485981308411215,130,0,0,130,127,3,0.0,0.0,1.0,0.9769230769230769,0.023076923076923078
5049,71,17,54,27,44,0.23943661971830985,0.7605633802816901,0.38028169014084506,0.6197183098591549,120,0,32,88,120,0,0.0,0.26666666666666666,0.7333333333333333,1.0,0.0
5050,62,15,47,22,40,0.24193548387096775,0.7580645161290323,0.3548387096774194,0.6451612903225806,136,0,0,136,133,3,0.0,0.0,1.0,0.9779411764705882,0.022058823529411766
5051,126,16,110,81,45,0.12698412698412698,0.873015873015873,0.6428571428571429,0.35714285714285715,105,0,1,104,101,4,0.0,0.009523809523809525,0.9904761904761905,0.9619047619047619,0.0380952380952381
5052,113,8,105,84,29,0.07079646017699115,0.9292035398230089,0.7433628318584071,0.25663716814159293,94,0,17,77,92,2,0.0,0.18085106382978725,0.8191489361702128,0.9787234042553191,0.02127659574468085
5053,121,11,110,79,42,0.09090909090909091,0.9090909090909091,0.6528925619834711,0.34710743801652894,115,0,1,114,111,4,0.0,0.008695652173913044,0.991304347826087,0.9652173913043478,0.034782608695652174
5054,200,19,181,153,47,0.095,0.905,0.765,0.235,140,0,24,116,137,3,0.0,0.17142857142857143,0.8285714285714286,0.9785714285714285,0.02142857142857143
5055,199,18,181,153,46,0.09045226130653267,0.9095477386934674,0.7688442211055276,0.23115577889447236,130,0,26,104,127,3,0.0,0.2,0.8,0.9769230769230769,0.023076923076923078
5056,120,10,110,78,42,0.08333333333333333,0.9166666666666666,0.65,0.35,111,0,1,110,107,4,0.0,0.009009009009009009,0.990990990990991,0.963963963963964,0.036036036036036036
5057,126,17,109,82,44,0.1349206349206349,0.8650793650793651,0.6507936507936508,0.3492063492063492,109,0,1,108,105,4,0.0,0.009174311926605505,0.9908256880733946,0.963302752293578,0.03669724770642202
5058,55,11,44,19,36,0.2,0.8,0.34545454545454546,0.6545454545454545,98,0,30,68,98,0,0.0,0.30612244897959184,0.6938775510204082,1.0,0.0
5059,39,4,35,31,8,0.10256410256410256,0.8974358974358975,0.7948717948717948,0.20512820512820512,90,0,20,70,87,3,0.0,0.2222222222222222,0.7777777777777778,0.9666666666666667,0.03333333333333333
5060,195,14,181,156,39,0.07179487179487179,0.9282051282051282,0.8,0.2,137,0,26,111,135,2,0.0,0.1897810218978102,0.8102189781021898,0.9854014598540146,0.014598540145985401
5061,168,20,148,114,54,0.11904761904761904,0.8809523809523809,0.6785714285714286,0.32142857142857145,159,0,24,135,158,1,0.0,0.1509433962264151,0.8490566037735849,0.9937106918238994,0.006289308176100629
5062,117,8,109,94,23,0.06837606837606838,0.9316239316239316,0.8034188034188035,0.19658119658119658,81,0,9,72,79,2,0.0,0.1111111111111111,0.8888888888888888,0.9753086419753086,0.024691358024691357
5063,90,10,80,63,27,0.1111111111111111,0.8888888888888888,0.7,0.3,78,0,1,77,74,4,0.0,0.01282051282051282,0.9871794871794872,0.9487179487179487,0.05128205128205128
5064,195,16,179,154,41,0.08205128205128205,0.9179487179487179,0.7897435897435897,0.21025641025641026,129,0,26,103,127,2,0.0,0.20155038759689922,0.7984496124031008,0.9844961240310077,0.015503875968992248
5065,116,10,106,86,30,0.08620689655172414,0.9137931034482759,0.7413793103448276,0.25862068965517243,76,0,10,66,74,2,0.0,0.13157894736842105,0.868421052631579,0.9736842105263158,0.02631578947368421
5066,194,18,176,151,43,0.09278350515463918,0.9072164948453608,0.7783505154639175,0.22164948453608246,145,0,25,120,142,3,0.0,0.1724137931034483,0.8275862068965517,0.9793103448275862,0.020689655172413793
5067,67,13,54,30,37,0.19402985074626866,0.8059701492537313,0.44776119402985076,0.5522388059701493,103,0,30,73,103,0,0.0,0.2912621359223301,0.7087378640776699,1.0,0.0
5068,66,12,54,26,40,0.18181818181818182,0.8181818181818182,0.3939393939393939,0.6060606060606061,95,0,30,65,95,0,0.0,0.3157894736842105,0.6842105263157895,1.0,0.0
5069,107,16,91,57,50,0.14953271028037382,0.8504672897196262,0.5327102803738317,0.4672897196261682,173,0,54,119,170,3,0.0,0.31213872832369943,0.6878612716763006,0.9826589595375722,0.017341040462427744
5070,206,11,195,165,41,0.05339805825242718,0.9466019417475728,0.8009708737864077,0.19902912621359223,139,0,25,114,136,3,0.0,0.17985611510791366,0.8201438848920863,0.9784172661870504,0.02158273381294964
5071,61,13,48,28,33,0.21311475409836064,0.7868852459016393,0.45901639344262296,0.5409836065573771,136,0,0,136,133,3,0.0,0.0,1.0,0.9779411764705882,0.022058823529411766
5072,123,13,110,78,45,0.10569105691056911,0.8943089430894309,0.6341463414634146,0.36585365853658536,96,0,1,95,93,3,0.0,0.010416666666666666,0.9895833333333334,0.96875,0.03125
5073,122,12,110,86,36,0.09836065573770492,0.9016393442622951,0.7049180327868853,0.29508196721311475,118,0,1,117,114,4,0.0,0.00847457627118644,0.9915254237288136,0.9661016949152542,0.03389830508474576
5074,68,21,47,27,41,0.3088235294117647,0.6911764705882353,0.39705882352941174,0.6029411764705882,145,0,0,145,142,3,0.0,0.0,1.0,0.9793103448275862,0.020689655172413793
5075,165,17,148,117,48,0.10303030303030303,0.896969696969697,0.7090909090909091,0.2909090909090909,140,0,24,116,139,1,0.0,0.17142857142857143,0.8285714285714286,0.9928571428571429,0.007142857142857143
5076,89,7,82,61,28,0.07865168539325842,0.9213483146067416,0.6853932584269663,0.3146067415730337,80,0,1,79,76,4,0.0,0.0125,0.9875,0.95,0.05
5077,89,13,76,58,31,0.14606741573033707,0.8539325842696629,0.651685393258427,0.34831460674157305,109,0,0,109,105,4,0.0,0.0,1.0,0.963302752293578,0.03669724770642202
5078,118,9,109,78,40,0.07627118644067797,0.923728813559322,0.6610169491525424,0.3389830508474576,113,0,1,112,109,4,0.0,0.008849557522123894,0.9911504424778761,0.9646017699115044,0.035398230088495575
5079,77,8,69,54,23,0.1038961038961039,0.8961038961038961,0.7012987012987013,0.2987012987012987,71,0,0,71,67,4,0.0,0.0,1.0,0.9436619718309859,0.056338028169014086
5080,219,24,195,172,47,0.1095890410958904,0.8904109589041096,0.7853881278538812,0.2146118721461187,140,0,26,114,137,3,0.0,0.18571428571428572,0.8142857142857143,0.9785714285714285,0.02142857142857143
5081,193,14,179,152,41,0.07253886010362694,0.927461139896373,0.7875647668393783,0.21243523316062177,136,0,25,111,134,2,0.0,0.18382352941176472,0.8161764705882353,0.9852941176470589,0.014705882352941176
5082,122,12,110,84,38,0.09836065573770492,0.9016393442622951,0.6885245901639344,0.3114754098360656,113,0,1,112,109,4,0.0,0.008849557522123894,0.9911504424778761,0.9646017699115044,0.035398230088495575
5083,190,13,177,151,39,0.06842105263157895,0.9315789473684211,0.7947368421052632,0.20526315789473684,141,0,27,114,138,3,0.0,0.19148936170212766,0.8085106382978723,0.9787234042553191,0.02127659574468085
5084,121,11,110,73,48,0.09090909090909091,0.9090909090909091,0.6033057851239669,0.39669421487603307,115,0,1,114,111,4,0.0,0.008695652173913044,0.991304347826087,0.9652173913043478,0.034782608695652174
5085,126,20,106,77,49,0.15873015873015872,0.8412698412698413,0.6111111111111112,0.3888888888888889,124,0,1,123,120,4,0.0,0.008064516129032258,0.9919354838709677,0.967741935483871,0.03225806451612903
5086,63,15,48,28,35,0.23809523809523808,0.7619047619047619,0.4444444444444444,0.5555555555555556,145,0,0,145,142,3,0.0,0.0,1.0,0.9793103448275862,0.020689655172413793
5087,95,19,76,53,42,0.2,0.8,0.5578947368421052,0.4421052631578947,106,0,0,106,102,4,0.0,0.0,1.0,0.9622641509433962,0.03773584905660377
5088,90,14,76,53,37,0.15555555555555556,0.8444444444444444,0.5888888888888889,0.4111111111111111,114,0,0,114,111,3,0.0,0.0,1.0,0.9736842105263158,0.02631578947368421
5089,128,18,110,79,49,0.140625,0.859375,0.6171875,0.3828125,109,0,1,108,105,4,0.0,0.009174311926605505,0.9908256880733946,0.963302752293578,0.03669724770642202
5090,191,13,178,153,38,0.06806282722513089,0.9319371727748691,0.8010471204188482,0.19895287958115182,150,0,27,123,147,3,0.0,0.18,0.82,0.98,0.02
5091,153,10,143,117,36,0.06535947712418301,0.934640522875817,0.7647058823529411,0.23529411764705882,136,1,24,111,135,1,0.007352941176470588,0.17647058823529413,0.8161764705882353,0.9926470588235294,0.007352941176470588
5092,91,15,76,54,37,0.16483516483516483,0.8351648351648352,0.5934065934065934,0.4065934065934066,116,0,0,116,112,4,0.0,0.0,1.0,0.9655172413793104,0.034482758620689655
5093,92,16,76,54,38,0.17391304347826086,0.8260869565217391,0.5869565217391305,0.41304347826086957,108,0,0,108,104,4,0.0,0.0,1.0,0.9629629629629629,0.037037037037037035
5094,71,17,54,31,40,0.23943661971830985,0.7605633802816901,0.43661971830985913,0.5633802816901409,103,0,32,71,103,0,0.0,0.3106796116504854,0.6893203883495146,1.0,0.0
5095,149,16,133,108,41,0.10738255033557047,0.8926174496644296,0.7248322147651006,0.2751677852348993,142,0,24,118,141,1,0.0,0.16901408450704225,0.8309859154929577,0.9929577464788732,0.007042253521126761
5096,96,20,76,57,39,0.20833333333333334,0.7916666666666666,0.59375,0.40625,109,0,0,109,106,3,0.0,0.0,1.0,0.9724770642201835,0.027522935779816515
5097,120,10,110,78,42,0.08333333333333333,0.9166666666666666,0.65,0.35,108,0,1,107,105,3,0.0,0.009259259259259259,0.9907407407407407,0.9722222222222222,0.027777777777777776
5098,121,18,103,73,48,0.1487603305785124,0.8512396694214877,0.6033057851239669,0.39669421487603307,135,0,0,135,132,3,0.0,0.0,1.0,0.9777777777777777,0.022222222222222223
5099,86,5,81,62,24,0.05813953488372093,0.9418604651162791,0.7209302325581395,0.27906976744186046,88,0,1,87,84,4,0.0,0.011363636363636364,0.9886363636363636,0.9545454545454546,0.045454545454545456
5100,90,14,76,52,38,0.15555555555555556,0.8444444444444444,0.5777777777777777,0.4222222222222222,103,0,0,103,101,2,0.0,0.0,1.0,0.9805825242718447,0.019417475728155338
5101,113,9,104,89,24,0.07964601769911504,0.9203539823008849,0.7876106194690266,0.21238938053097345,92,0,14,78,90,2,0.0,0.15217391304347827,0.8478260869565217,0.9782608695652174,0.021739130434782608
5102,124,14,110,75,49,0.11290322580645161,0.8870967741935484,0.6048387096774194,0.3951612903225806,118,0,2,116,115,3,0.0,0.01694915254237288,0.9830508474576272,0.9745762711864406,0.025423728813559324
5103,110,7,103,86,24,0.06363636363636363,0.9363636363636364,0.7818181818181819,0.21818181818181817,87,0,11,76,85,2,0.0,0.12643678160919541,0.8735632183908046,0.9770114942528736,0.022988505747126436
5104,188,11,177,153,35,0.05851063829787234,0.9414893617021277,0.8138297872340425,0.18617021276595744,139,0,26,113,136,3,0.0,0.18705035971223022,0.8129496402877698,0.9784172661870504,0.02158273381294964
5105,67,13,54,30,37,0.19402985074626866,0.8059701492537313,0.44776119402985076,0.5522388059701493,95,0,32,63,95,0,0.0,0.3368421052631579,0.6631578947368421,1.0,0.0
5106,84,8,76,55,29,0.09523809523809523,0.9047619047619048,0.6547619047619048,0.34523809523809523,116,0,0,116,113,3,0.0,0.0,1.0,0.9741379310344828,0.02586206896551724
5107,129,8,121,98,31,0.06201550387596899,0.937984496124031,0.7596899224806202,0.24031007751937986,93,0,11,82,91,2,0.0,0.11827956989247312,0.8817204301075269,0.978494623655914,0.021505376344086023
5108,125,15,110,77,48,0.12,0.88,0.616,0.384,115,0,1,114,111,4,0.0,0.008695652173913044,0.991304347826087,0.9652173913043478,0.034782608695652174
5109,89,13,76,52,37,0.14606741573033707,0.8539325842696629,0.5842696629213483,0.4157303370786517,112,0,0,112,108,4,0.0,0.0,1.0,0.9642857142857143,0.03571428571428571
5110,116,10,106,98,18,0.08620689655172414,0.9137931034482759,0.8448275862068966,0.15517241379310345,77,0,9,68,75,2,0.0,0.11688311688311688,0.8831168831168831,0.974025974025974,0.025974025974025976
5111,62,15,47,22,40,0.24193548387096775,0.7580645161290323,0.3548387096774194,0.6451612903225806,134,0,0,134,132,2,0.0,0.0,1.0,0.9850746268656716,0.014925373134328358
5112,87,11,76,56,31,0.12643678160919541,0.8735632183908046,0.6436781609195402,0.3563218390804598,122,0,0,122,120,2,0.0,0.0,1.0,0.9836065573770492,0.01639344262295082
5113,114,12,102,76,38,0.10526315789473684,0.8947368421052632,0.6666666666666666,0.3333333333333333,123,0,0,123,120,3,0.0,0.0,1.0,0.975609756097561,0.024390243902439025
5114,115,6,109,93,22,0.05217391304347826,0.9478260869565217,0.808695652173913,0.19130434782608696,83,0,10,73,81,2,0.0,0.12048192771084337,0.8795180722891566,0.9759036144578314,0.024096385542168676
5115,113,22,91,61,52,0.19469026548672566,0.8053097345132744,0.5398230088495575,0.46017699115044247,175,0,54,121,171,4,0.0,0.30857142857142855,0.6914285714285714,0.9771428571428571,0.022857142857142857
5116,119,5,114,96,23,0.04201680672268908,0.957983193277311,0.8067226890756303,0.19327731092436976,107,0,17,90,105,2,0.0,0.1588785046728972,0.8411214953271028,0.9813084112149533,0.018691588785046728
5117,128,19,109,81,47,0.1484375,0.8515625,0.6328125,0.3671875,123,0,1,122,119,4,0.0,0.008130081300813009,0.991869918699187,0.967479674796748,0.032520325203252036
5118,126,16,110,83,43,0.12698412698412698,0.873015873015873,0.6587301587301587,0.3412698412698413,107,0,1,106,103,4,0.0,0.009345794392523364,0.9906542056074766,0.9626168224299065,0.037383177570093455
5119,91,15,76,56,35,0.16483516483516483,0.8351648351648352,0.6153846153846154,0.38461538461538464,106,0,0,106,103,3,0.0,0.0,1.0,0.9716981132075472,0.02830188679245283
5120,191,12,179,151,40,0.06282722513089005,0.93717277486911,0.7905759162303665,0.2094240837696335,141,0,26,115,138,3,0.0,0.18439716312056736,0.8156028368794326,0.9787234042553191,0.02127659574468085
5121,121,11,110,77,44,0.09090909090909091,0.9090909090909091,0.6363636363636364,0.36363636363636365,119,0,1,118,116,3,0.0,0.008403361344537815,0.9915966386554622,0.9747899159663865,0.025210084033613446
5122,129,18,111,84,45,0.13953488372093023,0.8604651162790697,0.6511627906976745,0.3488372093023256,99,0,2,97,96,3,0.0,0.020202020202020204,0.9797979797979798,0.9696969696969697,0.030303030303030304
5123,90,14,76,54,36,0.15555555555555556,0.8444444444444444,0.6,0.4,114,0,0,114,111,3,0.0,0.0,1.0,0.9736842105263158,0.02631578947368421
5124,114,6,108,94,20,0.05263157894736842,0.9473684210526315,0.8245614035087719,0.17543859649122806,82,0,7,75,79,3,0.0,0.08536585365853659,0.9146341463414634,0.9634146341463414,0.036585365853658534
5125,126,10,116,88,38,0.07936507936507936,0.9206349206349206,0.6984126984126984,0.30158730158730157,97,0,13,84,95,2,0.0,0.13402061855670103,0.865979381443299,0.979381443298969,0.020618556701030927
5126,45,11,34,18,27,0.24444444444444444,0.7555555555555555,0.4,0.6,88,0,31,57,88,0,0.0,0.3522727272727273,0.6477272727272727,1.0,0.0
5127,39,4,35,33,6,0.10256410256410256,0.8974358974358975,0.8461538461538461,0.15384615384615385,90,0,18,72,87,3,0.0,0.2,0.8,0.9666666666666667,0.03333333333333333
5128,124,18,106,80,44,0.14516129032258066,0.8548387096774194,0.6451612903225806,0.3548387096774194,111,0,1,110,107,4,0.0,0.009009009009009009,0.990990990990991,0.963963963963964,0.036036036036036036
5129,128,18,110,81,47,0.140625,0.859375,0.6328125,0.3671875,111,0,1,110,107,4,0.0,0.009009009009009009,0.990990990990991,0.963963963963964,0.036036036036036036
5130,117,8,109,93,24,0.06837606837606838,0.9316239316239316,0.7948717948717948,0.20512820512820512,84,0,12,72,82,2,0.0,0.14285714285714285,0.8571428571428571,0.9761904761904762,0.023809523809523808
5131,57,10,47,24,33,0.17543859649122806,0.8245614035087719,0.42105263157894735,0.5789473684210527,141,0,0,141,138,3,0.0,0.0,1.0,0.9787234042553191,0.02127659574468085
5132,120,10,110,77,43,0.08333333333333333,0.9166666666666666,0.6416666666666667,0.35833333333333334,99,0,1,98,95,4,0.0,0.010101010101010102,0.98989898989899,0.9595959595959596,0.04040404040404041
5133,187,7,180,151,36,0.0374331550802139,0.9625668449197861,0.8074866310160428,0.1925133689839572,142,0,29,113,139,3,0.0,0.20422535211267606,0.795774647887324,0.9788732394366197,0.02112676056338028
5134,81,16,65,41,40,0.19753086419753085,0.8024691358024691,0.5061728395061729,0.49382716049382713,97,0,29,68,97,0,0.0,0.29896907216494845,0.7010309278350515,1.0,0.0
5135,161,13,148,110,51,0.08074534161490683,0.9192546583850931,0.6832298136645962,0.3167701863354037,149,1,24,124,148,1,0.006711409395973154,0.1610738255033557,0.8322147651006712,0.9932885906040269,0.006711409395973154
5136,158,15,143,111,47,0.0949367088607595,0.9050632911392406,0.7025316455696202,0.2974683544303797,147,0,24,123,146,1,0.0,0.16326530612244897,0.8367346938775511,0.9931972789115646,0.006802721088435374
5137,65,17,48,26,39,0.26153846153846155,0.7384615384615385,0.4,0.6,149,0,0,149,146,3,0.0,0.0,1.0,0.9798657718120806,0.020134228187919462
5138,63,9,54,28,35,0.14285714285714285,0.8571428571428571,0.4444444444444444,0.5555555555555556,99,0,31,68,99,0,0.0,0.31313131313131315,0.6868686868686869,1.0,0.0
5139,124,13,111,82,42,0.10483870967741936,0.8951612903225806,0.6612903225806451,0.3387096774193548,107,0,2,105,103,4,0.0,0.018691588785046728,0.9813084112149533,0.9626168224299065,0.037383177570093455
5140,198,16,182,155,43,0.08080808080808081,0.9191919191919192,0.7828282828282829,0.21717171717171718,143,0,26,117,140,3,0.0,0.18181818181818182,0.8181818181818182,0.9790209790209791,0.02097902097902098
5141,106,10,96,69,37,0.09433962264150944,0.9056603773584906,0.6509433962264151,0.3490566037735849,123,0,0,123,120,3,0.0,0.0,1.0,0.975609756097561,0.024390243902439025
5142,65,18,47,27,38,0.27692307692307694,0.7230769230769231,0.4153846153846154,0.5846153846153846,136,0,0,136,133,3,0.0,0.0,1.0,0.9779411764705882,0.022058823529411766
5143,116,7,109,92,24,0.0603448275862069,0.9396551724137931,0.7931034482758621,0.20689655172413793,93,0,12,81,91,2,0.0,0.12903225806451613,0.8709677419354839,0.978494623655914,0.021505376344086023
5144,64,17,47,27,37,0.265625,0.734375,0.421875,0.578125,135,0,0,135,132,3,0.0,0.0,1.0,0.9777777777777777,0.022222222222222223
5145,112,7,105,91,21,0.0625,0.9375,0.8125,0.1875,89,0,13,76,87,2,0.0,0.14606741573033707,0.8539325842696629,0.9775280898876404,0.02247191011235955
5146,122,13,109,85,37,0.10655737704918032,0.8934426229508197,0.6967213114754098,0.30327868852459017,105,0,0,105,101,4,0.0,0.0,1.0,0.9619047619047619,0.0380952380952381
5147,125,15,110,84,41,0.12,0.88,0.672,0.328,115,0,1,114,112,3,0.0,0.008695652173913044,0.991304347826087,0.9739130434782609,0.02608695652173913
5148,88,12,76,52,36,0.13636363636363635,0.8636363636363636,0.5909090909090909,0.4090909090909091,120,0,0,120,117,3,0.0,0.0,1.0,0.975,0.025
5149,86,10,76,56,30,0.11627906976744186,0.8837209302325582,0.6511627906976745,0.3488372093023256,115,0,0,115,111,4,0.0,0.0,1.0,0.9652173913043478,0.034782608695652174
5150,188,10,178,152,36,0.05319148936170213,0.9468085106382979,0.8085106382978723,0.19148936170212766,142,0,26,116,139,3,0.0,0.18309859154929578,0.8169014084507042,0.9788732394366197,0.02112676056338028
5151,124,15,109,83,41,0.12096774193548387,0.8790322580645161,0.6693548387096774,0.33064516129032256,119,0,1,118,115,4,0.0,0.008403361344537815,0.9915966386554622,0.9663865546218487,0.03361344537815126
5152,251,240,11,248,3,0.9561752988047809,0.043824701195219126,0.9880478087649402,0.01195219123505976,373,0,59,314,108,265,0.0,0.1581769436997319,0.8418230563002681,0.289544235924933,0.710455764075067
5153,129,19,110,81,48,0.14728682170542637,0.8527131782945736,0.627906976744186,0.37209302325581395,108,0,1,107,104,4,0.0,0.009259259259259259,0.9907407407407407,0.9629629629629629,0.037037037037037035
5154,146,13,133,103,43,0.08904109589041095,0.910958904109589,0.7054794520547946,0.2945205479452055,130,0,24,106,129,1,0.0,0.18461538461538463,0.8153846153846154,0.9923076923076923,0.007692307692307693
5155,44,10,34,20,24,0.22727272727272727,0.7727272727272727,0.45454545454545453,0.5454545454545454,98,0,32,66,98,0,0.0,0.32653061224489793,0.673469387755102,1.0,0.0
5156,147,14,133,106,41,0.09523809523809523,0.9047619047619048,0.7210884353741497,0.2789115646258503,127,0,24,103,126,1,0.0,0.1889763779527559,0.8110236220472441,0.9921259842519685,0.007874015748031496
5157,60,12,48,27,33,0.2,0.8,0.45,0.55,146,0,0,146,143,3,0.0,0.0,1.0,0.9794520547945206,0.02054794520547945
5158,105,14,91,61,44,0.13333333333333333,0.8666666666666667,0.580952380952381,0.41904761904761906,175,0,54,121,173,2,0.0,0.30857142857142855,0.6914285714285714,0.9885714285714285,0.011428571428571429
5159,68,14,54,29,39,0.20588235294117646,0.7941176470588235,0.4264705882352941,0.5735294117647058,98,0,33,65,98,0,0.0,0.336734693877551,0.6632653061224489,1.0,0.0
5160,124,14,110,87,37,0.11290322580645161,0.8870967741935484,0.7016129032258065,0.29838709677419356,108,0,0,108,104,4,0.0,0.0,1.0,0.9629629629629629,0.037037037037037035
5161,75,5,70,53,22,0.06666666666666667,0.9333333333333333,0.7066666666666667,0.29333333333333333,84,0,1,83,80,4,0.0,0.011904761904761904,0.9880952380952381,0.9523809523809523,0.047619047619047616
5162,109,18,91,55,54,0.1651376146788991,0.8348623853211009,0.5045871559633027,0.4954128440366973,169,0,54,115,166,3,0.0,0.31952662721893493,0.6804733727810651,0.9822485207100592,0.01775147928994083
5163,134,10,124,91,43,0.07462686567164178,0.9253731343283582,0.6791044776119403,0.3208955223880597,97,0,12,85,95,2,0.0,0.12371134020618557,0.8762886597938144,0.979381443298969,0.020618556701030927
5164,80,15,65,38,42,0.1875,0.8125,0.475,0.525,88,0,28,60,88,0,0.0,0.3181818181818182,0.6818181818181818,1.0,0.0
5165,86,10,76,56,30,0.11627906976744186,0.8837209302325582,0.6511627906976745,0.3488372093023256,110,0,0,110,106,4,0.0,0.0,1.0,0.9636363636363636,0.03636363636363636
5166,200,20,180,153,47,0.1,0.9,0.765,0.235,149,0,24,125,146,3,0.0,0.1610738255033557,0.8389261744966443,0.9798657718120806,0.020134228187919462
5167,92,16,76,52,40,0.17391304347826086,0.8260869565217391,0.5652173913043478,0.43478260869565216,107,0,0,107,103,4,0.0,0.0,1.0,0.9626168224299065,0.037383177570093455
5168,70,16,54,30,40,0.22857142857142856,0.7714285714285715,0.42857142857142855,0.5714285714285714,104,0,32,72,104,0,0.0,0.3076923076923077,0.6923076923076923,1.0,0.0
5169,63,16,47,23,40,0.25396825396825395,0.746031746031746,0.36507936507936506,0.6349206349206349,129,0,0,129,126,3,0.0,0.0,1.0,0.9767441860465116,0.023255813953488372
5170,47,13,34,19,28,0.2765957446808511,0.723404255319149,0.40425531914893614,0.5957446808510638,87,0,30,57,87,0,0.0,0.3448275862068966,0.6551724137931034,1.0,0.0
5171,109,18,91,58,51,0.1651376146788991,0.8348623853211009,0.5321100917431193,0.46788990825688076,178,0,54,124,174,4,0.0,0.30337078651685395,0.6966292134831461,0.9775280898876404,0.02247191011235955
5172,66,12,54,25,41,0.18181818181818182,0.8181818181818182,0.3787878787878788,0.6212121212121212,102,0,31,71,102,0,0.0,0.30392156862745096,0.696078431372549,1.0,0.0
5173,77,13,64,38,39,0.16883116883116883,0.8311688311688312,0.4935064935064935,0.5064935064935064,95,0,28,67,95,0,0.0,0.29473684210526313,0.7052631578947368,1.0,0.0
5174,112,13,99,87,25,0.11607142857142858,0.8839285714285714,0.7767857142857143,0.22321428571428573,91,0,18,73,89,2,0.0,0.1978021978021978,0.8021978021978022,0.978021978021978,0.02197802197802198
5175,110,4,106,93,17,0.03636363636363636,0.9636363636363636,0.8454545454545455,0.15454545454545454,84,0,11,73,82,2,0.0,0.13095238095238096,0.8690476190476191,0.9761904761904762,0.023809523809523808
5176,116,21,95,66,50,0.1810344827586207,0.8189655172413793,0.5689655172413793,0.43103448275862066,113,0,0,113,110,3,0.0,0.0,1.0,0.9734513274336283,0.02654867256637168
5177,121,9,112,97,24,0.0743801652892562,0.9256198347107438,0.8016528925619835,0.19834710743801653,106,0,18,88,103,3,0.0,0.16981132075471697,0.8301886792452831,0.9716981132075472,0.02830188679245283
5178,94,18,76,54,40,0.19148936170212766,0.8085106382978723,0.574468085106383,0.425531914893617,101,0,0,101,98,3,0.0,0.0,1.0,0.9702970297029703,0.0297029702970297
5179,124,14,110,86,38,0.11290322580645161,0.8870967741935484,0.6935483870967742,0.3064516129032258,106,0,1,105,102,4,0.0,0.009433962264150943,0.9905660377358491,0.9622641509433962,0.03773584905660377
5180,73,19,54,28,45,0.2602739726027397,0.7397260273972602,0.3835616438356164,0.6164383561643836,103,0,31,72,103,0,0.0,0.30097087378640774,0.6990291262135923,1.0,0.0
5181,123,13,110,80,43,0.10569105691056911,0.8943089430894309,0.6504065040650406,0.34959349593495936,109,0,1,108,105,4,0.0,0.009174311926605505,0.9908256880733946,0.963302752293578,0.03669724770642202
5182,123,13,110,80,43,0.10569105691056911,0.8943089430894309,0.6504065040650406,0.34959349593495936,106,0,1,105,102,4,0.0,0.009433962264150943,0.9905660377358491,0.9622641509433962,0.03773584905660377
5183,194,15,179,156,38,0.07731958762886598,0.9226804123711341,0.8041237113402062,0.1958762886597938,141,0,26,115,138,3,0.0,0.18439716312056736,0.8156028368794326,0.9787234042553191,0.02127659574468085
5184,120,13,107,79,41,0.10833333333333334,0.8916666666666667,0.6583333333333333,0.3416666666666667,109,0,2,107,105,4,0.0,0.01834862385321101,0.981651376146789,0.963302752293578,0.03669724770642202
5185,92,16,76,53,39,0.17391304347826086,0.8260869565217391,0.5760869565217391,0.42391304347826086,106,0,0,106,102,4,0.0,0.0,1.0,0.9622641509433962,0.03773584905660377
5186,116,9,107,81,35,0.07758620689655173,0.9224137931034483,0.6982758620689655,0.3017241379310345,119,0,2,117,115,4,0.0,0.01680672268907563,0.9831932773109243,0.9663865546218487,0.03361344537815126
5187,202,18,184,158,44,0.0891089108910891,0.9108910891089109,0.7821782178217822,0.21782178217821782,138,0,26,112,135,3,0.0,0.18840579710144928,0.8115942028985508,0.9782608695652174,0.021739130434782608
5188,189,12,177,151,38,0.06349206349206349,0.9365079365079365,0.798941798941799,0.20105820105820105,141,0,28,113,138,3,0.0,0.19858156028368795,0.8014184397163121,0.9787234042553191,0.02127659574468085
5189,212,16,196,170,42,0.07547169811320754,0.9245283018867925,0.8018867924528302,0.19811320754716982,154,0,25,129,151,3,0.0,0.16233766233766234,0.8376623376623377,0.9805194805194806,0.01948051948051948
5190,37,5,32,28,9,0.13513513513513514,0.8648648648648649,0.7567567567567568,0.24324324324324326,95,0,22,73,93,2,0.0,0.23157894736842105,0.7684210526315789,0.9789473684210527,0.021052631578947368
5191,66,19,47,29,37,0.2878787878787879,0.7121212121212122,0.4393939393939394,0.5606060606060606,142,0,0,142,139,3,0.0,0.0,1.0,0.9788732394366197,0.02112676056338028
5192,66,19,47,27,39,0.2878787878787879,0.7121212121212122,0.4090909090909091,0.5909090909090909,148,0,0,148,145,3,0.0,0.0,1.0,0.9797297297297297,0.02027027027027027
5193,109,4,105,88,21,0.03669724770642202,0.963302752293578,0.8073394495412844,0.1926605504587156,88,0,10,78,86,2,0.0,0.11363636363636363,0.8863636363636364,0.9772727272727273,0.022727272727272728
5194,108,9,99,84,24,0.08333333333333333,0.9166666666666666,0.7777777777777778,0.2222222222222222,95,0,16,79,93,2,0.0,0.16842105263157894,0.8315789473684211,0.9789473684210527,0.021052631578947368
5195,118,8,110,84,34,0.06779661016949153,0.9322033898305084,0.711864406779661,0.288135593220339,114,0,1,113,110,4,0.0,0.008771929824561403,0.9912280701754386,0.9649122807017544,0.03508771929824561
5196,79,14,65,39,40,0.17721518987341772,0.8227848101265823,0.4936708860759494,0.5063291139240507,106,0,30,76,106,0,0.0,0.2830188679245283,0.7169811320754716,1.0,0.0
5197,115,12,103,69,46,0.10434782608695652,0.8956521739130435,0.6,0.4,111,0,0,111,108,3,0.0,0.0,1.0,0.972972972972973,0.02702702702702703
5198,121,12,109,80,41,0.09917355371900827,0.9008264462809917,0.6611570247933884,0.33884297520661155,117,0,1,116,113,4,0.0,0.008547008547008548,0.9914529914529915,0.9658119658119658,0.03418803418803419
5199,119,10,109,97,22,0.08403361344537816,0.9159663865546218,0.8151260504201681,0.18487394957983194,89,0,11,78,87,2,0.0,0.12359550561797752,0.8764044943820225,0.9775280898876404,0.02247191011235955
5200,66,5,61,49,17,0.07575757575757576,0.9242424242424242,0.7424242424242424,0.25757575757575757,81,0,0,81,77,4,0.0,0.0,1.0,0.9506172839506173,0.04938271604938271
5201,80,15,65,37,43,0.1875,0.8125,0.4625,0.5375,91,0,28,63,91,0,0.0,0.3076923076923077,0.6923076923076923,1.0,0.0
5202,62,14,48,29,33,0.22580645161290322,0.7741935483870968,0.46774193548387094,0.532258064516129,144,0,0,144,141,3,0.0,0.0,1.0,0.9791666666666666,0.020833333333333332
5203,74,11,63,37,37,0.14864864864864866,0.8513513513513513,0.5,0.5,103,0,32,71,103,0,0.0,0.3106796116504854,0.6893203883495146,1.0,0.0
5204,215,17,198,169,46,0.07906976744186046,0.9209302325581395,0.786046511627907,0.21395348837209302,134,0,24,110,132,2,0.0,0.1791044776119403,0.8208955223880597,0.9850746268656716,0.014925373134328358
5205,119,9,110,97,22,0.07563025210084033,0.9243697478991597,0.8151260504201681,0.18487394957983194,81,0,7,74,79,2,0.0,0.08641975308641975,0.9135802469135802,0.9753086419753086,0.024691358024691357
5206,153,20,133,104,49,0.13071895424836602,0.869281045751634,0.6797385620915033,0.3202614379084967,136,0,24,112,135,1,0.0,0.17647058823529413,0.8235294117647058,0.9926470588235294,0.007352941176470588
5207,87,11,76,50,37,0.12643678160919541,0.8735632183908046,0.5747126436781609,0.42528735632183906,117,0,0,117,114,3,0.0,0.0,1.0,0.9743589743589743,0.02564102564102564
5208,199,23,176,147,52,0.11557788944723618,0.8844221105527639,0.7386934673366834,0.2613065326633166,136,0,25,111,134,2,0.0,0.18382352941176472,0.8161764705882353,0.9852941176470589,0.014705882352941176
5209,120,10,110,78,42,0.08333333333333333,0.9166666666666666,0.65,0.35,108,0,1,107,104,4,0.0,0.009259259259259259,0.9907407407407407,0.9629629629629629,0.037037037037037035
5210,70,16,54,30,40,0.22857142857142856,0.7714285714285715,0.42857142857142855,0.5714285714285714,99,0,32,67,99,0,0.0,0.32323232323232326,0.6767676767676768,1.0,0.0
5211,73,9,64,34,39,0.1232876712328767,0.8767123287671232,0.4657534246575342,0.5342465753424658,93,0,30,63,93,0,0.0,0.3225806451612903,0.6774193548387096,1.0,0.0
5212,145,134,11,142,3,0.9241379310344827,0.07586206896551724,0.9793103448275862,0.020689655172413793,2,0,0,2,2,0,0.0,0.0,1.0,1.0,0.0
5213,40,6,34,31,9,0.15,0.85,0.775,0.225,78,0,13,65,76,2,0.0,0.16666666666666666,0.8333333333333334,0.9743589743589743,0.02564102564102564
5214,69,15,54,28,41,0.21739130434782608,0.782608695652174,0.4057971014492754,0.5942028985507246,104,0,32,72,104,0,0.0,0.3076923076923077,0.6923076923076923,1.0,0.0
5215,39,3,36,32,7,0.07692307692307693,0.9230769230769231,0.8205128205128205,0.1794871794871795,85,0,17,68,82,3,0.0,0.2,0.8,0.9647058823529412,0.03529411764705882
5216,192,14,178,150,42,0.07291666666666667,0.9270833333333334,0.78125,0.21875,139,0,27,112,137,2,0.0,0.19424460431654678,0.8057553956834532,0.9856115107913669,0.014388489208633094
5217,116,7,109,98,18,0.0603448275862069,0.9396551724137931,0.8448275862068966,0.15517241379310345,89,0,10,79,87,2,0.0,0.11235955056179775,0.8876404494382022,0.9775280898876404,0.02247191011235955
5218,127,10,117,92,35,0.07874015748031496,0.9212598425196851,0.7244094488188977,0.2755905511811024,103,0,16,87,101,2,0.0,0.1553398058252427,0.8446601941747572,0.9805825242718447,0.019417475728155338
5219,131,113,18,128,3,0.8625954198473282,0.13740458015267176,0.9770992366412213,0.022900763358778626,353,1,33,319,103,250,0.0028328611898017,0.09348441926345609,0.9036827195467422,0.29178470254957506,0.7082152974504249
5220,37,3,34,32,5,0.08108108108108109,0.918918918918919,0.8648648648648649,0.13513513513513514,89,0,19,70,86,3,0.0,0.21348314606741572,0.7865168539325843,0.9662921348314607,0.033707865168539325
5221,198,16,182,156,42,0.08080808080808081,0.9191919191919192,0.7878787878787878,0.21212121212121213,139,0,27,112,137,2,0.0,0.19424460431654678,0.8057553956834532,0.9856115107913669,0.014388489208633094
5222,107,6,101,90,17,0.056074766355140186,0.9439252336448598,0.8411214953271028,0.1588785046728972,88,0,14,74,86,2,0.0,0.1590909090909091,0.8409090909090909,0.9772727272727273,0.022727272727272728
5223,150,17,133,98,52,0.11333333333333333,0.8866666666666667,0.6533333333333333,0.3466666666666667,140,0,24,116,139,1,0.0,0.17142857142857143,0.8285714285714286,0.9928571428571429,0.007142857142857143
5224,130,9,121,103,27,0.06923076923076923,0.9307692307692308,0.7923076923076923,0.2076923076923077,99,0,10,89,97,2,0.0,0.10101010101010101,0.898989898989899,0.9797979797979798,0.020202020202020204
5225,201,22,179,153,48,0.10945273631840796,0.8905472636815921,0.7611940298507462,0.23880597014925373,144,0,26,118,141,3,0.0,0.18055555555555555,0.8194444444444444,0.9791666666666666,0.020833333333333332
5226,209,13,196,166,43,0.06220095693779904,0.937799043062201,0.7942583732057417,0.20574162679425836,138,0,24,114,135,3,0.0,0.17391304347826086,0.8260869565217391,0.9782608695652174,0.021739130434782608
5227,70,16,54,29,41,0.22857142857142856,0.7714285714285715,0.4142857142857143,0.5857142857142857,99,0,30,69,99,0,0.0,0.30303030303030304,0.696969696969697,1.0,0.0
5228,59,12,47,28,31,0.2033898305084746,0.7966101694915254,0.4745762711864407,0.5254237288135594,134,0,0,134,131,3,0.0,0.0,1.0,0.9776119402985075,0.022388059701492536
5229,121,11,110,75,46,0.09090909090909091,0.9090909090909091,0.6198347107438017,0.38016528925619836,102,0,1,101,99,3,0.0,0.00980392156862745,0.9901960784313726,0.9705882352941176,0.029411764705882353
5230,60,13,47,27,33,0.21666666666666667,0.7833333333333333,0.45,0.55,128,0,0,128,125,3,0.0,0.0,1.0,0.9765625,0.0234375
5231,56,12,44,20,36,0.21428571428571427,0.7857142857142857,0.35714285714285715,0.6428571428571429,93,0,30,63,93,0,0.0,0.3225806451612903,0.6774193548387096,1.0,0.0
5232,112,21,91,60,52,0.1875,0.8125,0.5357142857142857,0.4642857142857143,183,0,54,129,181,2,0.0,0.29508196721311475,0.7049180327868853,0.9890710382513661,0.01092896174863388
5233,125,15,110,79,46,0.12,0.88,0.632,0.368,107,0,1,106,104,3,0.0,0.009345794392523364,0.9906542056074766,0.9719626168224299,0.028037383177570093
5234,135,25,110,84,51,0.18518518518518517,0.8148148148148148,0.6222222222222222,0.37777777777777777,118,0,1,117,114,4,0.0,0.00847457627118644,0.9915254237288136,0.9661016949152542,0.03389830508474576
5235,110,5,105,93,17,0.045454545454545456,0.9545454545454546,0.8454545454545455,0.15454545454545454,88,0,10,78,85,3,0.0,0.11363636363636363,0.8863636363636364,0.9659090909090909,0.03409090909090909
5236,42,6,36,34,8,0.14285714285714285,0.8571428571428571,0.8095238095238095,0.19047619047619047,91,0,19,72,88,3,0.0,0.2087912087912088,0.7912087912087912,0.967032967032967,0.03296703296703297
5237,166,18,148,111,55,0.10843373493975904,0.891566265060241,0.6686746987951807,0.3313253012048193,148,0,24,124,147,1,0.0,0.16216216216216217,0.8378378378378378,0.9932432432432432,0.006756756756756757
5238,126,19,107,75,51,0.15079365079365079,0.8492063492063492,0.5952380952380952,0.40476190476190477,120,0,2,118,116,4,0.0,0.016666666666666666,0.9833333333333333,0.9666666666666667,0.03333333333333333
5239,124,13,111,83,41,0.10483870967741936,0.8951612903225806,0.6693548387096774,0.33064516129032256,114,0,2,112,110,4,0.0,0.017543859649122806,0.9824561403508771,0.9649122807017544,0.03508771929824561
5240,176,138,38,173,3,0.7840909090909091,0.2159090909090909,0.9829545454545454,0.017045454545454544,376,0,48,328,108,268,0.0,0.1276595744680851,0.8723404255319149,0.2872340425531915,0.7127659574468085
5241,111,15,96,65,46,0.13513513513513514,0.8648648648648649,0.5855855855855856,0.4144144144144144,145,0,0,145,142,3,0.0,0.0,1.0,0.9793103448275862,0.020689655172413793
5242,79,7,72,61,18,0.08860759493670886,0.9113924050632911,0.7721518987341772,0.22784810126582278,78,0,0,78,74,4,0.0,0.0,1.0,0.9487179487179487,0.05128205128205128
5243,111,8,103,86,25,0.07207207207207207,0.9279279279279279,0.7747747747747747,0.22522522522522523,90,0,15,75,88,2,0.0,0.16666666666666666,0.8333333333333334,0.9777777777777777,0.022222222222222223
5244,67,19,48,25,42,0.2835820895522388,0.7164179104477612,0.373134328358209,0.6268656716417911,151,0,0,151,148,3,0.0,0.0,1.0,0.9801324503311258,0.019867549668874173
5245,117,7,110,82,35,0.05982905982905983,0.9401709401709402,0.7008547008547008,0.29914529914529914,107,0,1,106,103,4,0.0,0.009345794392523364,0.9906542056074766,0.9626168224299065,0.037383177570093455
5246,75,12,63,37,38,0.16,0.84,0.49333333333333335,0.5066666666666667,88,0,28,60,88,0,0.0,0.3181818181818182,0.6818181818181818,1.0,0.0
5247,126,16,110,80,46,0.12698412698412698,0.873015873015873,0.6349206349206349,0.36507936507936506,109,0,1,108,105,4,0.0,0.009174311926605505,0.9908256880733946,0.963302752293578,0.03669724770642202
5248,71,17,54,31,40,0.23943661971830985,0.7605633802816901,0.43661971830985913,0.5633802816901409,101,0,30,71,101,0,0.0,0.297029702970297,0.7029702970297029,1.0,0.0
5249,206,24,182,162,44,0.11650485436893204,0.883495145631068,0.7864077669902912,0.21359223300970873,142,0,26,116,140,2,0.0,0.18309859154929578,0.8169014084507042,0.9859154929577465,0.014084507042253521
5250,58,11,47,28,30,0.1896551724137931,0.8103448275862069,0.4827586206896552,0.5172413793103449,146,0,0,146,143,3,0.0,0.0,1.0,0.9794520547945206,0.02054794520547945
5251,221,23,198,171,50,0.10407239819004525,0.8959276018099548,0.7737556561085973,0.22624434389140272,141,0,26,115,138,3,0.0,0.18439716312056736,0.8156028368794326,0.9787234042553191,0.02127659574468085
5252,132,21,111,89,43,0.1590909090909091,0.8409090909090909,0.6742424242424242,0.32575757575757575,105,0,2,103,101,4,0.0,0.01904761904761905,0.9809523809523809,0.9619047619047619,0.0380952380952381
5253,117,11,106,75,42,0.09401709401709402,0.905982905982906,0.6410256410256411,0.358974358974359,105,0,0,105,101,4,0.0,0.0,1.0,0.9619047619047619,0.0380952380952381
5254,89,13,76,54,35,0.14606741573033707,0.8539325842696629,0.6067415730337079,0.39325842696629215,103,0,0,103,101,2,0.0,0.0,1.0,0.9805825242718447,0.019417475728155338
5255,195,17,178,150,45,0.08717948717948718,0.9128205128205128,0.7692307692307693,0.23076923076923078,144,0,27,117,141,3,0.0,0.1875,0.8125,0.9791666666666666,0.020833333333333332
5256,77,13,64,39,38,0.16883116883116883,0.8311688311688312,0.5064935064935064,0.4935064935064935,104,0,30,74,104,0,0.0,0.28846153846153844,0.7115384615384616,1.0,0.0
5257,127,17,110,79,48,0.13385826771653545,0.8661417322834646,0.6220472440944882,0.3779527559055118,104,0,1,103,100,4,0.0,0.009615384615384616,0.9903846153846154,0.9615384615384616,0.038461538461538464
5258,45,11,34,17,28,0.24444444444444444,0.7555555555555555,0.37777777777777777,0.6222222222222222,78,0,31,47,78,0,0.0,0.3974358974358974,0.6025641025641025,1.0,0.0
5259,91,15,76,55,36,0.16483516483516483,0.8351648351648352,0.6043956043956044,0.3956043956043956,103,0,0,103,99,4,0.0,0.0,1.0,0.9611650485436893,0.038834951456310676
5260,39,5,34,32,7,0.1282051282051282,0.8717948717948718,0.8205128205128205,0.1794871794871795,83,0,16,67,81,2,0.0,0.1927710843373494,0.8072289156626506,0.9759036144578314,0.024096385542168676
5261,40,6,34,32,8,0.15,0.85,0.8,0.2,79,0,15,64,76,3,0.0,0.189873417721519,0.810126582278481,0.9620253164556962,0.0379746835443038
5262,189,13,176,147,42,0.06878306878306878,0.9312169312169312,0.7777777777777778,0.2222222222222222,132,0,26,106,130,2,0.0,0.19696969696969696,0.803030303030303,0.9848484848484849,0.015151515151515152
5263,58,11,47,28,30,0.1896551724137931,0.8103448275862069,0.4827586206896552,0.5172413793103449,138,0,0,138,135,3,0.0,0.0,1.0,0.9782608695652174,0.021739130434782608
5264,76,12,64,36,40,0.15789473684210525,0.8421052631578947,0.47368421052631576,0.5263157894736842,96,0,30,66,96,0,0.0,0.3125,0.6875,1.0,0.0
5265,190,179,11,187,3,0.9421052631578948,0.05789473684210526,0.9842105263157894,0.015789473684210527,353,0,62,291,120,233,0.0,0.17563739376770537,0.8243626062322946,0.33994334277620397,0.660056657223796
5266,89,13,76,55,34,0.14606741573033707,0.8539325842696629,0.6179775280898876,0.38202247191011235,113,0,0,113,109,4,0.0,0.0,1.0,0.9646017699115044,0.035398230088495575
5267,193,18,175,145,48,0.09326424870466321,0.9067357512953368,0.7512953367875648,0.24870466321243523,128,0,27,101,126,2,0.0,0.2109375,0.7890625,0.984375,0.015625
5268,199,19,180,155,44,0.09547738693467336,0.9045226130653267,0.7788944723618091,0.22110552763819097,141,0,27,114,139,2,0.0,0.19148936170212766,0.8085106382978723,0.9858156028368794,0.014184397163120567
5269,105,8,97,68,37,0.0761904761904762,0.9238095238095239,0.6476190476190476,0.3523809523809524,106,0,0,106,103,3,0.0,0.0,1.0,0.9716981132075472,0.02830188679245283
5270,62,15,47,25,37,0.24193548387096775,0.7580645161290323,0.4032258064516129,0.5967741935483871,136,0,0,136,133,3,0.0,0.0,1.0,0.9779411764705882,0.022058823529411766
5271,107,16,91,53,54,0.14953271028037382,0.8504672897196262,0.4953271028037383,0.5046728971962616,172,1,54,117,169,3,0.005813953488372093,0.313953488372093,0.6802325581395349,0.9825581395348837,0.01744186046511628
5272,119,9,110,80,39,0.07563025210084033,0.9243697478991597,0.6722689075630253,0.3277310924369748,118,0,1,117,114,4,0.0,0.00847457627118644,0.9915254237288136,0.9661016949152542,0.03389830508474576
5273,126,16,110,79,47,0.12698412698412698,0.873015873015873,0.626984126984127,0.373015873015873,115,0,1,114,111,4,0.0,0.008695652173913044,0.991304347826087,0.9652173913043478,0.034782608695652174
5274,203,20,183,156,47,0.09852216748768473,0.9014778325123153,0.7684729064039408,0.2315270935960591,145,0,26,119,142,3,0.0,0.1793103448275862,0.8206896551724138,0.9793103448275862,0.020689655172413793
5275,77,11,66,37,40,0.14285714285714285,0.8571428571428571,0.4805194805194805,0.5194805194805194,91,0,26,65,91,0,0.0,0.2857142857142857,0.7142857142857143,1.0,0.0
5276,169,21,148,120,49,0.1242603550295858,0.8757396449704142,0.7100591715976331,0.28994082840236685,146,0,24,122,145,1,0.0,0.1643835616438356,0.8356164383561644,0.9931506849315068,0.00684931506849315
5277,64,17,47,29,35,0.265625,0.734375,0.453125,0.546875,141,0,0,141,138,3,0.0,0.0,1.0,0.9787234042553191,0.02127659574468085
5278,117,8,109,93,24,0.06837606837606838,0.9316239316239316,0.7948717948717948,0.20512820512820512,88,0,9,79,86,2,0.0,0.10227272727272728,0.8977272727272727,0.9772727272727273,0.022727272727272728
5279,89,13,76,56,33,0.14606741573033707,0.8539325842696629,0.6292134831460674,0.3707865168539326,106,0,0,106,103,3,0.0,0.0,1.0,0.9716981132075472,0.02830188679245283
5280,111,15,96,70,41,0.13513513513513514,0.8648648648648649,0.6306306306306306,0.36936936936936937,104,0,0,104,101,3,0.0,0.0,1.0,0.9711538461538461,0.028846153846153848
5281,59,15,44,22,37,0.2542372881355932,0.7457627118644068,0.3728813559322034,0.6271186440677966,97,0,32,65,97,0,0.0,0.32989690721649484,0.6701030927835051,1.0,0.0
5282,122,12,110,85,37,0.09836065573770492,0.9016393442622951,0.6967213114754098,0.30327868852459017,109,0,1,108,106,3,0.0,0.009174311926605505,0.9908256880733946,0.9724770642201835,0.027522935779816515
5283,193,15,178,152,41,0.07772020725388601,0.9222797927461139,0.7875647668393783,0.21243523316062177,139,0,26,113,136,3,0.0,0.18705035971223022,0.8129496402877698,0.9784172661870504,0.02158273381294964
5284,54,7,47,23,31,0.12962962962962962,0.8703703703703703,0.42592592592592593,0.5740740740740741,141,0,0,141,138,3,0.0,0.0,1.0,0.9787234042553191,0.02127659574468085
5285,88,12,76,57,31,0.13636363636363635,0.8636363636363636,0.6477272727272727,0.3522727272727273,107,0,0,107,104,3,0.0,0.0,1.0,0.9719626168224299,0.028037383177570093
5286,127,17,110,81,46,0.13385826771653545,0.8661417322834646,0.6377952755905512,0.36220472440944884,113,0,2,111,109,4,0.0,0.017699115044247787,0.9823008849557522,0.9646017699115044,0.035398230088495575
5287,148,15,133,110,38,0.10135135135135136,0.8986486486486487,0.7432432432432432,0.25675675675675674,142,0,24,118,141,1,0.0,0.16901408450704225,0.8309859154929577,0.9929577464788732,0.007042253521126761
5288,203,21,182,158,45,0.10344827586206896,0.896551724137931,0.7783251231527094,0.22167487684729065,137,0,27,110,134,3,0.0,0.19708029197080293,0.8029197080291971,0.9781021897810219,0.021897810218978103
5289,121,15,106,81,40,0.12396694214876033,0.8760330578512396,0.6694214876033058,0.3305785123966942,130,0,0,130,126,4,0.0,0.0,1.0,0.9692307692307692,0.03076923076923077
5290,119,9,110,84,35,0.07563025210084033,0.9243697478991597,0.7058823529411765,0.29411764705882354,117,0,1,116,113,4,0.0,0.008547008547008548,0.9914529914529915,0.9658119658119658,0.03418803418803419
5291,124,14,110,73,51,0.11290322580645161,0.8870967741935484,0.5887096774193549,0.4112903225806452,106,0,1,105,102,4,0.0,0.009433962264150943,0.9905660377358491,0.9622641509433962,0.03773584905660377
5292,74,6,68,48,26,0.08108108108108109,0.918918918918919,0.6486486486486487,0.35135135135135137,70,0,0,70,66,4,0.0,0.0,1.0,0.9428571428571428,0.05714285714285714
5293,45,11,34,21,24,0.24444444444444444,0.7555555555555555,0.4666666666666667,0.5333333333333333,77,0,30,47,77,0,0.0,0.38961038961038963,0.6103896103896104,1.0,0.0
5294,39,6,33,30,9,0.15384615384615385,0.8461538461538461,0.7692307692307693,0.23076923076923078,97,0,20,77,94,3,0.0,0.20618556701030927,0.7938144329896907,0.9690721649484536,0.030927835051546393
5295,87,8,79,57,30,0.09195402298850575,0.9080459770114943,0.6551724137931034,0.3448275862068966,84,0,1,83,80,4,0.0,0.011904761904761904,0.9880952380952381,0.9523809523809523,0.047619047619047616
5296,89,13,76,58,31,0.14606741573033707,0.8539325842696629,0.651685393258427,0.34831460674157305,114,0,0,114,111,3,0.0,0.0,1.0,0.9736842105263158,0.02631578947368421
5297,66,18,48,28,38,0.2727272727272727,0.7272727272727273,0.42424242424242425,0.5757575757575758,146,0,0,146,143,3,0.0,0.0,1.0,0.9794520547945206,0.02054794520547945
5298,86,10,76,56,30,0.11627906976744186,0.8837209302325582,0.6511627906976745,0.3488372093023256,111,0,0,111,107,4,0.0,0.0,1.0,0.963963963963964,0.036036036036036036
5299,196,18,178,151,45,0.09183673469387756,0.9081632653061225,0.7704081632653061,0.22959183673469388,139,0,24,115,136,3,0.0,0.17266187050359713,0.8273381294964028,0.9784172661870504,0.02158273381294964
5300,107,4,103,82,25,0.037383177570093455,0.9626168224299065,0.7663551401869159,0.2336448598130841,86,0,13,73,84,2,0.0,0.1511627906976744,0.8488372093023255,0.9767441860465116,0.023255813953488372
5301,125,15,110,80,45,0.12,0.88,0.64,0.36,109,0,1,108,105,4,0.0,0.009174311926605505,0.9908256880733946,0.963302752293578,0.03669724770642202
5302,106,6,100,87,19,0.05660377358490566,0.9433962264150944,0.8207547169811321,0.1792452830188679,89,0,13,76,87,2,0.0,0.14606741573033707,0.8539325842696629,0.9775280898876404,0.02247191011235955
5303,57,10,47,25,32,0.17543859649122806,0.8245614035087719,0.43859649122807015,0.5614035087719298,138,0,0,138,136,2,0.0,0.0,1.0,0.9855072463768116,0.014492753623188406
5304,147,14,133,103,44,0.09523809523809523,0.9047619047619048,0.7006802721088435,0.29931972789115646,126,0,24,102,125,1,0.0,0.19047619047619047,0.8095238095238095,0.9920634920634921,0.007936507936507936
5305,200,19,181,156,44,0.095,0.905,0.78,0.22,142,0,26,116,139,3,0.0,0.18309859154929578,0.8169014084507042,0.9788732394366197,0.02112676056338028
5306,165,17,148,115,50,0.10303030303030303,0.896969696969697,0.696969696969697,0.30303030303030304,157,0,24,133,156,1,0.0,0.15286624203821655,0.8471337579617835,0.9936305732484076,0.006369426751592357
5307,212,18,194,168,44,0.08490566037735849,0.9150943396226415,0.7924528301886793,0.20754716981132076,137,0,25,112,134,3,0.0,0.18248175182481752,0.8175182481751825,0.9781021897810219,0.021897810218978103
5308,89,13,76,54,35,0.14606741573033707,0.8539325842696629,0.6067415730337079,0.39325842696629215,118,0,0,118,114,4,0.0,0.0,1.0,0.9661016949152542,0.03389830508474576
5309,197,17,180,157,40,0.08629441624365482,0.9137055837563451,0.7969543147208121,0.20304568527918782,142,0,26,116,139,3,0.0,0.18309859154929578,0.8169014084507042,0.9788732394366197,0.02112676056338028
5310,89,13,76,53,36,0.14606741573033707,0.8539325842696629,0.5955056179775281,0.4044943820224719,116,0,0,116,113,3,0.0,0.0,1.0,0.9741379310344828,0.02586206896551724
5311,59,11,48,25,34,0.1864406779661017,0.8135593220338984,0.423728813559322,0.576271186440678,135,0,0,135,132,3,0.0,0.0,1.0,0.9777777777777777,0.022222222222222223
5312,213,16,197,169,44,0.07511737089201878,0.9248826291079812,0.7934272300469484,0.20657276995305165,143,0,25,118,141,2,0.0,0.17482517482517482,0.8251748251748252,0.986013986013986,0.013986013986013986
5313,220,20,200,173,47,0.09090909090909091,0.9090909090909091,0.7863636363636364,0.21363636363636362,143,0,26,117,141,2,0.0,0.18181818181818182,0.8181818181818182,0.986013986013986,0.013986013986013986
5314,87,13,74,54,33,0.14942528735632185,0.8505747126436781,0.6206896551724138,0.3793103448275862,107,0,0,107,104,3,0.0,0.0,1.0,0.9719626168224299,0.028037383177570093
5315,115,13,102,71,44,0.11304347826086956,0.8869565217391304,0.6173913043478261,0.3826086956521739,124,0,0,124,120,4,0.0,0.0,1.0,0.967741935483871,0.03225806451612903
5316,80,14,66,40,40,0.175,0.825,0.5,0.5,92,0,28,64,92,0,0.0,0.30434782608695654,0.6956521739130435,1.0,0.0
5317,124,18,106,78,46,0.14516129032258066,0.8548387096774194,0.6290322580645161,0.3709677419354839,106,0,1,105,102,4,0.0,0.009433962264150943,0.9905660377358491,0.9622641509433962,0.03773584905660377
5318,120,9,111,78,42,0.075,0.925,0.65,0.35,108,0,2,106,105,3,0.0,0.018518518518518517,0.9814814814814815,0.9722222222222222,0.027777777777777776
5319,196,17,179,154,42,0.08673469387755102,0.9132653061224489,0.7857142857142857,0.21428571428571427,148,0,27,121,146,2,0.0,0.18243243243243243,0.8175675675675675,0.9864864864864865,0.013513513513513514
5320,209,16,193,163,46,0.07655502392344497,0.9234449760765551,0.7799043062200957,0.22009569377990432,139,0,25,114,136,3,0.0,0.17985611510791366,0.8201438848920863,0.9784172661870504,0.02158273381294964
5321,197,15,182,161,36,0.07614213197969544,0.9238578680203046,0.817258883248731,0.18274111675126903,147,0,27,120,144,3,0.0,0.1836734693877551,0.8163265306122449,0.9795918367346939,0.02040816326530612
5322,91,15,76,53,38,0.16483516483516483,0.8351648351648352,0.5824175824175825,0.4175824175824176,111,0,0,111,107,4,0.0,0.0,1.0,0.963963963963964,0.036036036036036036
5323,130,20,110,89,41,0.15384615384615385,0.8461538461538461,0.6846153846153846,0.3153846153846154,117,0,1,116,113,4,0.0,0.008547008547008548,0.9914529914529915,0.9658119658119658,0.03418803418803419
5324,124,14,110,81,43,0.11290322580645161,0.8870967741935484,0.6532258064516129,0.3467741935483871,110,0,1,109,107,3,0.0,0.00909090909090909,0.990909090909091,0.9727272727272728,0.02727272727272727
5325,76,13,63,34,42,0.17105263157894737,0.8289473684210527,0.4473684210526316,0.5526315789473685,90,0,28,62,90,0,0.0,0.3111111111111111,0.6888888888888889,1.0,0.0
5326,130,20,110,85,45,0.15384615384615385,0.8461538461538461,0.6538461538461539,0.34615384615384615,107,0,1,106,103,4,0.0,0.009345794392523364,0.9906542056074766,0.9626168224299065,0.037383177570093455
5327,123,13,110,83,40,0.10569105691056911,0.8943089430894309,0.6747967479674797,0.3252032520325203,117,0,1,116,113,4,0.0,0.008547008547008548,0.9914529914529915,0.9658119658119658,0.03418803418803419
5328,112,21,91,60,52,0.1875,0.8125,0.5357142857142857,0.4642857142857143,176,1,54,121,174,2,0.005681818181818182,0.3068181818181818,0.6875,0.9886363636363636,0.011363636363636364
5329,70,16,54,26,44,0.22857142857142856,0.7714285714285715,0.37142857142857144,0.6285714285714286,97,0,30,67,97,0,0.0,0.30927835051546393,0.6907216494845361,1.0,0.0
5330,59,12,47,25,34,0.2033898305084746,0.7966101694915254,0.423728813559322,0.576271186440678,128,0,0,128,125,3,0.0,0.0,1.0,0.9765625,0.0234375
5331,89,13,76,53,36,0.14606741573033707,0.8539325842696629,0.5955056179775281,0.4044943820224719,112,0,0,112,108,4,0.0,0.0,1.0,0.9642857142857143,0.03571428571428571
5332,115,9,106,79,36,0.0782608695652174,0.9217391304347826,0.6869565217391305,0.3130434782608696,105,0,1,104,101,4,0.0,0.009523809523809525,0.9904761904761905,0.9619047619047619,0.0380952380952381
5333,94,18,76,58,36,0.19148936170212766,0.8085106382978723,0.6170212765957447,0.3829787234042553,100,0,0,100,96,4,0.0,0.0,1.0,0.96,0.04
5334,205,28,177,156,49,0.13658536585365855,0.8634146341463415,0.7609756097560976,0.23902439024390243,131,0,27,104,128,3,0.0,0.20610687022900764,0.7938931297709924,0.9770992366412213,0.022900763358778626
5335,38,5,33,28,10,0.13157894736842105,0.868421052631579,0.7368421052631579,0.2631578947368421,84,0,13,71,82,2,0.0,0.15476190476190477,0.8452380952380952,0.9761904761904762,0.023809523809523808
5336,131,10,121,96,35,0.07633587786259542,0.9236641221374046,0.732824427480916,0.26717557251908397,93,0,12,81,91,2,0.0,0.12903225806451613,0.8709677419354839,0.978494623655914,0.021505376344086023
5337,125,7,118,98,27,0.056,0.944,0.784,0.216,97,0,15,82,95,2,0.0,0.15463917525773196,0.845360824742268,0.979381443298969,0.020618556701030927
5338,110,9,101,90,20,0.08181818181818182,0.9181818181818182,0.8181818181818182,0.18181818181818182,92,0,17,75,90,2,0.0,0.18478260869565216,0.8152173913043478,0.9782608695652174,0.021739130434782608
5339,63,15,48,27,36,0.23809523809523808,0.7619047619047619,0.42857142857142855,0.5714285714285714,136,0,0,136,133,3,0.0,0.0,1.0,0.9779411764705882,0.022058823529411766
5340,132,9,123,99,33,0.06818181818181818,0.9318181818181818,0.75,0.25,96,0,11,85,94,2,0.0,0.11458333333333333,0.8854166666666666,0.9791666666666666,0.020833333333333332
5341,118,12,106,78,40,0.1016949152542373,0.8983050847457628,0.6610169491525424,0.3389830508474576,109,0,1,108,105,4,0.0,0.009174311926605505,0.9908256880733946,0.963302752293578,0.03669724770642202
5342,88,12,76,55,33,0.13636363636363635,0.8636363636363636,0.625,0.375,117,0,0,117,113,4,0.0,0.0,1.0,0.9658119658119658,0.03418803418803419
5343,118,9,109,83,35,0.07627118644067797,0.923728813559322,0.7033898305084746,0.2966101694915254,108,0,1,107,104,4,0.0,0.009259259259259259,0.9907407407407407,0.9629629629629629,0.037037037037037035
5344,191,15,176,151,40,0.07853403141361257,0.9214659685863874,0.7905759162303665,0.2094240837696335,134,0,27,107,131,3,0.0,0.20149253731343283,0.7985074626865671,0.9776119402985075,0.022388059701492536
5345,121,11,110,84,37,0.09090909090909091,0.9090909090909091,0.6942148760330579,0.30578512396694213,105,0,1,104,102,3,0.0,0.009523809523809525,0.9904761904761905,0.9714285714285714,0.02857142857142857
5346,211,14,197,170,41,0.06635071090047394,0.933649289099526,0.8056872037914692,0.1943127962085308,136,0,24,112,133,3,0.0,0.17647058823529413,0.8235294117647058,0.9779411764705882,0.022058823529411766
5347,88,12,76,54,34,0.13636363636363635,0.8636363636363636,0.6136363636363636,0.38636363636363635,113,0,0,113,110,3,0.0,0.0,1.0,0.9734513274336283,0.02654867256637168
5348,112,10,102,86,26,0.08928571428571429,0.9107142857142857,0.7678571428571429,0.23214285714285715,95,0,18,77,93,2,0.0,0.18947368421052632,0.8105263157894737,0.9789473684210527,0.021052631578947368
5349,121,14,107,83,38,0.11570247933884298,0.8842975206611571,0.6859504132231405,0.3140495867768595,115,0,1,114,112,3,0.0,0.008695652173913044,0.991304347826087,0.9739130434782609,0.02608695652173913
5350,109,7,102,91,18,0.06422018348623854,0.9357798165137615,0.8348623853211009,0.1651376146788991,89,0,14,75,87,2,0.0,0.15730337078651685,0.8426966292134831,0.9775280898876404,0.02247191011235955
5351,118,21,97,70,48,0.17796610169491525,0.8220338983050848,0.5932203389830508,0.4067796610169492,120,0,0,120,117,3,0.0,0.0,1.0,0.975,0.025
5352,111,5,106,90,21,0.04504504504504504,0.954954954954955,0.8108108108108109,0.1891891891891892,83,0,11,72,81,2,0.0,0.13253012048192772,0.8674698795180723,0.9759036144578314,0.024096385542168676
5353,48,14,34,18,30,0.2916666666666667,0.7083333333333334,0.375,0.625,81,0,30,51,81,0,0.0,0.37037037037037035,0.6296296296296297,1.0,0.0
5354,108,4,104,92,16,0.037037037037037035,0.9629629629629629,0.8518518518518519,0.14814814814814814,91,0,14,77,89,2,0.0,0.15384615384615385,0.8461538461538461,0.978021978021978,0.02197802197802198
5355,60,13,47,29,31,0.21666666666666667,0.7833333333333333,0.48333333333333334,0.5166666666666667,135,0,0,135,132,3,0.0,0.0,1.0,0.9777777777777777,0.022222222222222223
5356,79,16,63,38,41,0.20253164556962025,0.7974683544303798,0.4810126582278481,0.5189873417721519,85,0,28,57,85,0,0.0,0.32941176470588235,0.6705882352941176,1.0,0.0
5357,96,22,74,53,43,0.22916666666666666,0.7708333333333334,0.5520833333333334,0.4479166666666667,113,0,0,113,109,4,0.0,0.0,1.0,0.9646017699115044,0.035398230088495575
5358,119,9,110,79,40,0.07563025210084033,0.9243697478991597,0.6638655462184874,0.33613445378151263,107,0,1,106,104,3,0.0,0.009345794392523364,0.9906542056074766,0.9719626168224299,0.028037383177570093
5359,74,7,67,50,24,0.0945945945945946,0.9054054054054054,0.6756756756756757,0.32432432432432434,71,0,0,71,67,4,0.0,0.0,1.0,0.9436619718309859,0.056338028169014086
5360,125,15,110,86,39,0.12,0.88,0.688,0.312,119,0,1,118,115,4,0.0,0.008403361344537815,0.9915966386554622,0.9663865546218487,0.03361344537815126
5361,122,11,111,82,40,0.09016393442622951,0.9098360655737705,0.6721311475409836,0.32786885245901637,103,0,2,101,100,3,0.0,0.019417475728155338,0.9805825242718447,0.970873786407767,0.02912621359223301
5362,91,15,76,58,33,0.16483516483516483,0.8351648351648352,0.6373626373626373,0.3626373626373626,118,0,0,118,115,3,0.0,0.0,1.0,0.9745762711864406,0.025423728813559324
5363,122,13,109,78,44,0.10655737704918032,0.8934426229508197,0.639344262295082,0.36065573770491804,117,0,1,116,113,4,0.0,0.008547008547008548,0.9914529914529915,0.9658119658119658,0.03418803418803419
5364,218,23,195,166,52,0.10550458715596331,0.8944954128440367,0.7614678899082569,0.23853211009174313,144,0,26,118,141,3,0.0,0.18055555555555555,0.8194444444444444,0.9791666666666666,0.020833333333333332
5365,130,20,110,86,44,0.15384615384615385,0.8461538461538461,0.6615384615384615,0.3384615384615385,106,0,1,105,103,3,0.0,0.009433962264150943,0.9905660377358491,0.9716981132075472,0.02830188679245283
5366,121,11,110,77,44,0.09090909090909091,0.9090909090909091,0.6363636363636364,0.36363636363636365,87,0,1,86,83,4,0.0,0.011494252873563218,0.9885057471264368,0.9540229885057471,0.04597701149425287
5367,88,12,76,58,30,0.13636363636363635,0.8636363636363636,0.6590909090909091,0.3409090909090909,109,0,0,109,105,4,0.0,0.0,1.0,0.963302752293578,0.03669724770642202
5368,114,7,107,91,23,0.06140350877192982,0.9385964912280702,0.7982456140350878,0.20175438596491227,83,0,8,75,80,3,0.0,0.0963855421686747,0.9036144578313253,0.963855421686747,0.03614457831325301
5369,125,14,111,79,46,0.112,0.888,0.632,0.368,110,0,1,109,106,4,0.0,0.00909090909090909,0.990909090909091,0.9636363636363636,0.03636363636363636
5370,112,21,91,55,57,0.1875,0.8125,0.49107142857142855,0.5089285714285714,166,0,54,112,162,4,0.0,0.3253012048192771,0.6746987951807228,0.9759036144578314,0.024096385542168676
5371,131,9,122,102,29,0.06870229007633588,0.9312977099236641,0.7786259541984732,0.22137404580152673,97,0,15,82,95,2,0.0,0.15463917525773196,0.845360824742268,0.979381443298969,0.020618556701030927
5372,191,14,177,151,40,0.07329842931937172,0.9267015706806283,0.7905759162303665,0.2094240837696335,139,0,27,112,136,3,0.0,0.19424460431654678,0.8057553956834532,0.9784172661870504,0.02158273381294964
5373,90,14,76,55,35,0.15555555555555556,0.8444444444444444,0.6111111111111112,0.3888888888888889,108,0,0,108,104,4,0.0,0.0,1.0,0.9629629629629629,0.037037037037037035
5374,125,15,110,76,49,0.12,0.88,0.608,0.392,116,0,1,115,113,3,0.0,0.008620689655172414,0.9913793103448276,0.9741379310344828,0.02586206896551724
5375,189,9,180,152,37,0.047619047619047616,0.9523809523809523,0.8042328042328042,0.19576719576719576,139,0,26,113,136,3,0.0,0.18705035971223022,0.8129496402877698,0.9784172661870504,0.02158273381294964
5376,105,14,91,61,44,0.13333333333333333,0.8666666666666667,0.580952380952381,0.41904761904761906,165,0,54,111,162,3,0.0,0.32727272727272727,0.6727272727272727,0.9818181818181818,0.01818181818181818
5377,210,16,194,167,43,0.0761904761904762,0.9238095238095239,0.7952380952380952,0.20476190476190476,139,0,24,115,136,3,0.0,0.17266187050359713,0.8273381294964028,0.9784172661870504,0.02158273381294964
5378,122,16,106,80,42,0.13114754098360656,0.8688524590163934,0.6557377049180327,0.3442622950819672,116,0,1,115,112,4,0.0,0.008620689655172414,0.9913793103448276,0.9655172413793104,0.034482758620689655
5379,123,13,110,83,40,0.10569105691056911,0.8943089430894309,0.6747967479674797,0.3252032520325203,111,0,1,110,107,4,0.0,0.009009009009009009,0.990990990990991,0.963963963963964,0.036036036036036036
5380,204,19,185,160,44,0.09313725490196079,0.9068627450980392,0.7843137254901961,0.21568627450980393,130,0,25,105,127,3,0.0,0.19230769230769232,0.8076923076923077,0.9769230769230769,0.023076923076923078
5381,111,5,106,88,23,0.04504504504504504,0.954954954954955,0.7927927927927928,0.2072072072072072,83,0,7,76,81,2,0.0,0.08433734939759036,0.9156626506024096,0.9759036144578314,0.024096385542168676
5382,84,8,76,55,29,0.09523809523809523,0.9047619047619048,0.6547619047619048,0.34523809523809523,107,0,0,107,103,4,0.0,0.0,1.0,0.9626168224299065,0.037383177570093455
5383,68,7,61,50,18,0.10294117647058823,0.8970588235294118,0.7352941176470589,0.2647058823529412,80,0,0,80,76,4,0.0,0.0,1.0,0.95,0.05
5384,153,21,132,103,50,0.13725490196078433,0.8627450980392157,0.673202614379085,0.32679738562091504,129,0,24,105,128,1,0.0,0.18604651162790697,0.813953488372093,0.9922480620155039,0.007751937984496124
5385,171,23,148,105,66,0.13450292397660818,0.8654970760233918,0.6140350877192983,0.38596491228070173,138,0,24,114,137,1,0.0,0.17391304347826086,0.8260869565217391,0.9927536231884058,0.007246376811594203
5386,93,17,76,50,43,0.1827956989247312,0.8172043010752689,0.5376344086021505,0.46236559139784944,113,0,0,113,110,3,0.0,0.0,1.0,0.9734513274336283,0.02654867256637168
5387,126,16,110,77,49,0.12698412698412698,0.873015873015873,0.6111111111111112,0.3888888888888889,110,0,1,109,107,3,0.0,0.00909090909090909,0.990909090909091,0.9727272727272728,0.02727272727272727
5388,90,14,76,56,34,0.15555555555555556,0.8444444444444444,0.6222222222222222,0.37777777777777777,107,0,0,107,104,3,0.0,0.0,1.0,0.9719626168224299,0.028037383177570093
5389,84,19,65,40,44,0.2261904761904762,0.7738095238095238,0.47619047619047616,0.5238095238095238,96,0,29,67,96,0,0.0,0.3020833333333333,0.6979166666666666,1.0,0.0
5390,214,17,197,169,45,0.0794392523364486,0.9205607476635514,0.7897196261682243,0.2102803738317757,142,0,27,115,139,3,0.0,0.19014084507042253,0.8098591549295775,0.9788732394366197,0.02112676056338028
5391,120,11,109,82,38,0.09166666666666666,0.9083333333333333,0.6833333333333333,0.31666666666666665,115,0,1,114,111,4,0.0,0.008695652173913044,0.991304347826087,0.9652173913043478,0.034782608695652174
5392,128,18,110,83,45,0.140625,0.859375,0.6484375,0.3515625,117,0,1,116,113,4,0.0,0.008547008547008548,0.9914529914529915,0.9658119658119658,0.03418803418803419
5393,57,10,47,27,30,0.17543859649122806,0.8245614035087719,0.47368421052631576,0.5263157894736842,145,0,0,145,142,3,0.0,0.0,1.0,0.9793103448275862,0.020689655172413793
5394,78,14,64,40,38,0.1794871794871795,0.8205128205128205,0.5128205128205128,0.48717948717948717,108,0,30,78,108,0,0.0,0.2777777777777778,0.7222222222222222,1.0,0.0
5395,118,9,109,80,38,0.07627118644067797,0.923728813559322,0.6779661016949152,0.3220338983050847,107,0,1,106,103,4,0.0,0.009345794392523364,0.9906542056074766,0.9626168224299065,0.037383177570093455
5396,207,196,11,204,3,0.9468599033816425,0.05314009661835749,0.9855072463768116,0.014492753623188406,342,0,73,269,124,218,0.0,0.2134502923976608,0.7865497076023392,0.36257309941520466,0.6374269005847953
5397,0,0,0,0,0,0.0,0.0,0.0,0.0,0,0,0,0,0,0,0.0,0.0,0.0,0.0,0.0
5398,129,8,121,100,29,0.06201550387596899,0.937984496124031,0.7751937984496124,0.2248062015503876,97,0,13,84,95,2,0.0,0.13402061855670103,0.865979381443299,0.979381443298969,0.020618556701030927
5399,164,16,148,115,49,0.0975609756097561,0.9024390243902439,0.7012195121951219,0.29878048780487804,144,0,24,120,143,1,0.0,0.16666666666666666,0.8333333333333334,0.9930555555555556,0.006944444444444444
5400,114,6,108,92,22,0.05263157894736842,0.9473684210526315,0.8070175438596491,0.19298245614035087,82,0,11,71,80,2,0.0,0.13414634146341464,0.8658536585365854,0.975609756097561,0.024390243902439025
5401,62,15,47,26,36,0.24193548387096775,0.7580645161290323,0.41935483870967744,0.5806451612903226,148,0,0,148,145,3,0.0,0.0,1.0,0.9797297297297297,0.02027027027027027
5402,87,11,76,56,31,0.12643678160919541,0.8735632183908046,0.6436781609195402,0.3563218390804598,112,0,0,112,109,3,0.0,0.0,1.0,0.9732142857142857,0.026785714285714284
5403,111,20,91,54,57,0.18018018018018017,0.8198198198198198,0.4864864864864865,0.5135135135135135,190,0,54,136,186,4,0.0,0.28421052631578947,0.7157894736842105,0.9789473684210527,0.021052631578947368
5404,54,10,44,20,34,0.18518518518518517,0.8148148148148148,0.37037037037037035,0.6296296296296297,102,0,30,72,102,0,0.0,0.29411764705882354,0.7058823529411765,1.0,0.0
5405,125,15,110,81,44,0.12,0.88,0.648,0.352,116,0,0,116,112,4,0.0,0.0,1.0,0.9655172413793104,0.034482758620689655
5406,129,18,111,79,50,0.13953488372093023,0.8604651162790697,0.6124031007751938,0.3875968992248062,112,0,2,110,108,4,0.0,0.017857142857142856,0.9821428571428571,0.9642857142857143,0.03571428571428571
5407,131,20,111,85,46,0.15267175572519084,0.8473282442748091,0.648854961832061,0.3511450381679389,107,0,2,105,104,3,0.0,0.018691588785046728,0.9813084112149533,0.9719626168224299,0.028037383177570093
5408,122,12,110,89,33,0.09836065573770492,0.9016393442622951,0.7295081967213115,0.27049180327868855,109,0,1,108,105,4,0.0,0.009174311926605505,0.9908256880733946,0.963302752293578,0.03669724770642202
5409,85,20,65,40,45,0.23529411764705882,0.7647058823529411,0.47058823529411764,0.5294117647058824,100,0,30,70,100,0,0.0,0.3,0.7,1.0,0.0
5410,57,13,44,25,32,0.22807017543859648,0.7719298245614035,0.43859649122807015,0.5614035087719298,87,0,31,56,87,0,0.0,0.3563218390804598,0.6436781609195402,1.0,0.0
5411,79,15,64,34,45,0.189873417721519,0.810126582278481,0.43037974683544306,0.569620253164557,97,0,30,67,97,0,0.0,0.30927835051546393,0.6907216494845361,1.0,0.0
5412,107,10,97,73,34,0.09345794392523364,0.9065420560747663,0.6822429906542056,0.3177570093457944,149,0,0,149,145,4,0.0,0.0,1.0,0.9731543624161074,0.026845637583892617
5413,122,13,109,84,38,0.10655737704918032,0.8934426229508197,0.6885245901639344,0.3114754098360656,101,0,1,100,97,4,0.0,0.009900990099009901,0.9900990099009901,0.9603960396039604,0.039603960396039604
5414,52,5,47,20,32,0.09615384615384616,0.9038461538461539,0.38461538461538464,0.6153846153846154,133,0,0,133,131,2,0.0,0.0,1.0,0.9849624060150376,0.015037593984962405
5415,75,11,64,38,37,0.14666666666666667,0.8533333333333334,0.5066666666666667,0.49333333333333335,97,0,28,69,97,0,0.0,0.28865979381443296,0.711340206185567,1.0,0.0
5416,88,12,76,54,34,0.13636363636363635,0.8636363636363636,0.6136363636363636,0.38636363636363635,113,0,0,113,110,3,0.0,0.0,1.0,0.9734513274336283,0.02654867256637168
5417,85,9,76,58,27,0.10588235294117647,0.8941176470588236,0.6823529411764706,0.3176470588235294,111,0,0,111,108,3,0.0,0.0,1.0,0.972972972972973,0.02702702702702703
5418,122,12,110,79,43,0.09836065573770492,0.9016393442622951,0.6475409836065574,0.3524590163934426,113,0,1,112,109,4,0.0,0.008849557522123894,0.9911504424778761,0.9646017699115044,0.035398230088495575
5419,80,16,64,40,40,0.2,0.8,0.5,0.5,99,0,30,69,99,0,0.0,0.30303030303030304,0.696969696969697,1.0,0.0
5420,77,14,63,35,42,0.18181818181818182,0.8181818181818182,0.45454545454545453,0.5454545454545454,102,0,28,74,102,0,0.0,0.27450980392156865,0.7254901960784313,1.0,0.0
5421,116,5,111,88,28,0.04310344827586207,0.9568965517241379,0.7586206896551724,0.2413793103448276,84,0,9,75,82,2,0.0,0.10714285714285714,0.8928571428571429,0.9761904761904762,0.023809523809523808
5422,114,8,106,75,39,0.07017543859649122,0.9298245614035088,0.6578947368421053,0.34210526315789475,108,0,1,107,105,3,0.0,0.009259259259259259,0.9907407407407407,0.9722222222222222,0.027777777777777776
5423,135,24,111,83,52,0.17777777777777778,0.8222222222222222,0.6148148148148148,0.3851851851851852,117,0,2,115,114,3,0.0,0.017094017094017096,0.9829059829059829,0.9743589743589743,0.02564102564102564
5424,92,16,76,54,38,0.17391304347826086,0.8260869565217391,0.5869565217391305,0.41304347826086957,101,0,0,101,97,4,0.0,0.0,1.0,0.9603960396039604,0.039603960396039604
5425,65,18,47,25,40,0.27692307692307694,0.7230769230769231,0.38461538461538464,0.6153846153846154,139,0,0,139,136,3,0.0,0.0,1.0,0.9784172661870504,0.02158273381294964
5426,196,19,177,150,46,0.09693877551020408,0.9030612244897959,0.7653061224489796,0.23469387755102042,143,0,27,116,140,3,0.0,0.1888111888111888,0.8111888111888111,0.9790209790209791,0.02097902097902098
5427,92,16,76,60,32,0.17391304347826086,0.8260869565217391,0.6521739130434783,0.34782608695652173,109,0,0,109,107,2,0.0,0.0,1.0,0.981651376146789,0.01834862385321101
5428,87,11,76,53,34,0.12643678160919541,0.8735632183908046,0.6091954022988506,0.39080459770114945,110,0,0,110,107,3,0.0,0.0,1.0,0.9727272727272728,0.02727272727272727
5429,89,24,65,38,51,0.2696629213483146,0.7303370786516854,0.42696629213483145,0.5730337078651685,94,0,29,65,94,0,0.0,0.30851063829787234,0.6914893617021277,1.0,0.0
5430,108,12,96,72,36,0.1111111111111111,0.8888888888888888,0.6666666666666666,0.3333333333333333,127,0,1,126,123,4,0.0,0.007874015748031496,0.9921259842519685,0.968503937007874,0.031496062992125984
5431,194,14,180,157,37,0.07216494845360824,0.9278350515463918,0.8092783505154639,0.19072164948453607,146,0,26,120,144,2,0.0,0.1780821917808219,0.821917808219178,0.9863013698630136,0.0136986301369863
5432,41,7,34,18,23,0.17073170731707318,0.8292682926829268,0.43902439024390244,0.5609756097560976,78,0,30,48,78,0,0.0,0.38461538461538464,0.6153846153846154,1.0,0.0
5433,62,14,48,26,36,0.22580645161290322,0.7741935483870968,0.41935483870967744,0.5806451612903226,149,0,0,149,147,2,0.0,0.0,1.0,0.9865771812080537,0.013422818791946308
5434,62,15,47,26,36,0.24193548387096775,0.7580645161290323,0.41935483870967744,0.5806451612903226,130,0,0,130,127,3,0.0,0.0,1.0,0.9769230769230769,0.023076923076923078
5435,107,6,101,84,23,0.056074766355140186,0.9439252336448598,0.7850467289719626,0.21495327102803738,84,0,8,76,82,2,0.0,0.09523809523809523,0.9047619047619048,0.9761904761904762,0.023809523809523808
5436,111,4,107,87,24,0.036036036036036036,0.963963963963964,0.7837837837837838,0.21621621621621623,91,0,14,77,89,2,0.0,0.15384615384615385,0.8461538461538461,0.978021978021978,0.02197802197802198
5437,129,11,118,96,33,0.08527131782945736,0.9147286821705426,0.7441860465116279,0.2558139534883721,100,0,13,87,98,2,0.0,0.13,0.87,0.98,0.02
5438,146,16,130,102,44,0.1095890410958904,0.8904109589041096,0.6986301369863014,0.3013698630136986,137,0,25,112,136,1,0.0,0.18248175182481752,0.8175182481751825,0.9927007299270073,0.0072992700729927005
5439,112,7,105,87,25,0.0625,0.9375,0.7767857142857143,0.22321428571428573,82,0,12,70,80,2,0.0,0.14634146341463414,0.8536585365853658,0.975609756097561,0.024390243902439025
5440,192,13,179,153,39,0.06770833333333333,0.9322916666666666,0.796875,0.203125,139,0,26,113,137,2,0.0,0.18705035971223022,0.8129496402877698,0.9856115107913669,0.014388489208633094
5441,120,10,110,79,41,0.08333333333333333,0.9166666666666666,0.6583333333333333,0.3416666666666667,109,0,1,108,105,4,0.0,0.009174311926605505,0.9908256880733946,0.963302752293578,0.03669724770642202
5442,110,6,104,90,20,0.05454545454545454,0.9454545454545454,0.8181818181818182,0.18181818181818182,88,0,16,72,86,2,0.0,0.18181818181818182,0.8181818181818182,0.9772727272727273,0.022727272727272728
5443,181,158,23,178,3,0.8729281767955801,0.1270718232044199,0.9834254143646409,0.016574585635359115,295,0,33,262,84,211,0.0,0.11186440677966102,0.888135593220339,0.2847457627118644,0.7152542372881356
5444,87,23,64,40,47,0.26436781609195403,0.735632183908046,0.45977011494252873,0.5402298850574713,93,0,28,65,93,0,0.0,0.3010752688172043,0.6989247311827957,1.0,0.0
5445,66,19,47,29,37,0.2878787878787879,0.7121212121212122,0.4393939393939394,0.5606060606060606,136,0,0,136,133,3,0.0,0.0,1.0,0.9779411764705882,0.022058823529411766
5446,115,5,110,88,27,0.043478260869565216,0.9565217391304348,0.7652173913043478,0.23478260869565218,85,0,11,74,83,2,0.0,0.12941176470588237,0.8705882352941177,0.9764705882352941,0.023529411764705882
5447,70,6,64,50,20,0.08571428571428572,0.9142857142857143,0.7142857142857143,0.2857142857142857,81,0,0,81,77,4,0.0,0.0,1.0,0.9506172839506173,0.04938271604938271
5448,182,154,28,175,7,0.8461538461538461,0.15384615384615385,0.9615384615384616,0.038461538461538464,319,0,30,289,99,220,0.0,0.09404388714733543,0.9059561128526645,0.3103448275862069,0.6896551724137931
5449,62,14,48,28,34,0.22580645161290322,0.7741935483870968,0.45161290322580644,0.5483870967741935,142,0,0,142,139,3,0.0,0.0,1.0,0.9788732394366197,0.02112676056338028
5450,90,14,76,56,34,0.15555555555555556,0.8444444444444444,0.6222222222222222,0.37777777777777777,110,0,0,110,107,3,0.0,0.0,1.0,0.9727272727272728,0.02727272727272727
5451,54,10,44,23,31,0.18518518518518517,0.8148148148148148,0.42592592592592593,0.5740740740740741,94,0,30,64,94,0,0.0,0.3191489361702128,0.6808510638297872,1.0,0.0
5452,124,13,111,82,42,0.10483870967741936,0.8951612903225806,0.6612903225806451,0.3387096774193548,107,0,2,105,104,3,0.0,0.018691588785046728,0.9813084112149533,0.9719626168224299,0.028037383177570093
5453,91,15,76,56,35,0.16483516483516483,0.8351648351648352,0.6153846153846154,0.38461538461538464,120,0,0,120,116,4,0.0,0.0,1.0,0.9666666666666667,0.03333333333333333
5454,112,7,105,86,26,0.0625,0.9375,0.7678571428571429,0.23214285714285715,89,0,14,75,87,2,0.0,0.15730337078651685,0.8426966292134831,0.9775280898876404,0.02247191011235955
5455,103,8,95,81,22,0.07766990291262135,0.9223300970873787,0.7864077669902912,0.21359223300970873,89,0,19,70,87,2,0.0,0.21348314606741572,0.7865168539325843,0.9775280898876404,0.02247191011235955
5456,111,13,98,66,45,0.11711711711711711,0.8828828828828829,0.5945945945945946,0.40540540540540543,119,0,0,119,116,3,0.0,0.0,1.0,0.9747899159663865,0.025210084033613446
5457,61,13,48,29,32,0.21311475409836064,0.7868852459016393,0.47540983606557374,0.5245901639344263,137,0,0,137,134,3,0.0,0.0,1.0,0.9781021897810219,0.021897810218978103
5458,109,4,105,88,21,0.03669724770642202,0.963302752293578,0.8073394495412844,0.1926605504587156,83,0,13,70,81,2,0.0,0.1566265060240964,0.8433734939759037,0.9759036144578314,0.024096385542168676
5459,130,11,119,103,27,0.08461538461538462,0.9153846153846154,0.7923076923076923,0.2076923076923077,96,0,14,82,94,2,0.0,0.14583333333333334,0.8541666666666666,0.9791666666666666,0.020833333333333332
5460,198,18,180,152,46,0.09090909090909091,0.9090909090909091,0.7676767676767676,0.23232323232323232,143,0,24,119,140,3,0.0,0.16783216783216784,0.8321678321678322,0.9790209790209791,0.02097902097902098
5461,193,12,181,155,38,0.06217616580310881,0.9378238341968912,0.8031088082901554,0.19689119170984457,141,0,26,115,138,3,0.0,0.18439716312056736,0.8156028368794326,0.9787234042553191,0.02127659574468085
5462,213,15,198,167,46,0.07042253521126761,0.9295774647887324,0.784037558685446,0.215962441314554,148,0,26,122,145,3,0.0,0.17567567567567569,0.8243243243243243,0.9797297297297297,0.02027027027027027
5463,39,7,32,29,10,0.1794871794871795,0.8205128205128205,0.7435897435897436,0.2564102564102564,87,0,15,72,84,3,0.0,0.1724137931034483,0.8275862068965517,0.9655172413793104,0.034482758620689655
5464,120,9,111,84,36,0.075,0.925,0.7,0.3,102,0,2,100,98,4,0.0,0.0196078431372549,0.9803921568627451,0.9607843137254902,0.0392156862745098
5465,123,6,117,97,26,0.04878048780487805,0.9512195121951219,0.7886178861788617,0.21138211382113822,80,0,5,75,78,2,0.0,0.0625,0.9375,0.975,0.025
5466,124,18,106,82,42,0.14516129032258066,0.8548387096774194,0.6612903225806451,0.3387096774193548,103,0,1,102,99,4,0.0,0.009708737864077669,0.9902912621359223,0.9611650485436893,0.038834951456310676
5467,58,10,48,27,31,0.1724137931034483,0.8275862068965517,0.46551724137931033,0.5344827586206896,137,0,0,137,134,3,0.0,0.0,1.0,0.9781021897810219,0.021897810218978103
5468,60,12,48,26,34,0.2,0.8,0.43333333333333335,0.5666666666666667,145,0,0,145,142,3,0.0,0.0,1.0,0.9793103448275862,0.020689655172413793
5469,126,15,111,82,44,0.11904761904761904,0.8809523809523809,0.6507936507936508,0.3492063492063492,112,0,1,111,108,4,0.0,0.008928571428571428,0.9910714285714286,0.9642857142857143,0.03571428571428571
5470,126,9,117,102,24,0.07142857142857142,0.9285714285714286,0.8095238095238095,0.19047619047619047,97,0,15,82,95,2,0.0,0.15463917525773196,0.845360824742268,0.979381443298969,0.020618556701030927
5471,111,8,103,85,26,0.07207207207207207,0.9279279279279279,0.7657657657657657,0.23423423423423423,91,0,15,76,89,2,0.0,0.16483516483516483,0.8351648351648352,0.978021978021978,0.02197802197802198
5472,169,21,148,115,54,0.1242603550295858,0.8757396449704142,0.6804733727810651,0.31952662721893493,135,1,24,110,134,1,0.007407407407407408,0.17777777777777778,0.8148148148148148,0.9925925925925926,0.007407407407407408
5473,125,15,110,80,45,0.12,0.88,0.64,0.36,110,0,1,109,106,4,0.0,0.00909090909090909,0.990909090909091,0.9636363636363636,0.03636363636363636
5474,93,17,76,55,38,0.1827956989247312,0.8172043010752689,0.5913978494623656,0.40860215053763443,114,0,0,114,110,4,0.0,0.0,1.0,0.9649122807017544,0.03508771929824561
5475,58,10,48,27,31,0.1724137931034483,0.8275862068965517,0.46551724137931033,0.5344827586206896,135,0,0,135,132,3,0.0,0.0,1.0,0.9777777777777777,0.022222222222222223
5476,60,13,47,30,30,0.21666666666666667,0.7833333333333333,0.5,0.5,141,0,0,141,139,2,0.0,0.0,1.0,0.9858156028368794,0.014184397163120567
5477,202,20,182,157,45,0.09900990099009901,0.900990099009901,0.7772277227722773,0.22277227722772278,139,0,24,115,136,3,0.0,0.17266187050359713,0.8273381294964028,0.9784172661870504,0.02158273381294964
5478,72,18,54,26,46,0.25,0.75,0.3611111111111111,0.6388888888888888,104,0,30,74,104,0,0.0,0.28846153846153844,0.7115384615384616,1.0,0.0
5479,118,9,109,81,37,0.07627118644067797,0.923728813559322,0.6864406779661016,0.3135593220338983,110,0,1,109,107,3,0.0,0.00909090909090909,0.990909090909091,0.9727272727272728,0.02727272727272727
5480,113,21,92,68,45,0.18584070796460178,0.8141592920353983,0.6017699115044248,0.39823008849557523,109,0,0,109,107,2,0.0,0.0,1.0,0.981651376146789,0.01834862385321101
5481,62,15,47,29,33,0.24193548387096775,0.7580645161290323,0.46774193548387094,0.532258064516129,143,0,0,143,140,3,0.0,0.0,1.0,0.9790209790209791,0.02097902097902098
5482,69,10,59,49,20,0.14492753623188406,0.855072463768116,0.7101449275362319,0.2898550724637681,79,0,0,79,75,4,0.0,0.0,1.0,0.9493670886075949,0.05063291139240506
5483,199,19,180,154,45,0.09547738693467336,0.9045226130653267,0.7738693467336684,0.22613065326633167,139,0,26,113,137,2,0.0,0.18705035971223022,0.8129496402877698,0.9856115107913669,0.014388489208633094
5484,57,10,47,27,30,0.17543859649122806,0.8245614035087719,0.47368421052631576,0.5263157894736842,140,0,0,140,137,3,0.0,0.0,1.0,0.9785714285714285,0.02142857142857143
5485,127,18,109,83,44,0.14173228346456693,0.8582677165354331,0.6535433070866141,0.3464566929133858,109,0,1,108,105,4,0.0,0.009174311926605505,0.9908256880733946,0.963302752293578,0.03669724770642202
5486,40,6,34,31,9,0.15,0.85,0.775,0.225,87,0,15,72,84,3,0.0,0.1724137931034483,0.8275862068965517,0.9655172413793104,0.034482758620689655
5487,78,13,65,36,42,0.16666666666666666,0.8333333333333334,0.46153846153846156,0.5384615384615384,98,0,30,68,98,0,0.0,0.30612244897959184,0.6938775510204082,1.0,0.0
5488,70,16,54,27,43,0.22857142857142856,0.7714285714285715,0.38571428571428573,0.6142857142857143,110,0,31,79,110,0,0.0,0.2818181818181818,0.7181818181818181,1.0,0.0
5489,120,10,110,82,38,0.08333333333333333,0.9166666666666666,0.6833333333333333,0.31666666666666665,114,0,1,113,110,4,0.0,0.008771929824561403,0.9912280701754386,0.9649122807017544,0.03508771929824561
5490,114,14,100,70,44,0.12280701754385964,0.8771929824561403,0.6140350877192983,0.38596491228070173,123,0,0,123,120,3,0.0,0.0,1.0,0.975609756097561,0.024390243902439025
5491,189,11,178,151,38,0.0582010582010582,0.9417989417989417,0.798941798941799,0.20105820105820105,141,0,26,115,138,3,0.0,0.18439716312056736,0.8156028368794326,0.9787234042553191,0.02127659574468085
5492,123,13,110,80,43,0.10569105691056911,0.8943089430894309,0.6504065040650406,0.34959349593495936,114,0,1,113,111,3,0.0,0.008771929824561403,0.9912280701754386,0.9736842105263158,0.02631578947368421
5493,105,7,98,81,24,0.06666666666666667,0.9333333333333333,0.7714285714285715,0.22857142857142856,94,0,18,76,92,2,0.0,0.19148936170212766,0.8085106382978723,0.9787234042553191,0.02127659574468085
5494,146,13,133,105,41,0.08904109589041095,0.910958904109589,0.7191780821917808,0.2808219178082192,132,0,24,108,131,1,0.0,0.18181818181818182,0.8181818181818182,0.9924242424242424,0.007575757575757576
5495,64,10,54,27,37,0.15625,0.84375,0.421875,0.578125,101,0,31,70,101,0,0.0,0.3069306930693069,0.693069306930693,1.0,0.0
5496,194,17,177,147,47,0.08762886597938144,0.9123711340206185,0.7577319587628866,0.2422680412371134,141,0,28,113,138,3,0.0,0.19858156028368795,0.8014184397163121,0.9787234042553191,0.02127659574468085
5497,211,14,197,172,39,0.06635071090047394,0.933649289099526,0.8151658767772512,0.1848341232227488,145,0,25,120,142,3,0.0,0.1724137931034483,0.8275862068965517,0.9793103448275862,0.020689655172413793
5498,73,5,68,51,22,0.0684931506849315,0.9315068493150684,0.6986301369863014,0.3013698630136986,74,0,1,73,70,4,0.0,0.013513513513513514,0.9864864864864865,0.9459459459459459,0.05405405405405406
5499,128,18,110,80,48,0.140625,0.859375,0.625,0.375,109,0,1,108,105,4,0.0,0.009174311926605505,0.9908256880733946,0.963302752293578,0.03669724770642202
5500,69,9,60,44,25,0.13043478260869565,0.8695652173913043,0.6376811594202898,0.36231884057971014,77,0,0,77,73,4,0.0,0.0,1.0,0.948051948051948,0.05194805194805195
5501,124,14,110,79,45,0.11290322580645161,0.8870967741935484,0.6370967741935484,0.3629032258064516,107,0,1,106,103,4,0.0,0.009345794392523364,0.9906542056074766,0.9626168224299065,0.037383177570093455
5502,113,22,91,61,52,0.19469026548672566,0.8053097345132744,0.5398230088495575,0.46017699115044247,191,0,54,137,188,3,0.0,0.28272251308900526,0.7172774869109948,0.9842931937172775,0.015706806282722512
5503,84,8,76,57,27,0.09523809523809523,0.9047619047619048,0.6785714285714286,0.32142857142857145,113,0,0,113,110,3,0.0,0.0,1.0,0.9734513274336283,0.02654867256637168
5504,87,11,76,51,36,0.12643678160919541,0.8735632183908046,0.5862068965517241,0.41379310344827586,103,0,0,103,99,4,0.0,0.0,1.0,0.9611650485436893,0.038834951456310676
5505,69,15,54,27,42,0.21739130434782608,0.782608695652174,0.391304347826087,0.6086956521739131,116,0,30,86,116,0,0.0,0.25862068965517243,0.7413793103448276,1.0,0.0
5506,128,17,111,80,48,0.1328125,0.8671875,0.625,0.375,111,0,2,109,107,4,0.0,0.018018018018018018,0.9819819819819819,0.963963963963964,0.036036036036036036
5507,128,18,110,84,44,0.140625,0.859375,0.65625,0.34375,113,0,1,112,109,4,0.0,0.008849557522123894,0.9911504424778761,0.9646017699115044,0.035398230088495575
5508,37,5,32,30,7,0.13513513513513514,0.8648648648648649,0.8108108108108109,0.1891891891891892,89,0,17,72,86,3,0.0,0.19101123595505617,0.8089887640449438,0.9662921348314607,0.033707865168539325
5509,74,11,63,39,35,0.14864864864864866,0.8513513513513513,0.527027027027027,0.47297297297297297,96,0,30,66,96,0,0.0,0.3125,0.6875,1.0,0.0
5510,39,5,34,31,8,0.1282051282051282,0.8717948717948718,0.7948717948717948,0.20512820512820512,84,0,15,69,81,3,0.0,0.17857142857142858,0.8214285714285714,0.9642857142857143,0.03571428571428571
5511,114,16,98,69,45,0.14035087719298245,0.8596491228070176,0.6052631578947368,0.39473684210526316,124,0,0,124,120,4,0.0,0.0,1.0,0.967741935483871,0.03225806451612903
5512,163,15,148,120,43,0.09202453987730061,0.9079754601226994,0.7361963190184049,0.26380368098159507,142,0,24,118,141,1,0.0,0.16901408450704225,0.8309859154929577,0.9929577464788732,0.007042253521126761
5513,175,28,147,109,66,0.16,0.84,0.6228571428571429,0.37714285714285717,133,0,24,109,132,1,0.0,0.18045112781954886,0.8195488721804511,0.9924812030075187,0.007518796992481203
5514,108,6,102,88,20,0.05555555555555555,0.9444444444444444,0.8148148148148148,0.18518518518518517,86,0,13,73,84,2,0.0,0.1511627906976744,0.8488372093023255,0.9767441860465116,0.023255813953488372
5515,87,8,79,63,24,0.09195402298850575,0.9080459770114943,0.7241379310344828,0.27586206896551724,85,0,1,84,81,4,0.0,0.011764705882352941,0.9882352941176471,0.9529411764705882,0.047058823529411764
5516,119,8,111,93,26,0.06722689075630252,0.9327731092436975,0.7815126050420168,0.2184873949579832,106,0,16,90,104,2,0.0,0.1509433962264151,0.8490566037735849,0.9811320754716981,0.018867924528301886
5517,62,18,44,27,35,0.2903225806451613,0.7096774193548387,0.43548387096774194,0.5645161290322581,92,0,32,60,92,0,0.0,0.34782608695652173,0.6521739130434783,1.0,0.0
5518,112,10,102,71,41,0.08928571428571429,0.9107142857142857,0.6339285714285714,0.36607142857142855,132,0,0,132,129,3,0.0,0.0,1.0,0.9772727272727273,0.022727272727272728
5519,125,4,121,105,20,0.032,0.968,0.84,0.16,102,0,12,90,100,2,0.0,0.11764705882352941,0.8823529411764706,0.9803921568627451,0.0196078431372549
5520,105,10,95,80,25,0.09523809523809523,0.9047619047619048,0.7619047619047619,0.23809523809523808,85,0,12,73,83,2,0.0,0.1411764705882353,0.8588235294117647,0.9764705882352941,0.023529411764705882
5521,196,16,180,152,44,0.08163265306122448,0.9183673469387755,0.7755102040816326,0.22448979591836735,139,0,25,114,137,2,0.0,0.17985611510791366,0.8201438848920863,0.9856115107913669,0.014388489208633094
5522,116,20,96,68,48,0.1724137931034483,0.8275862068965517,0.5862068965517241,0.41379310344827586,113,0,0,113,110,3,0.0,0.0,1.0,0.9734513274336283,0.02654867256637168
5523,110,5,105,93,17,0.045454545454545456,0.9545454545454546,0.8454545454545455,0.15454545454545454,81,0,9,72,79,2,0.0,0.1111111111111111,0.8888888888888888,0.9753086419753086,0.024691358024691357
5524,126,16,110,80,46,0.12698412698412698,0.873015873015873,0.6349206349206349,0.36507936507936506,109,0,1,108,106,3,0.0,0.009174311926605505,0.9908256880733946,0.9724770642201835,0.027522935779816515
5525,118,8,110,77,41,0.06779661016949153,0.9322033898305084,0.652542372881356,0.3474576271186441,109,0,1,108,105,4,0.0,0.009174311926605505,0.9908256880733946,0.963302752293578,0.03669724770642202
5526,131,21,110,84,47,0.16030534351145037,0.8396946564885496,0.6412213740458015,0.35877862595419846,105,0,1,104,101,4,0.0,0.009523809523809525,0.9904761904761905,0.9619047619047619,0.0380952380952381
5527,192,10,182,155,37,0.052083333333333336,0.9479166666666666,0.8072916666666666,0.19270833333333334,137,0,26,111,134,3,0.0,0.1897810218978102,0.8102189781021898,0.9781021897810219,0.021897810218978103
5528,92,16,76,55,37,0.17391304347826086,0.8260869565217391,0.5978260869565217,0.40217391304347827,97,0,0,97,93,4,0.0,0.0,1.0,0.9587628865979382,0.041237113402061855
5529,58,11,47,27,31,0.1896551724137931,0.8103448275862069,0.46551724137931033,0.5344827586206896,133,0,0,133,130,3,0.0,0.0,1.0,0.9774436090225563,0.022556390977443608
5530,59,12,47,30,29,0.2033898305084746,0.7966101694915254,0.5084745762711864,0.4915254237288136,141,0,0,141,138,3,0.0,0.0,1.0,0.9787234042553191,0.02127659574468085
5531,119,8,111,96,23,0.06722689075630252,0.9327731092436975,0.8067226890756303,0.19327731092436976,85,0,8,77,83,2,0.0,0.09411764705882353,0.9058823529411765,0.9764705882352941,0.023529411764705882
5532,110,19,91,59,51,0.17272727272727273,0.8272727272727273,0.5363636363636364,0.4636363636363636,175,0,54,121,173,2,0.0,0.30857142857142855,0.6914285714285714,0.9885714285714285,0.011428571428571429
5533,122,15,107,78,44,0.12295081967213115,0.8770491803278688,0.639344262295082,0.36065573770491804,109,0,2,107,106,3,0.0,0.01834862385321101,0.981651376146789,0.9724770642201835,0.027522935779816515
5534,215,19,196,167,48,0.08837209302325581,0.9116279069767442,0.7767441860465116,0.22325581395348837,147,0,24,123,145,2,0.0,0.16326530612244897,0.8367346938775511,0.9863945578231292,0.013605442176870748
5535,125,14,111,81,44,0.112,0.888,0.648,0.352,106,0,2,104,102,4,0.0,0.018867924528301886,0.9811320754716981,0.9622641509433962,0.03773584905660377
5536,120,10,110,81,39,0.08333333333333333,0.9166666666666666,0.675,0.325,110,0,2,108,106,4,0.0,0.01818181818181818,0.9818181818181818,0.9636363636363636,0.03636363636363636
5537,121,11,110,81,40,0.09090909090909091,0.9090909090909091,0.6694214876033058,0.3305785123966942,110,0,1,109,106,4,0.0,0.00909090909090909,0.990909090909091,0.9636363636363636,0.03636363636363636
5538,111,6,105,84,27,0.05405405405405406,0.9459459459459459,0.7567567567567568,0.24324324324324326,84,0,10,74,82,2,0.0,0.11904761904761904,0.8809523809523809,0.9761904761904762,0.023809523809523808
5539,67,20,47,26,41,0.29850746268656714,0.7014925373134329,0.3880597014925373,0.6119402985074627,136,0,0,136,133,3,0.0,0.0,1.0,0.9779411764705882,0.022058823529411766
5540,128,17,111,85,43,0.1328125,0.8671875,0.6640625,0.3359375,111,0,2,109,107,4,0.0,0.018018018018018018,0.9819819819819819,0.963963963963964,0.036036036036036036
5541,199,18,181,156,43,0.09045226130653267,0.9095477386934674,0.7839195979899497,0.21608040201005024,142,0,27,115,140,2,0.0,0.19014084507042253,0.8098591549295775,0.9859154929577465,0.014084507042253521
5542,122,11,111,75,47,0.09016393442622951,0.9098360655737705,0.6147540983606558,0.38524590163934425,109,0,2,107,106,3,0.0,0.01834862385321101,0.981651376146789,0.9724770642201835,0.027522935779816515
5543,122,12,110,83,39,0.09836065573770492,0.9016393442622951,0.680327868852459,0.319672131147541,103,0,1,102,99,4,0.0,0.009708737864077669,0.9902912621359223,0.9611650485436893,0.038834951456310676
5544,58,10,48,25,33,0.1724137931034483,0.8275862068965517,0.43103448275862066,0.5689655172413793,150,0,0,150,147,3,0.0,0.0,1.0,0.98,0.02
5545,123,6,117,89,34,0.04878048780487805,0.9512195121951219,0.7235772357723578,0.2764227642276423,90,0,18,72,88,2,0.0,0.2,0.8,0.9777777777777777,0.022222222222222223
5546,163,15,148,117,46,0.09202453987730061,0.9079754601226994,0.7177914110429447,0.2822085889570552,138,0,24,114,137,1,0.0,0.17391304347826086,0.8260869565217391,0.9927536231884058,0.007246376811594203
5547,220,23,197,166,54,0.10454545454545454,0.8954545454545455,0.7545454545454545,0.24545454545454545,148,0,27,121,146,2,0.0,0.18243243243243243,0.8175675675675675,0.9864864864864865,0.013513513513513514
5548,121,11,110,87,34,0.09090909090909091,0.9090909090909091,0.71900826446281,0.2809917355371901,114,0,1,113,110,4,0.0,0.008771929824561403,0.9912280701754386,0.9649122807017544,0.03508771929824561
5549,60,13,47,19,41,0.21666666666666667,0.7833333333333333,0.31666666666666665,0.6833333333333333,141,0,0,141,138,3,0.0,0.0,1.0,0.9787234042553191,0.02127659574468085
5550,121,14,107,73,48,0.11570247933884298,0.8842975206611571,0.6033057851239669,0.39669421487603307,122,0,2,120,118,4,0.0,0.01639344262295082,0.9836065573770492,0.9672131147540983,0.03278688524590164
5551,60,13,47,26,34,0.21666666666666667,0.7833333333333333,0.43333333333333335,0.5666666666666667,136,0,0,136,133,3,0.0,0.0,1.0,0.9779411764705882,0.022058823529411766
5552,109,6,103,93,16,0.05504587155963303,0.944954128440367,0.8532110091743119,0.14678899082568808,81,0,7,74,79,2,0.0,0.08641975308641975,0.9135802469135802,0.9753086419753086,0.024691358024691357
5553,166,18,148,116,50,0.10843373493975904,0.891566265060241,0.6987951807228916,0.30120481927710846,135,0,24,111,134,1,0.0,0.17777777777777778,0.8222222222222222,0.9925925925925926,0.007407407407407408
5554,52,8,44,22,30,0.15384615384615385,0.8461538461538461,0.4230769230769231,0.5769230769230769,92,0,32,60,92,0,0.0,0.34782608695652173,0.6521739130434783,1.0,0.0
5555,43,9,34,33,10,0.20930232558139536,0.7906976744186046,0.7674418604651163,0.23255813953488372,80,0,12,68,77,3,0.0,0.15,0.85,0.9625,0.0375
5556,106,4,102,86,20,0.03773584905660377,0.9622641509433962,0.8113207547169812,0.18867924528301888,86,0,11,75,84,2,0.0,0.12790697674418605,0.872093023255814,0.9767441860465116,0.023255813953488372
5557,62,15,47,24,38,0.24193548387096775,0.7580645161290323,0.3870967741935484,0.6129032258064516,149,0,0,149,146,3,0.0,0.0,1.0,0.9798657718120806,0.020134228187919462
5558,58,11,47,26,32,0.1896551724137931,0.8103448275862069,0.4482758620689655,0.5517241379310345,145,0,0,145,142,3,0.0,0.0,1.0,0.9793103448275862,0.020689655172413793
5559,37,3,34,32,5,0.08108108108108109,0.918918918918919,0.8648648648648649,0.13513513513513514,86,0,20,66,83,3,0.0,0.23255813953488372,0.7674418604651163,0.9651162790697675,0.03488372093023256
5560,109,9,100,74,35,0.08256880733944955,0.9174311926605505,0.6788990825688074,0.3211009174311927,110,0,0,110,107,3,0.0,0.0,1.0,0.9727272727272728,0.02727272727272727
5561,125,17,108,76,49,0.136,0.864,0.608,0.392,119,0,1,118,115,4,0.0,0.008403361344537815,0.9915966386554622,0.9663865546218487,0.03361344537815126
5562,115,17,98,70,45,0.14782608695652175,0.8521739130434782,0.6086956521739131,0.391304347826087,108,0,0,108,105,3,0.0,0.0,1.0,0.9722222222222222,0.027777777777777776
5563,104,7,97,81,23,0.0673076923076923,0.9326923076923077,0.7788461538461539,0.22115384615384615,96,0,18,78,94,2,0.0,0.1875,0.8125,0.9791666666666666,0.020833333333333332
5564,71,6,65,51,20,0.08450704225352113,0.9154929577464789,0.7183098591549296,0.28169014084507044,85,0,0,85,81,4,0.0,0.0,1.0,0.9529411764705882,0.047058823529411764
5565,196,15,181,156,40,0.07653061224489796,0.923469387755102,0.7959183673469388,0.20408163265306123,148,0,24,124,145,3,0.0,0.16216216216216217,0.8378378378378378,0.9797297297297297,0.02027027027027027
5566,217,18,199,171,46,0.08294930875576037,0.9170506912442397,0.7880184331797235,0.2119815668202765,138,0,25,113,136,2,0.0,0.18115942028985507,0.8188405797101449,0.9855072463768116,0.014492753623188406
5567,106,17,89,54,52,0.16037735849056603,0.839622641509434,0.5094339622641509,0.49056603773584906,183,0,53,130,179,4,0.0,0.2896174863387978,0.7103825136612022,0.9781420765027322,0.02185792349726776
5568,82,18,64,42,40,0.21951219512195122,0.7804878048780488,0.5121951219512195,0.4878048780487805,97,0,28,69,97,0,0.0,0.28865979381443296,0.711340206185567,1.0,0.0
5569,73,19,54,26,47,0.2602739726027397,0.7397260273972602,0.3561643835616438,0.6438356164383562,91,0,31,60,91,0,0.0,0.34065934065934067,0.6593406593406593,1.0,0.0
5570,165,17,148,121,44,0.10303030303030303,0.896969696969697,0.7333333333333333,0.26666666666666666,152,1,24,127,151,1,0.006578947368421052,0.15789473684210525,0.8355263157894737,0.993421052631579,0.006578947368421052
5571,64,16,48,28,36,0.25,0.75,0.4375,0.5625,140,0,0,140,137,3,0.0,0.0,1.0,0.9785714285714285,0.02142857142857143
5572,130,9,121,98,32,0.06923076923076923,0.9307692307692308,0.7538461538461538,0.24615384615384617,102,0,14,88,100,2,0.0,0.13725490196078433,0.8627450980392157,0.9803921568627451,0.0196078431372549
5573,38,4,34,31,7,0.10526315789473684,0.8947368421052632,0.8157894736842105,0.18421052631578946,85,0,16,69,82,3,0.0,0.18823529411764706,0.8117647058823529,0.9647058823529412,0.03529411764705882
5574,79,15,64,35,44,0.189873417721519,0.810126582278481,0.4430379746835443,0.5569620253164557,101,0,32,69,101,0,0.0,0.31683168316831684,0.6831683168316832,1.0,0.0
5575,76,22,54,25,51,0.2894736842105263,0.7105263157894737,0.32894736842105265,0.6710526315789473,105,0,30,75,105,0,0.0,0.2857142857142857,0.7142857142857143,1.0,0.0
5576,120,10,110,87,33,0.08333333333333333,0.9166666666666666,0.725,0.275,115,0,1,114,111,4,0.0,0.008695652173913044,0.991304347826087,0.9652173913043478,0.034782608695652174
5577,198,19,179,158,40,0.09595959595959595,0.9040404040404041,0.797979797979798,0.20202020202020202,139,0,27,112,137,2,0.0,0.19424460431654678,0.8057553956834532,0.9856115107913669,0.014388489208633094
5578,90,13,77,55,35,0.14444444444444443,0.8555555555555555,0.6111111111111112,0.3888888888888889,106,0,0,106,102,4,0.0,0.0,1.0,0.9622641509433962,0.03773584905660377
5579,117,19,98,76,41,0.1623931623931624,0.8376068376068376,0.6495726495726496,0.3504273504273504,107,0,0,107,104,3,0.0,0.0,1.0,0.9719626168224299,0.028037383177570093
5580,123,13,110,79,44,0.10569105691056911,0.8943089430894309,0.6422764227642277,0.35772357723577236,113,0,1,112,109,4,0.0,0.008849557522123894,0.9911504424778761,0.9646017699115044,0.035398230088495575
5581,108,4,104,91,17,0.037037037037037035,0.9629629629629629,0.8425925925925926,0.1574074074074074,87,0,14,73,85,2,0.0,0.16091954022988506,0.8390804597701149,0.9770114942528736,0.022988505747126436
5582,163,15,148,108,55,0.09202453987730061,0.9079754601226994,0.6625766871165644,0.3374233128834356,152,0,24,128,151,1,0.0,0.15789473684210525,0.8421052631578947,0.993421052631579,0.006578947368421052
5583,126,15,111,80,46,0.11904761904761904,0.8809523809523809,0.6349206349206349,0.36507936507936506,110,0,2,108,107,3,0.0,0.01818181818181818,0.9818181818181818,0.9727272727272728,0.02727272727272727
5584,210,16,194,166,44,0.0761904761904762,0.9238095238095239,0.7904761904761904,0.20952380952380953,149,0,26,123,146,3,0.0,0.174496644295302,0.825503355704698,0.9798657718120806,0.020134228187919462
5585,111,15,96,66,45,0.13513513513513514,0.8648648648648649,0.5945945945945946,0.40540540540540543,109,0,0,109,107,2,0.0,0.0,1.0,0.981651376146789,0.01834862385321101
5586,81,6,75,51,30,0.07407407407407407,0.9259259259259259,0.6296296296296297,0.37037037037037035,82,0,1,81,78,4,0.0,0.012195121951219513,0.9878048780487805,0.9512195121951219,0.04878048780487805
5587,121,11,110,78,43,0.09090909090909091,0.9090909090909091,0.6446280991735537,0.35537190082644626,115,0,1,114,111,4,0.0,0.008695652173913044,0.991304347826087,0.9652173913043478,0.034782608695652174
5588,120,10,110,80,40,0.08333333333333333,0.9166666666666666,0.6666666666666666,0.3333333333333333,109,0,1,108,105,4,0.0,0.009174311926605505,0.9908256880733946,0.963302752293578,0.03669724770642202
5589,110,5,105,92,18,0.045454545454545456,0.9545454545454546,0.8363636363636363,0.16363636363636364,85,0,14,71,83,2,0.0,0.16470588235294117,0.8352941176470589,0.9764705882352941,0.023529411764705882
5590,175,158,17,172,3,0.9028571428571428,0.09714285714285714,0.9828571428571429,0.017142857142857144,316,0,43,273,97,219,0.0,0.1360759493670886,0.8639240506329114,0.3069620253164557,0.6930379746835443
5591,80,14,66,39,41,0.175,0.825,0.4875,0.5125,95,0,28,67,95,0,0.0,0.29473684210526313,0.7052631578947368,1.0,0.0
5592,74,20,54,26,48,0.2702702702702703,0.7297297297297297,0.35135135135135137,0.6486486486486487,107,0,32,75,107,0,0.0,0.29906542056074764,0.7009345794392523,1.0,0.0
5593,86,10,76,53,33,0.11627906976744186,0.8837209302325582,0.6162790697674418,0.38372093023255816,117,0,0,117,113,4,0.0,0.0,1.0,0.9658119658119658,0.03418803418803419
5594,145,12,133,107,38,0.08275862068965517,0.9172413793103448,0.7379310344827587,0.2620689655172414,127,0,24,103,126,1,0.0,0.1889763779527559,0.8110236220472441,0.9921259842519685,0.007874015748031496
5595,126,18,108,79,47,0.14285714285714285,0.8571428571428571,0.626984126984127,0.373015873015873,103,0,1,102,99,4,0.0,0.009708737864077669,0.9902912621359223,0.9611650485436893,0.038834951456310676
5596,76,22,54,29,47,0.2894736842105263,0.7105263157894737,0.3815789473684211,0.618421052631579,90,0,30,60,90,0,0.0,0.3333333333333333,0.6666666666666666,1.0,0.0
5597,123,13,110,87,36,0.10569105691056911,0.8943089430894309,0.7073170731707317,0.2926829268292683,117,0,1,116,113,4,0.0,0.008547008547008548,0.9914529914529915,0.9658119658119658,0.03418803418803419
5598,145,12,133,110,35,0.08275862068965517,0.9172413793103448,0.7586206896551724,0.2413793103448276,133,0,24,109,132,1,0.0,0.18045112781954886,0.8195488721804511,0.9924812030075187,0.007518796992481203
5599,123,14,109,77,46,0.11382113821138211,0.8861788617886179,0.6260162601626016,0.37398373983739835,113,0,1,112,109,4,0.0,0.008849557522123894,0.9911504424778761,0.9646017699115044,0.035398230088495575
5600,146,13,133,100,46,0.08904109589041095,0.910958904109589,0.684931506849315,0.3150684931506849,134,0,24,110,133,1,0.0,0.1791044776119403,0.8208955223880597,0.9925373134328358,0.007462686567164179
5601,122,12,110,84,38,0.09836065573770492,0.9016393442622951,0.6885245901639344,0.3114754098360656,109,0,1,108,106,3,0.0,0.009174311926605505,0.9908256880733946,0.9724770642201835,0.027522935779816515
5602,67,13,54,25,42,0.19402985074626866,0.8059701492537313,0.373134328358209,0.6268656716417911,92,0,31,61,92,0,0.0,0.33695652173913043,0.6630434782608695,1.0,0.0
5603,129,9,120,99,30,0.06976744186046512,0.9302325581395349,0.7674418604651163,0.23255813953488372,107,0,15,92,105,2,0.0,0.14018691588785046,0.8598130841121495,0.9813084112149533,0.018691588785046728
5604,59,12,47,26,33,0.2033898305084746,0.7966101694915254,0.4406779661016949,0.559322033898305,138,0,0,138,135,3,0.0,0.0,1.0,0.9782608695652174,0.021739130434782608
5605,141,8,133,94,47,0.05673758865248227,0.9432624113475178,0.6666666666666666,0.3333333333333333,138,0,24,114,137,1,0.0,0.17391304347826086,0.8260869565217391,0.9927536231884058,0.007246376811594203
5606,196,17,179,153,43,0.08673469387755102,0.9132653061224489,0.7806122448979592,0.2193877551020408,154,0,27,127,151,3,0.0,0.17532467532467533,0.8246753246753247,0.9805194805194806,0.01948051948051948
5607,111,10,101,82,29,0.09009009009009009,0.9099099099099099,0.7387387387387387,0.26126126126126126,84,0,16,68,82,2,0.0,0.19047619047619047,0.8095238095238095,0.9761904761904762,0.023809523809523808
5608,128,18,110,82,46,0.140625,0.859375,0.640625,0.359375,111,0,1,110,107,4,0.0,0.009009009009009009,0.990990990990991,0.963963963963964,0.036036036036036036
5609,76,12,64,36,40,0.15789473684210525,0.8421052631578947,0.47368421052631576,0.5263157894736842,87,0,31,56,87,0,0.0,0.3563218390804598,0.6436781609195402,1.0,0.0
5610,106,15,91,58,48,0.14150943396226415,0.8584905660377359,0.5471698113207547,0.4528301886792453,178,0,54,124,176,2,0.0,0.30337078651685395,0.6966292134831461,0.9887640449438202,0.011235955056179775
5611,60,12,48,29,31,0.2,0.8,0.48333333333333334,0.5166666666666667,141,0,0,141,139,2,0.0,0.0,1.0,0.9858156028368794,0.014184397163120567
5612,113,22,91,58,55,0.19469026548672566,0.8053097345132744,0.5132743362831859,0.48672566371681414,185,0,54,131,181,4,0.0,0.2918918918918919,0.7081081081081081,0.9783783783783784,0.021621621621621623
5613,113,13,100,69,44,0.11504424778761062,0.8849557522123894,0.6106194690265486,0.3893805309734513,131,0,0,131,127,4,0.0,0.0,1.0,0.9694656488549618,0.030534351145038167
5614,67,13,54,29,38,0.19402985074626866,0.8059701492537313,0.43283582089552236,0.5671641791044776,105,0,30,75,105,0,0.0,0.2857142857142857,0.7142857142857143,1.0,0.0
5615,169,21,148,117,52,0.1242603550295858,0.8757396449704142,0.6923076923076923,0.3076923076923077,157,0,24,133,156,1,0.0,0.15286624203821655,0.8471337579617835,0.9936305732484076,0.006369426751592357
5616,125,14,111,88,37,0.112,0.888,0.704,0.296,112,0,2,110,108,4,0.0,0.017857142857142856,0.9821428571428571,0.9642857142857143,0.03571428571428571
5617,156,13,143,111,45,0.08333333333333333,0.9166666666666666,0.7115384615384616,0.28846153846153844,145,1,24,120,144,1,0.006896551724137931,0.16551724137931034,0.8275862068965517,0.993103448275862,0.006896551724137931
5618,125,15,110,77,48,0.12,0.88,0.616,0.384,107,0,1,106,103,4,0.0,0.009345794392523364,0.9906542056074766,0.9626168224299065,0.037383177570093455
5619,107,16,91,56,51,0.14953271028037382,0.8504672897196262,0.5233644859813084,0.4766355140186916,183,1,54,128,180,3,0.00546448087431694,0.29508196721311475,0.6994535519125683,0.9836065573770492,0.01639344262295082
5620,190,9,181,153,37,0.04736842105263158,0.9526315789473684,0.8052631578947368,0.19473684210526315,144,0,25,119,142,2,0.0,0.1736111111111111,0.8263888888888888,0.9861111111111112,0.013888888888888888
5621,104,6,98,84,20,0.057692307692307696,0.9423076923076923,0.8076923076923077,0.19230769230769232,84,0,9,75,81,3,0.0,0.10714285714285714,0.8928571428571429,0.9642857142857143,0.03571428571428571
5622,121,11,110,83,38,0.09090909090909091,0.9090909090909091,0.6859504132231405,0.3140495867768595,109,0,1,108,105,4,0.0,0.009174311926605505,0.9908256880733946,0.963302752293578,0.03669724770642202
5623,54,6,48,29,25,0.1111111111111111,0.8888888888888888,0.5370370370370371,0.46296296296296297,143,0,0,143,140,3,0.0,0.0,1.0,0.9790209790209791,0.02097902097902098
5624,123,9,114,92,31,0.07317073170731707,0.926829268292683,0.7479674796747967,0.25203252032520324,102,0,18,84,100,2,0.0,0.17647058823529413,0.8235294117647058,0.9803921568627451,0.0196078431372549
5625,118,8,110,75,43,0.06779661016949153,0.9322033898305084,0.635593220338983,0.3644067796610169,109,0,1,108,105,4,0.0,0.009174311926605505,0.9908256880733946,0.963302752293578,0.03669724770642202
5626,133,10,123,104,29,0.07518796992481203,0.924812030075188,0.7819548872180451,0.21804511278195488,95,0,11,84,93,2,0.0,0.11578947368421053,0.8842105263157894,0.9789473684210527,0.021052631578947368
5627,122,9,113,96,26,0.07377049180327869,0.9262295081967213,0.7868852459016393,0.21311475409836064,101,0,18,83,99,2,0.0,0.1782178217821782,0.8217821782178217,0.9801980198019802,0.019801980198019802
5628,85,8,77,58,27,0.09411764705882353,0.9058823529411765,0.6823529411764706,0.3176470588235294,80,0,1,79,76,4,0.0,0.0125,0.9875,0.95,0.05
5629,164,17,147,115,49,0.10365853658536585,0.8963414634146342,0.7012195121951219,0.29878048780487804,138,0,24,114,137,1,0.0,0.17391304347826086,0.8260869565217391,0.9927536231884058,0.007246376811594203
5630,165,17,148,112,53,0.10303030303030303,0.896969696969697,0.6787878787878788,0.3212121212121212,149,0,24,125,148,1,0.0,0.1610738255033557,0.8389261744966443,0.9932885906040269,0.006711409395973154
5631,91,8,83,65,26,0.08791208791208792,0.9120879120879121,0.7142857142857143,0.2857142857142857,84,0,1,83,80,4,0.0,0.011904761904761904,0.9880952380952381,0.9523809523809523,0.047619047619047616
5632,112,4,108,91,21,0.03571428571428571,0.9642857142857143,0.8125,0.1875,75,0,9,66,73,2,0.0,0.12,0.88,0.9733333333333334,0.02666666666666667
5633,77,14,63,39,38,0.18181818181818182,0.8181818181818182,0.5064935064935064,0.4935064935064935,88,0,30,58,88,0,0.0,0.3409090909090909,0.6590909090909091,1.0,0.0
5634,38,4,34,30,8,0.10526315789473684,0.8947368421052632,0.7894736842105263,0.21052631578947367,84,0,14,70,81,3,0.0,0.16666666666666666,0.8333333333333334,0.9642857142857143,0.03571428571428571
5635,110,7,103,77,33,0.06363636363636363,0.9363636363636364,0.7,0.3,119,0,0,119,115,4,0.0,0.0,1.0,0.9663865546218487,0.03361344537815126
5636,124,14,110,79,45,0.11290322580645161,0.8870967741935484,0.6370967741935484,0.3629032258064516,113,0,1,112,109,4,0.0,0.008849557522123894,0.9911504424778761,0.9646017699115044,0.035398230088495575
5637,46,12,34,19,27,0.2608695652173913,0.7391304347826086,0.41304347826086957,0.5869565217391305,77,0,30,47,77,0,0.0,0.38961038961038963,0.6103896103896104,1.0,0.0
5638,112,16,96,68,44,0.14285714285714285,0.8571428571428571,0.6071428571428571,0.39285714285714285,104,0,0,104,101,3,0.0,0.0,1.0,0.9711538461538461,0.028846153846153848
5639,73,19,54,26,47,0.2602739726027397,0.7397260273972602,0.3561643835616438,0.6438356164383562,97,0,30,67,97,0,0.0,0.30927835051546393,0.6907216494845361,1.0,0.0
5640,64,17,47,22,42,0.265625,0.734375,0.34375,0.65625,133,0,0,133,130,3,0.0,0.0,1.0,0.9774436090225563,0.022556390977443608
5641,100,4,96,80,20,0.04,0.96,0.8,0.2,91,0,14,77,89,2,0.0,0.15384615384615385,0.8461538461538461,0.978021978021978,0.02197802197802198
5642,87,11,76,52,35,0.12643678160919541,0.8735632183908046,0.5977011494252874,0.40229885057471265,118,0,0,118,114,4,0.0,0.0,1.0,0.9661016949152542,0.03389830508474576
5643,110,17,93,68,42,0.15454545454545454,0.8454545454545455,0.6181818181818182,0.38181818181818183,113,0,0,113,110,3,0.0,0.0,1.0,0.9734513274336283,0.02654867256637168
5644,55,11,44,21,34,0.2,0.8,0.38181818181818183,0.6181818181818182,96,0,30,66,96,0,0.0,0.3125,0.6875,1.0,0.0
5645,62,15,47,24,38,0.24193548387096775,0.7580645161290323,0.3870967741935484,0.6129032258064516,138,0,0,138,136,2,0.0,0.0,1.0,0.9855072463768116,0.014492753623188406
5646,45,11,34,16,29,0.24444444444444444,0.7555555555555555,0.35555555555555557,0.6444444444444445,83,0,32,51,83,0,0.0,0.3855421686746988,0.6144578313253012,1.0,0.0
5647,60,13,47,26,34,0.21666666666666667,0.7833333333333333,0.43333333333333335,0.5666666666666667,145,0,0,145,143,2,0.0,0.0,1.0,0.9862068965517241,0.013793103448275862
5648,67,13,54,31,36,0.19402985074626866,0.8059701492537313,0.4626865671641791,0.5373134328358209,110,0,30,80,110,0,0.0,0.2727272727272727,0.7272727272727273,1.0,0.0
5649,59,12,47,28,31,0.2033898305084746,0.7966101694915254,0.4745762711864407,0.5254237288135594,136,0,0,136,134,2,0.0,0.0,1.0,0.9852941176470589,0.014705882352941176
5650,124,14,110,83,41,0.11290322580645161,0.8870967741935484,0.6693548387096774,0.33064516129032256,107,0,0,107,103,4,0.0,0.0,1.0,0.9626168224299065,0.037383177570093455
5651,58,11,47,27,31,0.1896551724137931,0.8103448275862069,0.46551724137931033,0.5344827586206896,137,0,0,137,134,3,0.0,0.0,1.0,0.9781021897810219,0.021897810218978103
5652,87,11,76,57,30,0.12643678160919541,0.8735632183908046,0.6551724137931034,0.3448275862068966,103,0,0,103,101,2,0.0,0.0,1.0,0.9805825242718447,0.019417475728155338
5653,167,19,148,119,48,0.11377245508982035,0.8862275449101796,0.7125748502994012,0.2874251497005988,140,0,24,116,139,1,0.0,0.17142857142857143,0.8285714285714286,0.9928571428571429,0.007142857142857143
5654,40,6,34,31,9,0.15,0.85,0.775,0.225,86,0,20,66,84,2,0.0,0.23255813953488372,0.7674418604651163,0.9767441860465116,0.023255813953488372
5655,125,16,109,81,44,0.128,0.872,0.648,0.352,117,0,1,116,114,3,0.0,0.008547008547008548,0.9914529914529915,0.9743589743589743,0.02564102564102564
5656,74,6,68,49,25,0.08108108108108109,0.918918918918919,0.6621621621621622,0.33783783783783783,77,0,0,77,73,4,0.0,0.0,1.0,0.948051948051948,0.05194805194805195
5657,56,9,47,27,29,0.16071428571428573,0.8392857142857143,0.48214285714285715,0.5178571428571429,128,0,0,128,125,3,0.0,0.0,1.0,0.9765625,0.0234375
5658,151,18,133,104,47,0.11920529801324503,0.8807947019867549,0.6887417218543046,0.31125827814569534,120,0,24,96,119,1,0.0,0.2,0.8,0.9916666666666667,0.008333333333333333
5659,72,18,54,30,42,0.25,0.75,0.4166666666666667,0.5833333333333334,110,0,30,80,110,0,0.0,0.2727272727272727,0.7272727272727273,1.0,0.0
5660,122,13,109,84,38,0.10655737704918032,0.8934426229508197,0.6885245901639344,0.3114754098360656,113,0,1,112,110,3,0.0,0.008849557522123894,0.9911504424778761,0.9734513274336283,0.02654867256637168
5661,123,12,111,81,42,0.0975609756097561,0.9024390243902439,0.6585365853658537,0.34146341463414637,108,0,2,106,104,4,0.0,0.018518518518518517,0.9814814814814815,0.9629629629629629,0.037037037037037035
5662,123,13,110,82,41,0.10569105691056911,0.8943089430894309,0.6666666666666666,0.3333333333333333,113,0,1,112,109,4,0.0,0.008849557522123894,0.9911504424778761,0.9646017699115044,0.035398230088495575
5663,125,14,111,85,40,0.112,0.888,0.68,0.32,102,0,2,100,99,3,0.0,0.0196078431372549,0.9803921568627451,0.9705882352941176,0.029411764705882353
5664,122,13,109,79,43,0.10655737704918032,0.8934426229508197,0.6475409836065574,0.3524590163934426,114,0,1,113,110,4,0.0,0.008771929824561403,0.9912280701754386,0.9649122807017544,0.03508771929824561
5665,109,7,102,82,27,0.06422018348623854,0.9357798165137615,0.7522935779816514,0.24770642201834864,91,0,15,76,89,2,0.0,0.16483516483516483,0.8351648351648352,0.978021978021978,0.02197802197802198
5666,110,8,102,69,41,0.07272727272727272,0.9272727272727272,0.6272727272727273,0.37272727272727274,136,0,0,136,134,2,0.0,0.0,1.0,0.9852941176470589,0.014705882352941176
5667,55,11,44,23,32,0.2,0.8,0.41818181818181815,0.5818181818181818,97,0,30,67,97,0,0.0,0.30927835051546393,0.6907216494845361,1.0,0.0
5668,111,6,105,96,15,0.05405405405405406,0.9459459459459459,0.8648648648648649,0.13513513513513514,81,0,8,73,79,2,0.0,0.09876543209876543,0.9012345679012346,0.9753086419753086,0.024691358024691357
5669,95,12,83,66,29,0.12631578947368421,0.8736842105263158,0.6947368421052632,0.30526315789473685,87,0,1,86,83,4,0.0,0.011494252873563218,0.9885057471264368,0.9540229885057471,0.04597701149425287
5670,124,7,117,96,28,0.056451612903225805,0.9435483870967742,0.7741935483870968,0.22580645161290322,107,0,13,94,105,2,0.0,0.12149532710280374,0.8785046728971962,0.9813084112149533,0.018691588785046728
5671,119,7,112,90,29,0.058823529411764705,0.9411764705882353,0.7563025210084033,0.24369747899159663,103,0,17,86,101,2,0.0,0.1650485436893204,0.8349514563106796,0.9805825242718447,0.019417475728155338
5672,163,20,143,112,51,0.12269938650306748,0.8773006134969326,0.6871165644171779,0.3128834355828221,135,0,24,111,134,1,0.0,0.17777777777777778,0.8222222222222222,0.9925925925925926,0.007407407407407408
5673,67,4,63,45,22,0.05970149253731343,0.9402985074626866,0.6716417910447762,0.3283582089552239,78,0,0,78,74,4,0.0,0.0,1.0,0.9487179487179487,0.05128205128205128
5674,84,8,76,54,30,0.09523809523809523,0.9047619047619048,0.6428571428571429,0.35714285714285715,104,0,0,104,101,3,0.0,0.0,1.0,0.9711538461538461,0.028846153846153848
5675,127,16,111,88,39,0.12598425196850394,0.8740157480314961,0.6929133858267716,0.30708661417322836,118,0,2,116,114,4,0.0,0.01694915254237288,0.9830508474576272,0.9661016949152542,0.03389830508474576
5676,123,13,110,83,40,0.10569105691056911,0.8943089430894309,0.6747967479674797,0.3252032520325203,102,0,2,100,98,4,0.0,0.0196078431372549,0.9803921568627451,0.9607843137254902,0.0392156862745098
5677,119,7,112,95,24,0.058823529411764705,0.9411764705882353,0.7983193277310925,0.20168067226890757,86,0,10,76,84,2,0.0,0.11627906976744186,0.8837209302325582,0.9767441860465116,0.023255813953488372
5678,160,17,143,112,48,0.10625,0.89375,0.7,0.3,140,0,24,116,139,1,0.0,0.17142857142857143,0.8285714285714286,0.9928571428571429,0.007142857142857143
5679,89,13,76,55,34,0.14606741573033707,0.8539325842696629,0.6179775280898876,0.38202247191011235,108,0,0,108,105,3,0.0,0.0,1.0,0.9722222222222222,0.027777777777777776
5680,122,12,110,89,33,0.09836065573770492,0.9016393442622951,0.7295081967213115,0.27049180327868855,108,0,1,107,105,3,0.0,0.009259259259259259,0.9907407407407407,0.9722222222222222,0.027777777777777776
5681,87,11,76,54,33,0.12643678160919541,0.8735632183908046,0.6206896551724138,0.3793103448275862,112,0,0,112,109,3,0.0,0.0,1.0,0.9732142857142857,0.026785714285714284
5682,43,9,34,32,11,0.20930232558139536,0.7906976744186046,0.7441860465116279,0.2558139534883721,92,0,19,73,89,3,0.0,0.20652173913043478,0.7934782608695652,0.967391304347826,0.03260869565217391
5683,110,15,95,68,42,0.13636363636363635,0.8636363636363636,0.6181818181818182,0.38181818181818183,117,0,0,117,114,3,0.0,0.0,1.0,0.9743589743589743,0.02564102564102564
5684,57,10,47,26,31,0.17543859649122806,0.8245614035087719,0.45614035087719296,0.543859649122807,130,0,0,130,127,3,0.0,0.0,1.0,0.9769230769230769,0.023076923076923078
5685,121,11,110,78,43,0.09090909090909091,0.9090909090909091,0.6446280991735537,0.35537190082644626,103,0,1,102,100,3,0.0,0.009708737864077669,0.9902912621359223,0.970873786407767,0.02912621359223301
5686,61,7,54,28,33,0.11475409836065574,0.8852459016393442,0.45901639344262296,0.5409836065573771,104,0,30,74,104,0,0.0,0.28846153846153844,0.7115384615384616,1.0,0.0
5687,193,15,178,149,44,0.07772020725388601,0.9222797927461139,0.772020725388601,0.22797927461139897,148,0,26,122,145,3,0.0,0.17567567567567569,0.8243243243243243,0.9797297297297297,0.02027027027027027
5688,95,19,76,56,39,0.2,0.8,0.5894736842105263,0.4105263157894737,111,0,0,111,109,2,0.0,0.0,1.0,0.9819819819819819,0.018018018018018018
5689,57,10,47,29,28,0.17543859649122806,0.8245614035087719,0.5087719298245614,0.49122807017543857,141,0,0,141,138,3,0.0,0.0,1.0,0.9787234042553191,0.02127659574468085
5690,169,21,148,111,58,0.1242603550295858,0.8757396449704142,0.6568047337278107,0.3431952662721893,152,0,24,128,151,1,0.0,0.15789473684210525,0.8421052631578947,0.993421052631579,0.006578947368421052
5691,191,13,178,150,41,0.06806282722513089,0.9319371727748691,0.7853403141361257,0.21465968586387435,136,0,27,109,133,3,0.0,0.19852941176470587,0.8014705882352942,0.9779411764705882,0.022058823529411766
5692,86,10,76,55,31,0.11627906976744186,0.8837209302325582,0.6395348837209303,0.36046511627906974,115,0,0,115,111,4,0.0,0.0,1.0,0.9652173913043478,0.034782608695652174
5693,196,14,182,156,40,0.07142857142857142,0.9285714285714286,0.7959183673469388,0.20408163265306123,147,0,24,123,144,3,0.0,0.16326530612244897,0.8367346938775511,0.9795918367346939,0.02040816326530612
5694,163,15,148,115,48,0.09202453987730061,0.9079754601226994,0.7055214723926381,0.294478527607362,155,1,24,130,154,1,0.0064516129032258064,0.15483870967741936,0.8387096774193549,0.9935483870967742,0.0064516129032258064
5695,54,10,44,24,30,0.18518518518518517,0.8148148148148148,0.4444444444444444,0.5555555555555556,94,0,30,64,94,0,0.0,0.3191489361702128,0.6808510638297872,1.0,0.0
5696,196,16,180,153,43,0.08163265306122448,0.9183673469387755,0.7806122448979592,0.2193877551020408,140,0,26,114,137,3,0.0,0.18571428571428572,0.8142857142857143,0.9785714285714285,0.02142857142857143
5697,114,18,96,70,44,0.15789473684210525,0.8421052631578947,0.6140350877192983,0.38596491228070173,120,0,0,120,117,3,0.0,0.0,1.0,0.975,0.025
5698,117,7,110,78,39,0.05982905982905983,0.9401709401709402,0.6666666666666666,0.3333333333333333,113,0,1,112,109,4,0.0,0.008849557522123894,0.9911504424778761,0.9646017699115044,0.035398230088495575
5699,199,20,179,150,49,0.10050251256281408,0.8994974874371859,0.7537688442211056,0.24623115577889448,134,0,27,107,131,3,0.0,0.20149253731343283,0.7985074626865671,0.9776119402985075,0.022388059701492536
5700,107,16,91,57,50,0.14953271028037382,0.8504672897196262,0.5327102803738317,0.4672897196261682,170,0,54,116,168,2,0.0,0.3176470588235294,0.6823529411764706,0.9882352941176471,0.011764705882352941
5701,110,19,91,61,49,0.17272727272727273,0.8272727272727273,0.5545454545454546,0.44545454545454544,178,0,54,124,175,3,0.0,0.30337078651685395,0.6966292134831461,0.9831460674157303,0.016853932584269662
5702,120,10,110,82,38,0.08333333333333333,0.9166666666666666,0.6833333333333333,0.31666666666666665,109,0,1,108,105,4,0.0,0.009174311926605505,0.9908256880733946,0.963302752293578,0.03669724770642202
5703,109,3,106,86,23,0.027522935779816515,0.9724770642201835,0.7889908256880734,0.21100917431192662,81,0,12,69,79,2,0.0,0.14814814814814814,0.8518518518518519,0.9753086419753086,0.024691358024691357
5704,56,9,47,26,30,0.16071428571428573,0.8392857142857143,0.4642857142857143,0.5357142857142857,139,0,0,139,136,3,0.0,0.0,1.0,0.9784172661870504,0.02158273381294964
5705,44,10,34,18,26,0.22727272727272727,0.7727272727272727,0.4090909090909091,0.5909090909090909,81,0,30,51,81,0,0.0,0.37037037037037035,0.6296296296296297,1.0,0.0
5706,109,12,97,71,38,0.11009174311926606,0.8899082568807339,0.6513761467889908,0.3486238532110092,107,0,0,107,104,3,0.0,0.0,1.0,0.9719626168224299,0.028037383177570093
5707,123,6,117,99,24,0.04878048780487805,0.9512195121951219,0.8048780487804879,0.1951219512195122,110,0,18,92,108,2,0.0,0.16363636363636364,0.8363636363636363,0.9818181818181818,0.01818181818181818
5708,150,17,133,102,48,0.11333333333333333,0.8866666666666667,0.68,0.32,130,0,24,106,129,1,0.0,0.18461538461538463,0.8153846153846154,0.9923076923076923,0.007692307692307693
5709,82,20,62,34,48,0.24390243902439024,0.7560975609756098,0.4146341463414634,0.5853658536585366,113,0,30,83,113,0,0.0,0.26548672566371684,0.7345132743362832,1.0,0.0
5710,92,16,76,57,35,0.17391304347826086,0.8260869565217391,0.6195652173913043,0.3804347826086957,96,0,0,96,92,4,0.0,0.0,1.0,0.9583333333333334,0.041666666666666664
5711,121,11,110,86,35,0.09090909090909091,0.9090909090909091,0.7107438016528925,0.2892561983471074,108,0,1,107,104,4,0.0,0.009259259259259259,0.9907407407407407,0.9629629629629629,0.037037037037037035
5712,123,13,110,85,38,0.10569105691056911,0.8943089430894309,0.6910569105691057,0.3089430894308943,110,0,1,109,106,4,0.0,0.00909090909090909,0.990909090909091,0.9636363636363636,0.03636363636363636
5713,42,8,34,31,11,0.19047619047619047,0.8095238095238095,0.7380952380952381,0.2619047619047619,84,0,13,71,81,3,0.0,0.15476190476190477,0.8452380952380952,0.9642857142857143,0.03571428571428571
5714,126,12,114,93,33,0.09523809523809523,0.9047619047619048,0.7380952380952381,0.2619047619047619,101,0,19,82,99,2,0.0,0.18811881188118812,0.8118811881188119,0.9801980198019802,0.019801980198019802
5715,166,18,148,109,57,0.10843373493975904,0.891566265060241,0.6566265060240963,0.3433734939759036,146,0,24,122,145,1,0.0,0.1643835616438356,0.8356164383561644,0.9931506849315068,0.00684931506849315
5716,41,7,34,16,25,0.17073170731707318,0.8292682926829268,0.3902439024390244,0.6097560975609756,87,0,30,57,87,0,0.0,0.3448275862068966,0.6551724137931034,1.0,0.0
5717,101,10,91,64,37,0.09900990099009901,0.900990099009901,0.6336633663366337,0.36633663366336633,174,0,54,120,171,3,0.0,0.3103448275862069,0.6896551724137931,0.9827586206896551,0.017241379310344827
5718,118,8,110,78,40,0.06779661016949153,0.9322033898305084,0.6610169491525424,0.3389830508474576,111,0,1,110,107,4,0.0,0.009009009009009009,0.990990990990991,0.963963963963964,0.036036036036036036
5719,113,13,100,74,39,0.11504424778761062,0.8849557522123894,0.6548672566371682,0.34513274336283184,135,0,0,135,133,2,0.0,0.0,1.0,0.9851851851851852,0.014814814814814815
5720,123,14,109,81,42,0.11382113821138211,0.8861788617886179,0.6585365853658537,0.34146341463414637,120,0,1,119,117,3,0.0,0.008333333333333333,0.9916666666666667,0.975,0.025
5721,125,9,116,91,34,0.072,0.928,0.728,0.272,98,0,17,81,96,2,0.0,0.17346938775510204,0.826530612244898,0.9795918367346939,0.02040816326530612
5722,133,8,125,104,29,0.06015037593984962,0.9398496240601504,0.7819548872180451,0.21804511278195488,91,0,11,80,89,2,0.0,0.12087912087912088,0.8791208791208791,0.978021978021978,0.02197802197802198
5723,126,16,110,82,44,0.12698412698412698,0.873015873015873,0.6507936507936508,0.3492063492063492,114,0,1,113,110,4,0.0,0.008771929824561403,0.9912280701754386,0.9649122807017544,0.03508771929824561
5724,124,7,117,98,26,0.056451612903225805,0.9435483870967742,0.7903225806451613,0.20967741935483872,103,0,16,87,101,2,0.0,0.1553398058252427,0.8446601941747572,0.9805825242718447,0.019417475728155338
5725,192,14,178,151,41,0.07291666666666667,0.9270833333333334,0.7864583333333334,0.21354166666666666,134,0,28,106,132,2,0.0,0.208955223880597,0.7910447761194029,0.9850746268656716,0.014925373134328358
5726,201,190,11,194,7,0.945273631840796,0.05472636815920398,0.9651741293532339,0.03482587064676617,316,0,55,261,105,211,0.0,0.17405063291139242,0.8259493670886076,0.3322784810126582,0.6677215189873418
5727,126,16,110,78,48,0.12698412698412698,0.873015873015873,0.6190476190476191,0.38095238095238093,118,0,1,117,114,4,0.0,0.00847457627118644,0.9915254237288136,0.9661016949152542,0.03389830508474576
5728,120,10,110,91,29,0.08333333333333333,0.9166666666666666,0.7583333333333333,0.24166666666666667,108,0,1,107,104,4,0.0,0.009259259259259259,0.9907407407407407,0.9629629629629629,0.037037037037037035
5729,194,14,180,153,41,0.07216494845360824,0.9278350515463918,0.788659793814433,0.211340206185567,143,0,26,117,140,3,0.0,0.18181818181818182,0.8181818181818182,0.9790209790209791,0.02097902097902098
5730,88,11,77,57,31,0.125,0.875,0.6477272727272727,0.3522727272727273,84,0,1,83,80,4,0.0,0.011904761904761904,0.9880952380952381,0.9523809523809523,0.047619047619047616
5731,194,16,178,147,47,0.08247422680412371,0.9175257731958762,0.7577319587628866,0.2422680412371134,149,0,25,124,146,3,0.0,0.16778523489932887,0.8322147651006712,0.9798657718120806,0.020134228187919462
5732,147,14,133,95,52,0.09523809523809523,0.9047619047619048,0.6462585034013606,0.35374149659863946,126,0,24,102,125,1,0.0,0.19047619047619047,0.8095238095238095,0.9920634920634921,0.007936507936507936
5733,122,4,118,99,23,0.03278688524590164,0.9672131147540983,0.8114754098360656,0.1885245901639344,98,0,14,84,96,2,0.0,0.14285714285714285,0.8571428571428571,0.9795918367346939,0.02040816326530612
5734,86,10,76,52,34,0.11627906976744186,0.8837209302325582,0.6046511627906976,0.3953488372093023,103,0,0,103,100,3,0.0,0.0,1.0,0.970873786407767,0.02912621359223301
5735,122,12,110,79,43,0.09836065573770492,0.9016393442622951,0.6475409836065574,0.3524590163934426,103,0,1,102,100,3,0.0,0.009708737864077669,0.9902912621359223,0.970873786407767,0.02912621359223301
5736,89,13,76,56,33,0.14606741573033707,0.8539325842696629,0.6292134831460674,0.3707865168539326,112,0,0,112,109,3,0.0,0.0,1.0,0.9732142857142857,0.026785714285714284
5737,113,9,104,86,27,0.07964601769911504,0.9203539823008849,0.7610619469026548,0.23893805309734514,83,0,15,68,81,2,0.0,0.18072289156626506,0.8192771084337349,0.9759036144578314,0.024096385542168676
5738,217,20,197,169,48,0.09216589861751152,0.9078341013824884,0.7788018433179723,0.22119815668202766,133,0,24,109,130,3,0.0,0.18045112781954886,0.8195488721804511,0.9774436090225563,0.022556390977443608
5739,109,7,102,87,22,0.06422018348623854,0.9357798165137615,0.7981651376146789,0.2018348623853211,93,0,15,78,91,2,0.0,0.16129032258064516,0.8387096774193549,0.978494623655914,0.021505376344086023
5740,89,13,76,55,34,0.14606741573033707,0.8539325842696629,0.6179775280898876,0.38202247191011235,115,0,0,115,112,3,0.0,0.0,1.0,0.9739130434782609,0.02608695652173913
5741,58,11,47,26,32,0.1896551724137931,0.8103448275862069,0.4482758620689655,0.5517241379310345,147,0,0,147,144,3,0.0,0.0,1.0,0.9795918367346939,0.02040816326530612
5742,80,18,62,37,43,0.225,0.775,0.4625,0.5375,93,0,28,65,93,0,0.0,0.3010752688172043,0.6989247311827957,1.0,0.0
5743,156,13,143,113,43,0.08333333333333333,0.9166666666666666,0.7243589743589743,0.27564102564102566,151,0,24,127,150,1,0.0,0.15894039735099338,0.8410596026490066,0.9933774834437086,0.006622516556291391
5744,61,14,47,28,33,0.22950819672131148,0.7704918032786885,0.45901639344262296,0.5409836065573771,132,0,0,132,129,3,0.0,0.0,1.0,0.9772727272727273,0.022727272727272728
5745,145,13,132,105,40,0.0896551724137931,0.9103448275862069,0.7241379310344828,0.27586206896551724,125,0,24,101,124,1,0.0,0.192,0.808,0.992,0.008
5746,61,17,44,27,34,0.2786885245901639,0.7213114754098361,0.4426229508196721,0.5573770491803278,86,0,30,56,86,0,0.0,0.3488372093023256,0.6511627906976745,1.0,0.0
5747,114,23,91,61,53,0.20175438596491227,0.7982456140350878,0.5350877192982456,0.4649122807017544,174,0,54,120,172,2,0.0,0.3103448275862069,0.6896551724137931,0.9885057471264368,0.011494252873563218
5748,204,23,181,152,52,0.11274509803921569,0.8872549019607843,0.7450980392156863,0.2549019607843137,150,0,26,124,147,3,0.0,0.17333333333333334,0.8266666666666667,0.98,0.02
5749,191,12,179,149,42,0.06282722513089005,0.93717277486911,0.7801047120418848,0.2198952879581152,134,0,27,107,132,2,0.0,0.20149253731343283,0.7985074626865671,0.9850746268656716,0.014925373134328358
5750,75,12,63,34,41,0.16,0.84,0.4533333333333333,0.5466666666666666,97,0,28,69,97,0,0.0,0.28865979381443296,0.711340206185567,1.0,0.0
5751,197,16,181,153,44,0.08121827411167512,0.9187817258883249,0.7766497461928934,0.2233502538071066,148,0,28,120,146,2,0.0,0.1891891891891892,0.8108108108108109,0.9864864864864865,0.013513513513513514
5752,72,18,54,32,40,0.25,0.75,0.4444444444444444,0.5555555555555556,114,0,32,82,114,0,0.0,0.2807017543859649,0.7192982456140351,1.0,0.0
5753,127,17,110,89,38,0.13385826771653545,0.8661417322834646,0.7007874015748031,0.2992125984251969,110,0,1,109,106,4,0.0,0.00909090909090909,0.990909090909091,0.9636363636363636,0.03636363636363636
5754,70,16,54,27,43,0.22857142857142856,0.7714285714285715,0.38571428571428573,0.6142857142857143,101,0,31,70,101,0,0.0,0.3069306930693069,0.693069306930693,1.0,0.0
5755,126,16,110,81,45,0.12698412698412698,0.873015873015873,0.6428571428571429,0.35714285714285715,111,0,1,110,107,4,0.0,0.009009009009009009,0.990990990990991,0.963963963963964,0.036036036036036036
5756,105,4,101,83,22,0.0380952380952381,0.9619047619047619,0.7904761904761904,0.20952380952380953,96,0,19,77,94,2,0.0,0.19791666666666666,0.8020833333333334,0.9791666666666666,0.020833333333333332
5757,130,19,111,81,49,0.14615384615384616,0.8538461538461538,0.6230769230769231,0.3769230769230769,109,0,1,108,105,4,0.0,0.009174311926605505,0.9908256880733946,0.963302752293578,0.03669724770642202
5758,112,21,91,58,54,0.1875,0.8125,0.5178571428571429,0.48214285714285715,184,0,54,130,182,2,0.0,0.29347826086956524,0.7065217391304348,0.9891304347826086,0.010869565217391304
5759,72,18,54,29,43,0.25,0.75,0.4027777777777778,0.5972222222222222,89,0,30,59,89,0,0.0,0.33707865168539325,0.6629213483146067,1.0,0.0
5760,108,8,100,80,28,0.07407407407407407,0.9259259259259259,0.7407407407407407,0.25925925925925924,86,0,17,69,83,3,0.0,0.19767441860465115,0.8023255813953488,0.9651162790697675,0.03488372093023256
5761,86,10,76,57,29,0.11627906976744186,0.8837209302325582,0.6627906976744186,0.3372093023255814,111,0,0,111,107,4,0.0,0.0,1.0,0.963963963963964,0.036036036036036036
5762,62,8,54,26,36,0.12903225806451613,0.8709677419354839,0.41935483870967744,0.5806451612903226,105,0,31,74,105,0,0.0,0.29523809523809524,0.7047619047619048,1.0,0.0
5763,94,18,76,52,42,0.19148936170212766,0.8085106382978723,0.5531914893617021,0.44680851063829785,109,0,0,109,106,3,0.0,0.0,1.0,0.9724770642201835,0.027522935779816515
5764,118,12,106,70,48,0.1016949152542373,0.8983050847457628,0.5932203389830508,0.4067796610169492,115,0,1,114,111,4,0.0,0.008695652173913044,0.991304347826087,0.9652173913043478,0.034782608695652174
5765,162,14,148,108,54,0.08641975308641975,0.9135802469135802,0.6666666666666666,0.3333333333333333,140,0,24,116,139,1,0.0,0.17142857142857143,0.8285714285714286,0.9928571428571429,0.007142857142857143
5766,213,18,195,164,49,0.08450704225352113,0.9154929577464789,0.7699530516431925,0.2300469483568075,146,0,27,119,143,3,0.0,0.18493150684931506,0.815068493150685,0.9794520547945206,0.02054794520547945
5767,108,17,91,58,50,0.1574074074074074,0.8425925925925926,0.5370370370370371,0.46296296296296297,180,0,54,126,177,3,0.0,0.3,0.7,0.9833333333333333,0.016666666666666666
5768,215,17,198,168,47,0.07906976744186046,0.9209302325581395,0.7813953488372093,0.2186046511627907,150,0,27,123,147,3,0.0,0.18,0.82,0.98,0.02
5769,201,21,180,156,45,0.1044776119402985,0.8955223880597015,0.7761194029850746,0.22388059701492538,140,0,29,111,137,3,0.0,0.20714285714285716,0.7928571428571428,0.9785714285714285,0.02142857142857143
5770,91,15,76,56,35,0.16483516483516483,0.8351648351648352,0.6153846153846154,0.38461538461538464,107,0,0,107,103,4,0.0,0.0,1.0,0.9626168224299065,0.037383177570093455
5771,172,24,148,116,56,0.13953488372093023,0.8604651162790697,0.6744186046511628,0.32558139534883723,133,0,24,109,132,1,0.0,0.18045112781954886,0.8195488721804511,0.9924812030075187,0.007518796992481203
5772,155,12,143,110,45,0.07741935483870968,0.9225806451612903,0.7096774193548387,0.2903225806451613,152,0,24,128,151,1,0.0,0.15789473684210525,0.8421052631578947,0.993421052631579,0.006578947368421052
5773,122,11,111,83,39,0.09016393442622951,0.9098360655737705,0.680327868852459,0.319672131147541,106,0,2,104,102,4,0.0,0.018867924528301886,0.9811320754716981,0.9622641509433962,0.03773584905660377
5774,144,11,133,105,39,0.0763888888888889,0.9236111111111112,0.7291666666666666,0.2708333333333333,133,0,24,109,132,1,0.0,0.18045112781954886,0.8195488721804511,0.9924812030075187,0.007518796992481203
5775,39,5,34,31,8,0.1282051282051282,0.8717948717948718,0.7948717948717948,0.20512820512820512,86,0,17,69,83,3,0.0,0.19767441860465115,0.8023255813953488,0.9651162790697675,0.03488372093023256
5776,122,12,110,87,35,0.09836065573770492,0.9016393442622951,0.7131147540983607,0.28688524590163933,107,0,1,106,103,4,0.0,0.009345794392523364,0.9906542056074766,0.9626168224299065,0.037383177570093455
5777,203,23,180,153,50,0.11330049261083744,0.8866995073891626,0.7536945812807881,0.24630541871921183,136,0,25,111,133,3,0.0,0.18382352941176472,0.8161764705882353,0.9779411764705882,0.022058823529411766
5778,64,16,48,28,36,0.25,0.75,0.4375,0.5625,139,0,0,139,137,2,0.0,0.0,1.0,0.9856115107913669,0.014388489208633094
5779,93,17,76,54,39,0.1827956989247312,0.8172043010752689,0.5806451612903226,0.41935483870967744,112,0,0,112,109,3,0.0,0.0,1.0,0.9732142857142857,0.026785714285714284
5780,123,12,111,82,41,0.0975609756097561,0.9024390243902439,0.6666666666666666,0.3333333333333333,111,0,2,109,107,4,0.0,0.018018018018018018,0.9819819819819819,0.963963963963964,0.036036036036036036
5781,75,4,71,50,25,0.05333333333333334,0.9466666666666667,0.6666666666666666,0.3333333333333333,84,0,0,84,80,4,0.0,0.0,1.0,0.9523809523809523,0.047619047619047616
5782,66,19,47,26,40,0.2878787878787879,0.7121212121212122,0.3939393939393939,0.6060606060606061,144,0,0,144,141,3,0.0,0.0,1.0,0.9791666666666666,0.020833333333333332
5783,122,12,110,81,41,0.09836065573770492,0.9016393442622951,0.6639344262295082,0.3360655737704918,110,0,1,109,106,4,0.0,0.00909090909090909,0.990909090909091,0.9636363636363636,0.03636363636363636
5784,124,13,111,76,48,0.10483870967741936,0.8951612903225806,0.6129032258064516,0.3870967741935484,103,0,2,101,100,3,0.0,0.019417475728155338,0.9805825242718447,0.970873786407767,0.02912621359223301
5785,102,4,98,78,24,0.0392156862745098,0.9607843137254902,0.7647058823529411,0.23529411764705882,95,0,19,76,93,2,0.0,0.2,0.8,0.9789473684210527,0.021052631578947368
5786,120,11,109,85,35,0.09166666666666666,0.9083333333333333,0.7083333333333334,0.2916666666666667,116,0,1,115,112,4,0.0,0.008620689655172414,0.9913793103448276,0.9655172413793104,0.034482758620689655
5787,121,10,111,80,41,0.08264462809917356,0.9173553719008265,0.6611570247933884,0.33884297520661155,115,0,2,113,111,4,0.0,0.017391304347826087,0.9826086956521739,0.9652173913043478,0.034782608695652174
5788,197,15,182,157,40,0.07614213197969544,0.9238578680203046,0.7969543147208121,0.20304568527918782,143,0,28,115,140,3,0.0,0.1958041958041958,0.8041958041958042,0.9790209790209791,0.02097902097902098
5789,114,12,102,74,40,0.10526315789473684,0.8947368421052632,0.6491228070175439,0.3508771929824561,109,0,0,109,106,3,0.0,0.0,1.0,0.9724770642201835,0.027522935779816515
5790,193,17,176,151,42,0.08808290155440414,0.9119170984455959,0.7823834196891192,0.21761658031088082,141,0,24,117,138,3,0.0,0.1702127659574468,0.8297872340425532,0.9787234042553191,0.02127659574468085
5791,85,9,76,55,30,0.10588235294117647,0.8941176470588236,0.6470588235294118,0.35294117647058826,120,0,0,120,117,3,0.0,0.0,1.0,0.975,0.025
5792,45,11,34,16,29,0.24444444444444444,0.7555555555555555,0.35555555555555557,0.6444444444444445,80,0,32,48,80,0,0.0,0.4,0.6,1.0,0.0
5793,109,6,103,86,23,0.05504587155963303,0.944954128440367,0.7889908256880734,0.21100917431192662,88,0,16,72,86,2,0.0,0.18181818181818182,0.8181818181818182,0.9772727272727273,0.022727272727272728
5794,120,9,111,80,40,0.075,0.925,0.6666666666666666,0.3333333333333333,109,0,2,107,106,3,0.0,0.01834862385321101,0.981651376146789,0.9724770642201835,0.027522935779816515
5795,124,13,111,83,41,0.10483870967741936,0.8951612903225806,0.6693548387096774,0.33064516129032256,110,0,2,108,106,4,0.0,0.01818181818181818,0.9818181818181818,0.9636363636363636,0.03636363636363636
5796,131,13,118,97,34,0.09923664122137404,0.9007633587786259,0.7404580152671756,0.2595419847328244,96,0,13,83,93,3,0.0,0.13541666666666666,0.8645833333333334,0.96875,0.03125
5797,84,8,76,58,26,0.09523809523809523,0.9047619047619048,0.6904761904761905,0.30952380952380953,98,0,0,98,94,4,0.0,0.0,1.0,0.9591836734693877,0.04081632653061224
5798,121,12,109,79,42,0.09917355371900827,0.9008264462809917,0.6528925619834711,0.34710743801652894,105,0,1,104,101,4,0.0,0.009523809523809525,0.9904761904761905,0.9619047619047619,0.0380952380952381
5799,165,17,148,116,49,0.10303030303030303,0.896969696969697,0.703030303030303,0.296969696969697,155,0,24,131,154,1,0.0,0.15483870967741936,0.8451612903225807,0.9935483870967742,0.0064516129032258064
5800,52,5,47,28,24,0.09615384615384616,0.9038461538461539,0.5384615384615384,0.46153846153846156,137,0,0,137,135,2,0.0,0.0,1.0,0.9854014598540146,0.014598540145985401
5801,68,14,54,28,40,0.20588235294117646,0.7941176470588235,0.4117647058823529,0.5882352941176471,102,0,32,70,102,0,0.0,0.3137254901960784,0.6862745098039216,1.0,0.0
5802,57,10,47,25,32,0.17543859649122806,0.8245614035087719,0.43859649122807015,0.5614035087719298,147,0,0,147,144,3,0.0,0.0,1.0,0.9795918367346939,0.02040816326530612
5803,121,7,114,89,32,0.05785123966942149,0.9421487603305785,0.7355371900826446,0.2644628099173554,98,0,15,83,96,2,0.0,0.15306122448979592,0.8469387755102041,0.9795918367346939,0.02040816326530612
5804,63,15,48,28,35,0.23809523809523808,0.7619047619047619,0.4444444444444444,0.5555555555555556,135,0,0,135,132,3,0.0,0.0,1.0,0.9777777777777777,0.022222222222222223
5805,54,7,47,24,30,0.12962962962962962,0.8703703703703703,0.4444444444444444,0.5555555555555556,151,0,0,151,148,3,0.0,0.0,1.0,0.9801324503311258,0.019867549668874173
5806,120,9,111,90,30,0.075,0.925,0.75,0.25,108,0,18,90,106,2,0.0,0.16666666666666666,0.8333333333333334,0.9814814814814815,0.018518518518518517
5807,170,22,148,109,61,0.12941176470588237,0.8705882352941177,0.6411764705882353,0.3588235294117647,153,0,24,129,152,1,0.0,0.1568627450980392,0.8431372549019608,0.9934640522875817,0.006535947712418301
5808,112,14,98,73,39,0.125,0.875,0.6517857142857143,0.3482142857142857,112,0,0,112,109,3,0.0,0.0,1.0,0.9732142857142857,0.026785714285714284
5809,107,16,91,56,51,0.14953271028037382,0.8504672897196262,0.5233644859813084,0.4766355140186916,189,0,54,135,186,3,0.0,0.2857142857142857,0.7142857142857143,0.9841269841269841,0.015873015873015872
5810,110,14,96,71,39,0.12727272727272726,0.8727272727272727,0.6454545454545455,0.35454545454545455,112,0,0,112,109,3,0.0,0.0,1.0,0.9732142857142857,0.026785714285714284
5811,60,13,47,24,36,0.21666666666666667,0.7833333333333333,0.4,0.6,135,0,0,135,133,2,0.0,0.0,1.0,0.9851851851851852,0.014814814814814815
5812,118,8,110,86,32,0.06779661016949153,0.9322033898305084,0.7288135593220338,0.2711864406779661,100,0,17,83,98,2,0.0,0.17,0.83,0.98,0.02
5813,106,10,96,72,34,0.09433962264150944,0.9056603773584906,0.6792452830188679,0.32075471698113206,110,0,0,110,107,3,0.0,0.0,1.0,0.9727272727272728,0.02727272727272727
5814,167,19,148,113,54,0.11377245508982035,0.8862275449101796,0.6766467065868264,0.32335329341317365,152,1,24,127,151,1,0.006578947368421052,0.15789473684210525,0.8355263157894737,0.993421052631579,0.006578947368421052
5815,120,6,114,89,31,0.05,0.95,0.7416666666666667,0.25833333333333336,105,0,13,92,103,2,0.0,0.12380952380952381,0.8761904761904762,0.9809523809523809,0.01904761904761905
5816,124,15,109,84,40,0.12096774193548387,0.8790322580645161,0.6774193548387096,0.3225806451612903,103,0,1,102,99,4,0.0,0.009708737864077669,0.9902912621359223,0.9611650485436893,0.038834951456310676
5817,119,10,109,75,44,0.08403361344537816,0.9159663865546218,0.6302521008403361,0.3697478991596639,107,0,1,106,103,4,0.0,0.009345794392523364,0.9906542056074766,0.9626168224299065,0.037383177570093455
5818,215,15,200,175,40,0.06976744186046512,0.9302325581395349,0.813953488372093,0.18604651162790697,133,0,27,106,130,3,0.0,0.20300751879699247,0.7969924812030075,0.9774436090225563,0.022556390977443608
5819,164,16,148,122,42,0.0975609756097561,0.9024390243902439,0.7439024390243902,0.25609756097560976,140,1,24,115,139,1,0.007142857142857143,0.17142857142857143,0.8214285714285714,0.9928571428571429,0.007142857142857143
5820,121,9,112,90,31,0.0743801652892562,0.9256198347107438,0.743801652892562,0.256198347107438,101,0,11,90,99,2,0.0,0.10891089108910891,0.8910891089108911,0.9801980198019802,0.019801980198019802
5821,110,8,102,89,21,0.07272727272727272,0.9272727272727272,0.8090909090909091,0.19090909090909092,93,0,15,78,91,2,0.0,0.16129032258064516,0.8387096774193549,0.978494623655914,0.021505376344086023
5822,72,18,54,29,43,0.25,0.75,0.4027777777777778,0.5972222222222222,97,0,31,66,97,0,0.0,0.31958762886597936,0.6804123711340206,1.0,0.0
5823,81,5,76,55,26,0.06172839506172839,0.9382716049382716,0.6790123456790124,0.32098765432098764,106,0,0,106,104,2,0.0,0.0,1.0,0.9811320754716981,0.018867924528301886
5824,157,14,143,109,48,0.08917197452229299,0.910828025477707,0.6942675159235668,0.3057324840764331,130,0,24,106,129,1,0.0,0.18461538461538463,0.8153846153846154,0.9923076923076923,0.007692307692307693
5825,59,12,47,26,33,0.2033898305084746,0.7966101694915254,0.4406779661016949,0.559322033898305,142,0,0,142,139,3,0.0,0.0,1.0,0.9788732394366197,0.02112676056338028
5826,121,11,110,74,47,0.09090909090909091,0.9090909090909091,0.6115702479338843,0.3884297520661157,113,0,1,112,109,4,0.0,0.008849557522123894,0.9911504424778761,0.9646017699115044,0.035398230088495575
5827,82,20,62,36,46,0.24390243902439024,0.7560975609756098,0.43902439024390244,0.5609756097560976,95,0,28,67,95,0,0.0,0.29473684210526313,0.7052631578947368,1.0,0.0
5828,122,11,111,81,41,0.09016393442622951,0.9098360655737705,0.6639344262295082,0.3360655737704918,122,0,2,120,118,4,0.0,0.01639344262295082,0.9836065573770492,0.9672131147540983,0.03278688524590164
5829,107,8,99,81,26,0.07476635514018691,0.9252336448598131,0.7570093457943925,0.24299065420560748,85,0,7,78,83,2,0.0,0.08235294117647059,0.9176470588235294,0.9764705882352941,0.023529411764705882
5830,121,11,110,78,43,0.09090909090909091,0.9090909090909091,0.6446280991735537,0.35537190082644626,105,0,1,104,101,4,0.0,0.009523809523809525,0.9904761904761905,0.9619047619047619,0.0380952380952381
5831,196,16,180,155,41,0.08163265306122448,0.9183673469387755,0.7908163265306123,0.20918367346938777,141,0,27,114,138,3,0.0,0.19148936170212766,0.8085106382978723,0.9787234042553191,0.02127659574468085
5832,70,16,54,28,42,0.22857142857142856,0.7714285714285715,0.4,0.6,111,0,32,79,111,0,0.0,0.2882882882882883,0.7117117117117117,1.0,0.0
5833,62,18,44,23,39,0.2903225806451613,0.7096774193548387,0.3709677419354839,0.6290322580645161,85,0,31,54,85,0,0.0,0.36470588235294116,0.6352941176470588,1.0,0.0
5834,124,14,110,78,46,0.11290322580645161,0.8870967741935484,0.6290322580645161,0.3709677419354839,110,0,1,109,107,3,0.0,0.00909090909090909,0.990909090909091,0.9727272727272728,0.02727272727272727
5835,160,12,148,113,47,0.075,0.925,0.70625,0.29375,161,0,24,137,160,1,0.0,0.14906832298136646,0.8509316770186336,0.9937888198757764,0.006211180124223602
5836,88,12,76,54,34,0.13636363636363635,0.8636363636363636,0.6136363636363636,0.38636363636363635,108,0,0,108,105,3,0.0,0.0,1.0,0.9722222222222222,0.027777777777777776
5837,60,13,47,29,31,0.21666666666666667,0.7833333333333333,0.48333333333333334,0.5166666666666667,131,0,0,131,128,3,0.0,0.0,1.0,0.9770992366412213,0.022900763358778626
5838,89,13,76,54,35,0.14606741573033707,0.8539325842696629,0.6067415730337079,0.39325842696629215,112,0,0,112,109,3,0.0,0.0,1.0,0.9732142857142857,0.026785714285714284
5839,125,15,110,80,45,0.12,0.88,0.64,0.36,109,0,1,108,105,4,0.0,0.009174311926605505,0.9908256880733946,0.963302752293578,0.03669724770642202
5840,123,17,106,75,48,0.13821138211382114,0.8617886178861789,0.6097560975609756,0.3902439024390244,118,0,1,117,114,4,0.0,0.00847457627118644,0.9915254237288136,0.9661016949152542,0.03389830508474576
5841,213,15,198,170,43,0.07042253521126761,0.9295774647887324,0.7981220657276995,0.20187793427230047,153,0,25,128,150,3,0.0,0.16339869281045752,0.8366013071895425,0.9803921568627451,0.0196078431372549
5842,111,20,91,54,57,0.18018018018018017,0.8198198198198198,0.4864864864864865,0.5135135135135135,184,0,54,130,181,3,0.0,0.29347826086956524,0.7065217391304348,0.9836956521739131,0.016304347826086956
5843,70,16,54,28,42,0.22857142857142856,0.7714285714285715,0.4,0.6,105,0,30,75,105,0,0.0,0.2857142857142857,0.7142857142857143,1.0,0.0
5844,79,16,63,34,45,0.20253164556962025,0.7974683544303798,0.43037974683544306,0.569620253164557,97,0,28,69,97,0,0.0,0.28865979381443296,0.711340206185567,1.0,0.0
5845,80,15,65,40,40,0.1875,0.8125,0.5,0.5,93,0,29,64,93,0,0.0,0.3118279569892473,0.6881720430107527,1.0,0.0
5846,159,16,143,112,47,0.10062893081761007,0.89937106918239,0.7044025157232704,0.29559748427672955,143,0,24,119,142,1,0.0,0.16783216783216784,0.8321678321678322,0.993006993006993,0.006993006993006993
5847,125,16,109,81,44,0.128,0.872,0.648,0.352,108,0,1,107,104,4,0.0,0.009259259259259259,0.9907407407407407,0.9629629629629629,0.037037037037037035
5848,148,126,22,145,3,0.8513513513513513,0.14864864864864866,0.9797297297297297,0.02027027027027027,348,0,36,312,94,254,0.0,0.10344827586206896,0.896551724137931,0.27011494252873564,0.7298850574712644
5849,118,16,102,74,44,0.13559322033898305,0.864406779661017,0.6271186440677966,0.3728813559322034,123,0,0,123,120,3,0.0,0.0,1.0,0.975609756097561,0.024390243902439025
5850,117,8,109,76,41,0.06837606837606838,0.9316239316239316,0.6495726495726496,0.3504273504273504,105,0,1,104,101,4,0.0,0.009523809523809525,0.9904761904761905,0.9619047619047619,0.0380952380952381
5851,131,20,111,79,52,0.15267175572519084,0.8473282442748091,0.6030534351145038,0.3969465648854962,112,0,2,110,108,4,0.0,0.017857142857142856,0.9821428571428571,0.9642857142857143,0.03571428571428571
5852,122,12,110,77,45,0.09836065573770492,0.9016393442622951,0.6311475409836066,0.36885245901639346,114,0,1,113,111,3,0.0,0.008771929824561403,0.9912280701754386,0.9736842105263158,0.02631578947368421
5853,191,13,178,152,39,0.06806282722513089,0.9319371727748691,0.7958115183246073,0.20418848167539266,149,0,25,124,146,3,0.0,0.16778523489932887,0.8322147651006712,0.9798657718120806,0.020134228187919462
5854,150,17,133,99,51,0.11333333333333333,0.8866666666666667,0.66,0.34,131,0,24,107,130,1,0.0,0.183206106870229,0.816793893129771,0.9923664122137404,0.007633587786259542
5855,196,17,179,150,46,0.08673469387755102,0.9132653061224489,0.7653061224489796,0.23469387755102042,141,0,25,116,139,2,0.0,0.1773049645390071,0.8226950354609929,0.9858156028368794,0.014184397163120567
5856,196,17,179,153,43,0.08673469387755102,0.9132653061224489,0.7806122448979592,0.2193877551020408,147,0,27,120,144,3,0.0,0.1836734693877551,0.8163265306122449,0.9795918367346939,0.02040816326530612
5857,76,14,62,34,42,0.18421052631578946,0.8157894736842105,0.4473684210526316,0.5526315789473685,100,0,30,70,100,0,0.0,0.3,0.7,1.0,0.0
5858,113,5,108,87,26,0.04424778761061947,0.9557522123893806,0.7699115044247787,0.23008849557522124,75,0,8,67,73,2,0.0,0.10666666666666667,0.8933333333333333,0.9733333333333334,0.02666666666666667
5859,37,4,33,31,6,0.10810810810810811,0.8918918918918919,0.8378378378378378,0.16216216216216217,89,0,19,70,86,3,0.0,0.21348314606741572,0.7865168539325843,0.9662921348314607,0.033707865168539325
5860,91,15,76,57,34,0.16483516483516483,0.8351648351648352,0.6263736263736264,0.37362637362637363,111,0,0,111,108,3,0.0,0.0,1.0,0.972972972972973,0.02702702702702703
5861,68,5,63,48,20,0.07352941176470588,0.9264705882352942,0.7058823529411765,0.29411764705882354,80,0,1,79,76,4,0.0,0.0125,0.9875,0.95,0.05
5862,125,16,109,81,44,0.128,0.872,0.648,0.352,112,0,1,111,109,3,0.0,0.008928571428571428,0.9910714285714286,0.9732142857142857,0.026785714285714284
5863,122,12,110,77,45,0.09836065573770492,0.9016393442622951,0.6311475409836066,0.36885245901639346,105,0,1,104,101,4,0.0,0.009523809523809525,0.9904761904761905,0.9619047619047619,0.0380952380952381
5864,104,6,98,79,25,0.057692307692307696,0.9423076923076923,0.7596153846153846,0.2403846153846154,85,0,11,74,83,2,0.0,0.12941176470588237,0.8705882352941177,0.9764705882352941,0.023529411764705882
5865,88,12,76,52,36,0.13636363636363635,0.8636363636363636,0.5909090909090909,0.4090909090909091,118,0,0,118,116,2,0.0,0.0,1.0,0.9830508474576272,0.01694915254237288
5866,120,10,110,79,41,0.08333333333333333,0.9166666666666666,0.6583333333333333,0.3416666666666667,112,0,1,111,108,4,0.0,0.008928571428571428,0.9910714285714286,0.9642857142857143,0.03571428571428571
5867,124,13,111,80,44,0.10483870967741936,0.8951612903225806,0.6451612903225806,0.3548387096774194,113,0,2,111,109,4,0.0,0.017699115044247787,0.9823008849557522,0.9646017699115044,0.035398230088495575
5868,107,5,102,87,20,0.04672897196261682,0.9532710280373832,0.8130841121495327,0.18691588785046728,95,0,13,82,93,2,0.0,0.1368421052631579,0.8631578947368421,0.9789473684210527,0.021052631578947368
5869,93,10,83,63,30,0.10752688172043011,0.8924731182795699,0.6774193548387096,0.3225806451612903,86,0,1,85,82,4,0.0,0.011627906976744186,0.9883720930232558,0.9534883720930233,0.046511627906976744
5870,74,13,61,33,41,0.17567567567567569,0.8243243243243243,0.44594594594594594,0.5540540540540541,89,0,30,59,89,0,0.0,0.33707865168539325,0.6629213483146067,1.0,0.0
5871,111,13,98,71,40,0.11711711711711711,0.8828828828828829,0.6396396396396397,0.36036036036036034,128,0,0,128,124,4,0.0,0.0,1.0,0.96875,0.03125
5872,130,20,110,79,51,0.15384615384615385,0.8461538461538461,0.6076923076923076,0.3923076923076923,115,0,1,114,111,4,0.0,0.008695652173913044,0.991304347826087,0.9652173913043478,0.034782608695652174
5873,122,12,110,82,40,0.09836065573770492,0.9016393442622951,0.6721311475409836,0.32786885245901637,101,0,1,100,97,4,0.0,0.009900990099009901,0.9900990099009901,0.9603960396039604,0.039603960396039604
5874,117,8,109,84,33,0.06837606837606838,0.9316239316239316,0.717948717948718,0.28205128205128205,112,0,1,111,109,3,0.0,0.008928571428571428,0.9910714285714286,0.9732142857142857,0.026785714285714284
5875,122,12,110,82,40,0.09836065573770492,0.9016393442622951,0.6721311475409836,0.32786885245901637,121,0,1,120,117,4,0.0,0.008264462809917356,0.9917355371900827,0.9669421487603306,0.03305785123966942
5876,88,13,75,56,32,0.14772727272727273,0.8522727272727273,0.6363636363636364,0.36363636363636365,117,0,1,116,114,3,0.0,0.008547008547008548,0.9914529914529915,0.9743589743589743,0.02564102564102564
5877,109,13,96,71,38,0.11926605504587157,0.8807339449541285,0.6513761467889908,0.3486238532110092,112,0,0,112,109,3,0.0,0.0,1.0,0.9732142857142857,0.026785714285714284
5878,78,8,70,51,27,0.10256410256410256,0.8974358974358975,0.6538461538461539,0.34615384615384615,76,0,1,75,72,4,0.0,0.013157894736842105,0.9868421052631579,0.9473684210526315,0.05263157894736842
5879,122,16,106,76,46,0.13114754098360656,0.8688524590163934,0.6229508196721312,0.3770491803278688,99,0,1,98,96,3,0.0,0.010101010101010102,0.98989898989899,0.9696969696969697,0.030303030303030304
5880,123,11,112,85,38,0.08943089430894309,0.9105691056910569,0.6910569105691057,0.3089430894308943,106,0,17,89,104,2,0.0,0.16037735849056603,0.839622641509434,0.9811320754716981,0.018867924528301886
5881,57,10,47,26,31,0.17543859649122806,0.8245614035087719,0.45614035087719296,0.543859649122807,130,0,0,130,128,2,0.0,0.0,1.0,0.9846153846153847,0.015384615384615385
5882,130,8,122,97,33,0.06153846153846154,0.9384615384615385,0.7461538461538462,0.25384615384615383,98,0,12,86,96,2,0.0,0.12244897959183673,0.8775510204081632,0.9795918367346939,0.02040816326530612
5883,126,15,111,81,45,0.11904761904761904,0.8809523809523809,0.6428571428571429,0.35714285714285715,117,0,2,115,113,4,0.0,0.017094017094017096,0.9829059829059829,0.9658119658119658,0.03418803418803419
5884,195,14,181,155,40,0.07179487179487179,0.9282051282051282,0.7948717948717948,0.20512820512820512,141,0,26,115,138,3,0.0,0.18439716312056736,0.8156028368794326,0.9787234042553191,0.02127659574468085
5885,59,11,48,26,33,0.1864406779661017,0.8135593220338984,0.4406779661016949,0.559322033898305,144,0,0,144,141,3,0.0,0.0,1.0,0.9791666666666666,0.020833333333333332
5886,59,15,44,26,33,0.2542372881355932,0.7457627118644068,0.4406779661016949,0.559322033898305,94,0,32,62,94,0,0.0,0.3404255319148936,0.6595744680851063,1.0,0.0
5887,194,13,181,156,38,0.06701030927835051,0.9329896907216495,0.8041237113402062,0.1958762886597938,140,0,27,113,138,2,0.0,0.19285714285714287,0.8071428571428572,0.9857142857142858,0.014285714285714285
5888,192,10,182,152,40,0.052083333333333336,0.9479166666666666,0.7916666666666666,0.20833333333333334,138,0,24,114,135,3,0.0,0.17391304347826086,0.8260869565217391,0.9782608695652174,0.021739130434782608
5889,124,14,110,85,39,0.11290322580645161,0.8870967741935484,0.6854838709677419,0.31451612903225806,121,0,1,120,117,4,0.0,0.008264462809917356,0.9917355371900827,0.9669421487603306,0.03305785123966942
5890,87,11,76,52,35,0.12643678160919541,0.8735632183908046,0.5977011494252874,0.40229885057471265,104,0,0,104,101,3,0.0,0.0,1.0,0.9711538461538461,0.028846153846153848
5891,108,17,91,52,56,0.1574074074074074,0.8425925925925926,0.48148148148148145,0.5185185185185185,171,0,54,117,169,2,0.0,0.3157894736842105,0.6842105263157895,0.9883040935672515,0.011695906432748537
5892,119,8,111,96,23,0.06722689075630252,0.9327731092436975,0.8067226890756303,0.19327731092436976,83,0,7,76,81,2,0.0,0.08433734939759036,0.9156626506024096,0.9759036144578314,0.024096385542168676
5893,196,18,178,150,46,0.09183673469387756,0.9081632653061225,0.7653061224489796,0.23469387755102042,144,0,30,114,141,3,0.0,0.20833333333333334,0.7916666666666666,0.9791666666666666,0.020833333333333332
5894,123,13,110,85,38,0.10569105691056911,0.8943089430894309,0.6910569105691057,0.3089430894308943,123,0,1,122,119,4,0.0,0.008130081300813009,0.991869918699187,0.967479674796748,0.032520325203252036
5895,117,7,110,97,20,0.05982905982905983,0.9401709401709402,0.8290598290598291,0.17094017094017094,78,0,6,72,75,3,0.0,0.07692307692307693,0.9230769230769231,0.9615384615384616,0.038461538461538464
5896,95,19,76,58,37,0.2,0.8,0.6105263157894737,0.3894736842105263,106,0,0,106,103,3,0.0,0.0,1.0,0.9716981132075472,0.02830188679245283
5897,62,15,47,23,39,0.24193548387096775,0.7580645161290323,0.3709677419354839,0.6290322580645161,133,0,0,133,130,3,0.0,0.0,1.0,0.9774436090225563,0.022556390977443608
5898,194,14,180,152,42,0.07216494845360824,0.9278350515463918,0.7835051546391752,0.21649484536082475,138,0,26,112,136,2,0.0,0.18840579710144928,0.8115942028985508,0.9855072463768116,0.014492753623188406
5899,44,10,34,17,27,0.22727272727272727,0.7727272727272727,0.38636363636363635,0.6136363636363636,83,0,32,51,83,0,0.0,0.3855421686746988,0.6144578313253012,1.0,0.0
5900,119,9,110,76,43,0.07563025210084033,0.9243697478991597,0.6386554621848739,0.36134453781512604,105,0,1,104,102,3,0.0,0.009523809523809525,0.9904761904761905,0.9714285714285714,0.02857142857142857
5901,60,13,47,25,35,0.21666666666666667,0.7833333333333333,0.4166666666666667,0.5833333333333334,140,0,0,140,137,3,0.0,0.0,1.0,0.9785714285714285,0.02142857142857143
5902,76,12,64,37,39,0.15789473684210525,0.8421052631578947,0.4868421052631579,0.5131578947368421,99,0,30,69,99,0,0.0,0.30303030303030304,0.696969696969697,1.0,0.0
5903,201,21,180,157,44,0.1044776119402985,0.8955223880597015,0.7810945273631841,0.21890547263681592,142,0,28,114,139,3,0.0,0.19718309859154928,0.8028169014084507,0.9788732394366197,0.02112676056338028
5904,186,9,177,151,35,0.04838709677419355,0.9516129032258065,0.8118279569892473,0.1881720430107527,133,0,27,106,130,3,0.0,0.20300751879699247,0.7969924812030075,0.9774436090225563,0.022556390977443608
5905,59,11,48,27,32,0.1864406779661017,0.8135593220338984,0.4576271186440678,0.5423728813559322,139,0,0,139,136,3,0.0,0.0,1.0,0.9784172661870504,0.02158273381294964
5906,110,8,102,82,28,0.07272727272727272,0.9272727272727272,0.7454545454545455,0.2545454545454545,88,0,17,71,86,2,0.0,0.19318181818181818,0.8068181818181818,0.9772727272727273,0.022727272727272728
5907,90,9,81,53,37,0.1,0.9,0.5888888888888889,0.4111111111111111,80,0,0,80,76,4,0.0,0.0,1.0,0.95,0.05
5908,59,15,44,21,38,0.2542372881355932,0.7457627118644068,0.3559322033898305,0.6440677966101694,88,0,30,58,88,0,0.0,0.3409090909090909,0.6590909090909091,1.0,0.0
5909,42,7,35,32,10,0.16666666666666666,0.8333333333333334,0.7619047619047619,0.23809523809523808,82,0,12,70,79,3,0.0,0.14634146341463414,0.8536585365853658,0.9634146341463414,0.036585365853658534
5910,82,6,76,58,24,0.07317073170731707,0.926829268292683,0.7073170731707317,0.2926829268292683,110,0,0,110,106,4,0.0,0.0,1.0,0.9636363636363636,0.03636363636363636
5911,131,8,123,103,28,0.061068702290076333,0.9389312977099237,0.7862595419847328,0.21374045801526717,91,0,9,82,89,2,0.0,0.0989010989010989,0.9010989010989011,0.978021978021978,0.02197802197802198
5912,144,11,133,106,38,0.0763888888888889,0.9236111111111112,0.7361111111111112,0.2638888888888889,129,0,24,105,128,1,0.0,0.18604651162790697,0.813953488372093,0.9922480620155039,0.007751937984496124
5913,88,13,75,57,31,0.14772727272727273,0.8522727272727273,0.6477272727272727,0.3522727272727273,106,0,0,106,102,4,0.0,0.0,1.0,0.9622641509433962,0.03773584905660377
5914,59,11,48,29,30,0.1864406779661017,0.8135593220338984,0.4915254237288136,0.5084745762711864,137,0,0,137,134,3,0.0,0.0,1.0,0.9781021897810219,0.021897810218978103
5915,72,18,54,26,46,0.25,0.75,0.3611111111111111,0.6388888888888888,110,0,30,80,110,0,0.0,0.2727272727272727,0.7272727272727273,1.0,0.0
5916,125,15,110,85,40,0.12,0.88,0.68,0.32,99,0,0,99,95,4,0.0,0.0,1.0,0.9595959595959596,0.04040404040404041
5917,98,24,74,52,46,0.24489795918367346,0.7551020408163265,0.5306122448979592,0.46938775510204084,108,0,0,108,104,4,0.0,0.0,1.0,0.9629629629629629,0.037037037037037035
5918,164,16,148,117,47,0.0975609756097561,0.9024390243902439,0.7134146341463414,0.2865853658536585,147,1,24,122,146,1,0.006802721088435374,0.16326530612244897,0.8299319727891157,0.9931972789115646,0.006802721088435374
5919,89,13,76,53,36,0.14606741573033707,0.8539325842696629,0.5955056179775281,0.4044943820224719,102,0,0,102,100,2,0.0,0.0,1.0,0.9803921568627451,0.0196078431372549
5920,88,21,67,41,47,0.23863636363636365,0.7613636363636364,0.4659090909090909,0.5340909090909091,94,0,28,66,94,0,0.0,0.2978723404255319,0.7021276595744681,1.0,0.0
5921,123,8,115,98,25,0.06504065040650407,0.9349593495934959,0.7967479674796748,0.2032520325203252,97,0,17,80,95,2,0.0,0.17525773195876287,0.8247422680412371,0.979381443298969,0.020618556701030927
5922,122,10,112,93,29,0.08196721311475409,0.9180327868852459,0.7622950819672131,0.23770491803278687,82,0,8,74,80,2,0.0,0.0975609756097561,0.9024390243902439,0.975609756097561,0.024390243902439025
5923,84,6,78,65,19,0.07142857142857142,0.9285714285714286,0.7738095238095238,0.2261904761904762,84,0,1,83,80,4,0.0,0.011904761904761904,0.9880952380952381,0.9523809523809523,0.047619047619047616
5924,60,13,47,24,36,0.21666666666666667,0.7833333333333333,0.4,0.6,133,0,0,133,130,3,0.0,0.0,1.0,0.9774436090225563,0.022556390977443608
5925,199,17,182,159,40,0.08542713567839195,0.914572864321608,0.7989949748743719,0.20100502512562815,139,0,25,114,136,3,0.0,0.17985611510791366,0.8201438848920863,0.9784172661870504,0.02158273381294964
5926,121,10,111,86,35,0.08264462809917356,0.9173553719008265,0.7107438016528925,0.2892561983471074,111,0,2,109,107,4,0.0,0.018018018018018018,0.9819819819819819,0.963963963963964,0.036036036036036036
5927,95,19,76,58,37,0.2,0.8,0.6105263157894737,0.3894736842105263,108,0,0,108,104,4,0.0,0.0,1.0,0.9629629629629629,0.037037037037037035
5928,127,17,110,79,48,0.13385826771653545,0.8661417322834646,0.6220472440944882,0.3779527559055118,129,0,1,128,125,4,0.0,0.007751937984496124,0.9922480620155039,0.9689922480620154,0.031007751937984496
5929,125,14,111,74,51,0.112,0.888,0.592,0.408,110,0,2,108,106,4,0.0,0.01818181818181818,0.9818181818181818,0.9636363636363636,0.03636363636363636
5930,119,5,114,100,19,0.04201680672268908,0.957983193277311,0.8403361344537815,0.15966386554621848,88,0,6,82,86,2,0.0,0.06818181818181818,0.9318181818181818,0.9772727272727273,0.022727272727272728
5931,193,14,179,156,37,0.07253886010362694,0.927461139896373,0.8082901554404145,0.19170984455958548,142,0,26,116,139,3,0.0,0.18309859154929578,0.8169014084507042,0.9788732394366197,0.02112676056338028
5932,91,15,76,53,38,0.16483516483516483,0.8351648351648352,0.5824175824175825,0.4175824175824176,105,0,0,105,101,4,0.0,0.0,1.0,0.9619047619047619,0.0380952380952381
5933,105,14,91,60,45,0.13333333333333333,0.8666666666666667,0.5714285714285714,0.42857142857142855,170,0,54,116,167,3,0.0,0.3176470588235294,0.6823529411764706,0.9823529411764705,0.01764705882352941
5934,104,8,96,67,37,0.07692307692307693,0.9230769230769231,0.6442307692307693,0.3557692307692308,129,0,0,129,126,3,0.0,0.0,1.0,0.9767441860465116,0.023255813953488372
5935,189,11,178,155,34,0.0582010582010582,0.9417989417989417,0.8201058201058201,0.17989417989417988,138,0,25,113,136,2,0.0,0.18115942028985507,0.8188405797101449,0.9855072463768116,0.014492753623188406
5936,129,19,110,82,47,0.14728682170542637,0.8527131782945736,0.6356589147286822,0.3643410852713178,112,0,1,111,108,4,0.0,0.008928571428571428,0.9910714285714286,0.9642857142857143,0.03571428571428571
5937,110,19,91,63,47,0.17272727272727273,0.8272727272727273,0.5727272727272728,0.42727272727272725,171,0,54,117,169,2,0.0,0.3157894736842105,0.6842105263157895,0.9883040935672515,0.011695906432748537
5938,117,7,110,85,32,0.05982905982905983,0.9401709401709402,0.7264957264957265,0.27350427350427353,123,0,1,122,119,4,0.0,0.008130081300813009,0.991869918699187,0.967479674796748,0.032520325203252036
5939,128,18,110,83,45,0.140625,0.859375,0.6484375,0.3515625,111,0,1,110,107,4,0.0,0.009009009009009009,0.990990990990991,0.963963963963964,0.036036036036036036
5940,153,123,30,150,3,0.803921568627451,0.19607843137254902,0.9803921568627451,0.0196078431372549,350,0,30,320,97,253,0.0,0.08571428571428572,0.9142857142857143,0.27714285714285714,0.7228571428571429
5941,106,6,100,86,20,0.05660377358490566,0.9433962264150944,0.8113207547169812,0.18867924528301888,84,0,13,71,82,2,0.0,0.15476190476190477,0.8452380952380952,0.9761904761904762,0.023809523809523808
5942,119,9,110,81,38,0.07563025210084033,0.9243697478991597,0.680672268907563,0.31932773109243695,109,0,1,108,105,4,0.0,0.009174311926605505,0.9908256880733946,0.963302752293578,0.03669724770642202
5943,128,12,116,91,37,0.09375,0.90625,0.7109375,0.2890625,104,0,14,90,102,2,0.0,0.1346153846153846,0.8653846153846154,0.9807692307692307,0.019230769230769232
5944,65,11,54,30,35,0.16923076923076924,0.8307692307692308,0.46153846153846156,0.5384615384615384,104,0,30,74,104,0,0.0,0.28846153846153844,0.7115384615384616,1.0,0.0
5945,119,28,91,55,64,0.23529411764705882,0.7647058823529411,0.46218487394957986,0.5378151260504201,190,0,54,136,187,3,0.0,0.28421052631578947,0.7157894736842105,0.9842105263157894,0.015789473684210527
5946,164,16,148,114,50,0.0975609756097561,0.9024390243902439,0.6951219512195121,0.3048780487804878,148,0,24,124,147,1,0.0,0.16216216216216217,0.8378378378378378,0.9932432432432432,0.006756756756756757
5947,112,16,96,61,51,0.14285714285714285,0.8571428571428571,0.5446428571428571,0.45535714285714285,117,0,0,117,113,4,0.0,0.0,1.0,0.9658119658119658,0.03418803418803419
5948,147,14,133,109,38,0.09523809523809523,0.9047619047619048,0.7414965986394558,0.2585034013605442,126,0,24,102,125,1,0.0,0.19047619047619047,0.8095238095238095,0.9920634920634921,0.007936507936507936
5949,123,13,110,81,42,0.10569105691056911,0.8943089430894309,0.6585365853658537,0.34146341463414637,119,0,1,118,116,3,0.0,0.008403361344537815,0.9915966386554622,0.9747899159663865,0.025210084033613446
5950,129,10,119,103,26,0.07751937984496124,0.9224806201550387,0.7984496124031008,0.20155038759689922,94,0,10,84,92,2,0.0,0.10638297872340426,0.8936170212765957,0.9787234042553191,0.02127659574468085
5951,62,18,44,22,40,0.2903225806451613,0.7096774193548387,0.3548387096774194,0.6451612903225806,97,0,30,67,97,0,0.0,0.30927835051546393,0.6907216494845361,1.0,0.0
5952,109,18,91,58,51,0.1651376146788991,0.8348623853211009,0.5321100917431193,0.46788990825688076,180,0,54,126,178,2,0.0,0.3,0.7,0.9888888888888889,0.011111111111111112
5953,121,10,111,82,39,0.08264462809917356,0.9173553719008265,0.6776859504132231,0.32231404958677684,115,0,2,113,111,4,0.0,0.017391304347826087,0.9826086956521739,0.9652173913043478,0.034782608695652174
5954,142,9,133,106,36,0.06338028169014084,0.9366197183098591,0.7464788732394366,0.2535211267605634,131,0,24,107,130,1,0.0,0.183206106870229,0.816793893129771,0.9923664122137404,0.007633587786259542
5955,121,17,104,79,42,0.14049586776859505,0.859504132231405,0.6528925619834711,0.34710743801652894,125,0,0,125,122,3,0.0,0.0,1.0,0.976,0.024
5956,114,16,98,73,41,0.14035087719298245,0.8596491228070176,0.6403508771929824,0.35964912280701755,118,0,0,118,115,3,0.0,0.0,1.0,0.9745762711864406,0.025423728813559324
5957,121,12,109,69,52,0.09917355371900827,0.9008264462809917,0.5702479338842975,0.4297520661157025,94,0,1,93,91,3,0.0,0.010638297872340425,0.9893617021276596,0.9680851063829787,0.031914893617021274
5958,122,12,110,82,40,0.09836065573770492,0.9016393442622951,0.6721311475409836,0.32786885245901637,111,0,0,111,107,4,0.0,0.0,1.0,0.963963963963964,0.036036036036036036
5959,72,7,65,52,20,0.09722222222222222,0.9027777777777778,0.7222222222222222,0.2777777777777778,76,0,0,76,72,4,0.0,0.0,1.0,0.9473684210526315,0.05263157894736842
5960,108,5,103,85,23,0.046296296296296294,0.9537037037037037,0.7870370370370371,0.21296296296296297,86,0,14,72,84,2,0.0,0.16279069767441862,0.8372093023255814,0.9767441860465116,0.023255813953488372
5961,92,16,76,55,37,0.17391304347826086,0.8260869565217391,0.5978260869565217,0.40217391304347827,112,0,0,112,109,3,0.0,0.0,1.0,0.9732142857142857,0.026785714285714284
5962,111,14,97,71,40,0.12612612612612611,0.8738738738738738,0.6396396396396397,0.36036036036036034,112,0,0,112,109,3,0.0,0.0,1.0,0.9732142857142857,0.026785714285714284
5963,85,8,77,55,30,0.09411764705882353,0.9058823529411765,0.6470588235294118,0.35294117647058826,107,0,1,106,104,3,0.0,0.009345794392523364,0.9906542056074766,0.9719626168224299,0.028037383177570093
5964,126,15,111,77,49,0.11904761904761904,0.8809523809523809,0.6111111111111112,0.3888888888888889,111,0,2,109,107,4,0.0,0.018018018018018018,0.9819819819819819,0.963963963963964,0.036036036036036036
5965,43,9,34,16,27,0.20930232558139536,0.7906976744186046,0.37209302325581395,0.627906976744186,81,0,32,49,81,0,0.0,0.3950617283950617,0.6049382716049383,1.0,0.0
5966,170,147,23,167,3,0.8647058823529412,0.13529411764705881,0.9823529411764705,0.01764705882352941,315,0,34,281,91,224,0.0,0.10793650793650794,0.8920634920634921,0.28888888888888886,0.7111111111111111
5967,85,23,62,37,48,0.27058823529411763,0.7294117647058823,0.43529411764705883,0.5647058823529412,96,0,29,67,96,0,0.0,0.3020833333333333,0.6979166666666666,1.0,0.0
5968,217,19,198,168,49,0.08755760368663594,0.9124423963133641,0.7741935483870968,0.22580645161290322,142,0,27,115,139,3,0.0,0.19014084507042253,0.8098591549295775,0.9788732394366197,0.02112676056338028
5969,85,19,66,39,46,0.2235294117647059,0.7764705882352941,0.4588235294117647,0.5411764705882353,100,0,32,68,100,0,0.0,0.32,0.68,1.0,0.0
5970,115,8,107,87,28,0.06956521739130435,0.9304347826086956,0.7565217391304347,0.24347826086956523,87,0,14,73,85,2,0.0,0.16091954022988506,0.8390804597701149,0.9770114942528736,0.022988505747126436
5971,74,20,54,31,43,0.2702702702702703,0.7297297297297297,0.4189189189189189,0.581081081081081,98,0,30,68,98,0,0.0,0.30612244897959184,0.6938775510204082,1.0,0.0
5972,68,14,54,31,37,0.20588235294117646,0.7941176470588235,0.45588235294117646,0.5441176470588235,102,0,30,72,102,0,0.0,0.29411764705882354,0.7058823529411765,1.0,0.0
5973,200,20,180,153,47,0.1,0.9,0.765,0.235,146,0,27,119,143,3,0.0,0.18493150684931506,0.815068493150685,0.9794520547945206,0.02054794520547945
5974,122,11,111,83,39,0.09016393442622951,0.9098360655737705,0.680327868852459,0.319672131147541,111,0,2,109,107,4,0.0,0.018018018018018018,0.9819819819819819,0.963963963963964,0.036036036036036036
5975,116,5,111,99,17,0.04310344827586207,0.9568965517241379,0.853448275862069,0.14655172413793102,76,0,6,70,74,2,0.0,0.07894736842105263,0.9210526315789473,0.9736842105263158,0.02631578947368421
5976,210,14,196,167,43,0.06666666666666667,0.9333333333333333,0.7952380952380952,0.20476190476190476,141,0,25,116,138,3,0.0,0.1773049645390071,0.8226950354609929,0.9787234042553191,0.02127659574468085
5977,205,8,197,171,34,0.03902439024390244,0.9609756097560975,0.8341463414634146,0.16585365853658537,133,0,26,107,131,2,0.0,0.19548872180451127,0.8045112781954887,0.9849624060150376,0.015037593984962405
5978,90,14,76,57,33,0.15555555555555556,0.8444444444444444,0.6333333333333333,0.36666666666666664,98,0,0,98,94,4,0.0,0.0,1.0,0.9591836734693877,0.04081632653061224
5979,77,11,66,40,37,0.14285714285714285,0.8571428571428571,0.5194805194805194,0.4805194805194805,105,0,30,75,105,0,0.0,0.2857142857142857,0.7142857142857143,1.0,0.0
5980,214,15,199,170,44,0.07009345794392523,0.9299065420560748,0.794392523364486,0.205607476635514,145,0,24,121,142,3,0.0,0.16551724137931034,0.8344827586206897,0.9793103448275862,0.020689655172413793
5981,125,15,110,78,47,0.12,0.88,0.624,0.376,104,0,1,103,100,4,0.0,0.009615384615384616,0.9903846153846154,0.9615384615384616,0.038461538461538464
5982,169,21,148,117,52,0.1242603550295858,0.8757396449704142,0.6923076923076923,0.3076923076923077,149,0,24,125,148,1,0.0,0.1610738255033557,0.8389261744966443,0.9932885906040269,0.006711409395973154
5983,165,17,148,116,49,0.10303030303030303,0.896969696969697,0.703030303030303,0.296969696969697,156,0,24,132,155,1,0.0,0.15384615384615385,0.8461538461538461,0.9935897435897436,0.00641025641025641
5984,112,7,105,85,27,0.0625,0.9375,0.7589285714285714,0.24107142857142858,90,0,14,76,88,2,0.0,0.15555555555555556,0.8444444444444444,0.9777777777777777,0.022222222222222223
5985,151,18,133,107,44,0.11920529801324503,0.8807947019867549,0.7086092715231788,0.2913907284768212,135,0,24,111,134,1,0.0,0.17777777777777778,0.8222222222222222,0.9925925925925926,0.007407407407407408
5986,88,12,76,54,34,0.13636363636363635,0.8636363636363636,0.6136363636363636,0.38636363636363635,118,0,0,118,114,4,0.0,0.0,1.0,0.9661016949152542,0.03389830508474576
5987,61,14,47,23,38,0.22950819672131148,0.7704918032786885,0.3770491803278688,0.6229508196721312,137,0,0,137,135,2,0.0,0.0,1.0,0.9854014598540146,0.014598540145985401
5988,88,12,76,51,37,0.13636363636363635,0.8636363636363636,0.5795454545454546,0.42045454545454547,107,0,0,107,105,2,0.0,0.0,1.0,0.9813084112149533,0.018691588785046728
5989,108,4,104,91,17,0.037037037037037035,0.9629629629629629,0.8425925925925926,0.1574074074074074,85,0,13,72,83,2,0.0,0.15294117647058825,0.8470588235294118,0.9764705882352941,0.023529411764705882
5990,114,23,91,55,59,0.20175438596491227,0.7982456140350878,0.4824561403508772,0.5175438596491229,180,0,54,126,178,2,0.0,0.3,0.7,0.9888888888888889,0.011111111111111112
5991,107,4,103,88,19,0.037383177570093455,0.9626168224299065,0.822429906542056,0.17757009345794392,90,0,17,73,88,2,0.0,0.18888888888888888,0.8111111111111111,0.9777777777777777,0.022222222222222223
5992,115,17,98,69,46,0.14782608695652175,0.8521739130434782,0.6,0.4,126,0,0,126,123,3,0.0,0.0,1.0,0.9761904761904762,0.023809523809523808
5993,109,11,98,72,37,0.10091743119266056,0.8990825688073395,0.6605504587155964,0.3394495412844037,120,0,0,120,116,4,0.0,0.0,1.0,0.9666666666666667,0.03333333333333333
5994,62,14,48,25,37,0.22580645161290322,0.7741935483870968,0.4032258064516129,0.5967741935483871,138,0,0,138,135,3,0.0,0.0,1.0,0.9782608695652174,0.021739130434782608
5995,127,16,111,82,45,0.12598425196850394,0.8740157480314961,0.6456692913385826,0.3543307086614173,114,0,2,112,110,4,0.0,0.017543859649122806,0.9824561403508771,0.9649122807017544,0.03508771929824561
5996,117,7,110,89,28,0.05982905982905983,0.9401709401709402,0.7606837606837606,0.23931623931623933,84,0,9,75,82,2,0.0,0.10714285714285714,0.8928571428571429,0.9761904761904762,0.023809523809523808
5997,37,4,33,29,8,0.10810810810810811,0.8918918918918919,0.7837837837837838,0.21621621621621623,89,0,17,72,86,3,0.0,0.19101123595505617,0.8089887640449438,0.9662921348314607,0.033707865168539325
5998,84,8,76,54,30,0.09523809523809523,0.9047619047619048,0.6428571428571429,0.35714285714285715,109,0,0,109,105,4,0.0,0.0,1.0,0.963302752293578,0.03669724770642202
5999,112,7,105,92,20,0.0625,0.9375,0.8214285714285714,0.17857142857142858,88,0,14,74,86,2,0.0,0.1590909090909091,0.8409090909090909,0.9772727272727273,0.022727272727272728
6000,211,16,195,162,49,0.07582938388625593,0.9241706161137441,0.7677725118483413,0.23222748815165878,145,0,25,120,142,3,0.0,0.1724137931034483,0.8275862068965517,0.9793103448275862,0.020689655172413793
6001,84,8,76,54,30,0.09523809523809523,0.9047619047619048,0.6428571428571429,0.35714285714285715,100,0,0,100,97,3,0.0,0.0,1.0,0.97,0.03
6002,88,12,76,56,32,0.13636363636363635,0.8636363636363636,0.6363636363636364,0.36363636363636365,113,0,0,113,109,4,0.0,0.0,1.0,0.9646017699115044,0.035398230088495575
6003,105,14,91,61,44,0.13333333333333333,0.8666666666666667,0.580952380952381,0.41904761904761906,182,0,54,128,179,3,0.0,0.2967032967032967,0.7032967032967034,0.9835164835164835,0.016483516483516484
6004,71,17,54,29,42,0.23943661971830985,0.7605633802816901,0.4084507042253521,0.5915492957746479,107,0,32,75,107,0,0.0,0.29906542056074764,0.7009345794392523,1.0,0.0
6005,39,5,34,29,10,0.1282051282051282,0.8717948717948718,0.7435897435897436,0.2564102564102564,92,0,18,74,89,3,0.0,0.1956521739130435,0.8043478260869565,0.967391304347826,0.03260869565217391
6006,72,9,63,39,33,0.125,0.875,0.5416666666666666,0.4583333333333333,102,0,30,72,102,0,0.0,0.29411764705882354,0.7058823529411765,1.0,0.0
6007,139,122,17,136,3,0.8776978417266187,0.1223021582733813,0.9784172661870504,0.02158273381294964,300,0,34,266,86,214,0.0,0.11333333333333333,0.8866666666666667,0.2866666666666667,0.7133333333333334
6008,125,15,110,78,47,0.12,0.88,0.624,0.376,109,0,1,108,105,4,0.0,0.009174311926605505,0.9908256880733946,0.963302752293578,0.03669724770642202
6009,66,19,47,28,38,0.2878787878787879,0.7121212121212122,0.42424242424242425,0.5757575757575758,142,0,0,142,139,3,0.0,0.0,1.0,0.9788732394366197,0.02112676056338028
6010,69,15,54,28,41,0.21739130434782608,0.782608695652174,0.4057971014492754,0.5942028985507246,94,0,30,64,94,0,0.0,0.3191489361702128,0.6808510638297872,1.0,0.0
6011,126,8,118,98,28,0.06349206349206349,0.9365079365079365,0.7777777777777778,0.2222222222222222,97,0,14,83,95,2,0.0,0.14432989690721648,0.8556701030927835,0.979381443298969,0.020618556701030927
6012,126,4,122,103,23,0.031746031746031744,0.9682539682539683,0.8174603174603174,0.18253968253968253,100,0,12,88,98,2,0.0,0.12,0.88,0.98,0.02
6013,191,13,178,151,40,0.06806282722513089,0.9319371727748691,0.7905759162303665,0.2094240837696335,151,0,25,126,148,3,0.0,0.16556291390728478,0.8344370860927153,0.9801324503311258,0.019867549668874173
6014,107,6,101,85,22,0.056074766355140186,0.9439252336448598,0.794392523364486,0.205607476635514,95,0,16,79,93,2,0.0,0.16842105263157894,0.8315789473684211,0.9789473684210527,0.021052631578947368
6015,163,20,143,112,51,0.12269938650306748,0.8773006134969326,0.6871165644171779,0.3128834355828221,138,0,24,114,137,1,0.0,0.17391304347826086,0.8260869565217391,0.9927536231884058,0.007246376811594203
6016,78,14,64,36,42,0.1794871794871795,0.8205128205128205,0.46153846153846156,0.5384615384615384,88,0,28,60,88,0,0.0,0.3181818181818182,0.6818181818181818,1.0,0.0
6017,107,9,98,70,37,0.08411214953271028,0.9158878504672897,0.6542056074766355,0.34579439252336447,122,0,0,122,119,3,0.0,0.0,1.0,0.9754098360655737,0.02459016393442623
6018,127,17,110,76,51,0.13385826771653545,0.8661417322834646,0.5984251968503937,0.4015748031496063,107,0,1,106,103,4,0.0,0.009345794392523364,0.9906542056074766,0.9626168224299065,0.037383177570093455
6019,168,20,148,118,50,0.11904761904761904,0.8809523809523809,0.7023809523809523,0.2976190476190476,146,0,24,122,145,1,0.0,0.1643835616438356,0.8356164383561644,0.9931506849315068,0.00684931506849315
6020,41,7,34,32,9,0.17073170731707318,0.8292682926829268,0.7804878048780488,0.21951219512195122,84,0,13,71,81,3,0.0,0.15476190476190477,0.8452380952380952,0.9642857142857143,0.03571428571428571
6021,129,19,110,76,53,0.14728682170542637,0.8527131782945736,0.5891472868217055,0.4108527131782946,109,0,1,108,105,4,0.0,0.009174311926605505,0.9908256880733946,0.963302752293578,0.03669724770642202
6022,122,11,111,79,43,0.09016393442622951,0.9098360655737705,0.6475409836065574,0.3524590163934426,100,0,2,98,96,4,0.0,0.02,0.98,0.96,0.04
6023,92,16,76,56,36,0.17391304347826086,0.8260869565217391,0.6086956521739131,0.391304347826087,113,0,0,113,111,2,0.0,0.0,1.0,0.9823008849557522,0.017699115044247787
6024,218,23,195,166,52,0.10550458715596331,0.8944954128440367,0.7614678899082569,0.23853211009174313,144,0,26,118,141,3,0.0,0.18055555555555555,0.8194444444444444,0.9791666666666666,0.020833333333333332
6025,37,4,33,32,5,0.10810810810810811,0.8918918918918919,0.8648648648648649,0.13513513513513514,85,0,16,69,82,3,0.0,0.18823529411764706,0.8117647058823529,0.9647058823529412,0.03529411764705882
6026,69,15,54,28,41,0.21739130434782608,0.782608695652174,0.4057971014492754,0.5942028985507246,99,0,30,69,99,0,0.0,0.30303030303030304,0.696969696969697,1.0,0.0
6027,152,19,133,101,51,0.125,0.875,0.6644736842105263,0.3355263157894737,139,0,24,115,138,1,0.0,0.17266187050359713,0.8273381294964028,0.9928057553956835,0.007194244604316547
6028,202,18,184,158,44,0.0891089108910891,0.9108910891089109,0.7821782178217822,0.21782178217821782,134,0,24,110,131,3,0.0,0.1791044776119403,0.8208955223880597,0.9776119402985075,0.022388059701492536
6029,166,18,148,122,44,0.10843373493975904,0.891566265060241,0.7349397590361446,0.26506024096385544,149,0,24,125,148,1,0.0,0.1610738255033557,0.8389261744966443,0.9932885906040269,0.006711409395973154
6030,40,4,36,33,7,0.1,0.9,0.825,0.175,92,0,18,74,89,3,0.0,0.1956521739130435,0.8043478260869565,0.967391304347826,0.03260869565217391
6031,122,12,110,76,46,0.09836065573770492,0.9016393442622951,0.6229508196721312,0.3770491803278688,117,0,1,116,113,4,0.0,0.008547008547008548,0.9914529914529915,0.9658119658119658,0.03418803418803419
6032,80,15,65,38,42,0.1875,0.8125,0.475,0.525,91,0,32,59,91,0,0.0,0.3516483516483517,0.6483516483516484,1.0,0.0
6033,112,8,104,81,31,0.07142857142857142,0.9285714285714286,0.7232142857142857,0.2767857142857143,91,0,17,74,89,2,0.0,0.18681318681318682,0.8131868131868132,0.978021978021978,0.02197802197802198
6034,205,22,183,155,50,0.1073170731707317,0.8926829268292683,0.7560975609756098,0.24390243902439024,146,0,29,117,144,2,0.0,0.19863013698630136,0.8013698630136986,0.9863013698630136,0.0136986301369863
6035,107,4,103,82,25,0.037383177570093455,0.9626168224299065,0.7663551401869159,0.2336448598130841,90,0,14,76,88,2,0.0,0.15555555555555556,0.8444444444444444,0.9777777777777777,0.022222222222222223
6036,119,15,104,71,48,0.12605042016806722,0.8739495798319328,0.5966386554621849,0.40336134453781514,124,0,0,124,120,4,0.0,0.0,1.0,0.967741935483871,0.03225806451612903
6037,90,8,82,59,31,0.08888888888888889,0.9111111111111111,0.6555555555555556,0.34444444444444444,80,0,1,79,76,4,0.0,0.0125,0.9875,0.95,0.05
6038,60,13,47,28,32,0.21666666666666667,0.7833333333333333,0.4666666666666667,0.5333333333333333,136,0,0,136,133,3,0.0,0.0,1.0,0.9779411764705882,0.022058823529411766
6039,117,7,110,84,33,0.05982905982905983,0.9401709401709402,0.717948717948718,0.28205128205128205,97,0,16,81,95,2,0.0,0.16494845360824742,0.8350515463917526,0.979381443298969,0.020618556701030927
6040,62,7,55,37,25,0.11290322580645161,0.8870967741935484,0.5967741935483871,0.4032258064516129,79,0,0,79,75,4,0.0,0.0,1.0,0.9493670886075949,0.05063291139240506
6041,116,14,102,75,41,0.1206896551724138,0.8793103448275862,0.646551724137931,0.35344827586206895,133,0,0,133,129,4,0.0,0.0,1.0,0.9699248120300752,0.03007518796992481
6042,79,17,62,32,47,0.21518987341772153,0.7848101265822784,0.4050632911392405,0.5949367088607594,99,0,30,69,99,0,0.0,0.30303030303030304,0.696969696969697,1.0,0.0
6043,127,17,110,78,49,0.13385826771653545,0.8661417322834646,0.6141732283464567,0.3858267716535433,102,0,1,101,98,4,0.0,0.00980392156862745,0.9901960784313726,0.9607843137254902,0.0392156862745098
6044,211,12,199,173,38,0.05687203791469194,0.943127962085308,0.8199052132701422,0.18009478672985782,143,0,24,119,140,3,0.0,0.16783216783216784,0.8321678321678322,0.9790209790209791,0.02097902097902098
6045,128,18,110,78,50,0.140625,0.859375,0.609375,0.390625,116,0,1,115,112,4,0.0,0.008620689655172414,0.9913793103448276,0.9655172413793104,0.034482758620689655
6046,123,12,111,84,39,0.0975609756097561,0.9024390243902439,0.6829268292682927,0.3170731707317073,103,0,2,101,100,3,0.0,0.019417475728155338,0.9805825242718447,0.970873786407767,0.02912621359223301
6047,80,19,61,32,48,0.2375,0.7625,0.4,0.6,91,0,28,63,91,0,0.0,0.3076923076923077,0.6923076923076923,1.0,0.0
6048,120,11,109,81,39,0.09166666666666666,0.9083333333333333,0.675,0.325,112,0,1,111,109,3,0.0,0.008928571428571428,0.9910714285714286,0.9732142857142857,0.026785714285714284
6049,126,7,119,100,26,0.05555555555555555,0.9444444444444444,0.7936507936507936,0.20634920634920634,97,0,15,82,95,2,0.0,0.15463917525773196,0.845360824742268,0.979381443298969,0.020618556701030927
6050,120,9,111,88,32,0.075,0.925,0.7333333333333333,0.26666666666666666,107,0,1,106,103,4,0.0,0.009345794392523364,0.9906542056074766,0.9626168224299065,0.037383177570093455
6051,115,8,107,90,25,0.06956521739130435,0.9304347826086956,0.782608695652174,0.21739130434782608,89,0,12,77,87,2,0.0,0.1348314606741573,0.8651685393258427,0.9775280898876404,0.02247191011235955
6052,67,19,48,31,36,0.2835820895522388,0.7164179104477612,0.4626865671641791,0.5373134328358209,132,0,0,132,129,3,0.0,0.0,1.0,0.9772727272727273,0.022727272727272728
6053,86,21,65,38,48,0.2441860465116279,0.7558139534883721,0.4418604651162791,0.5581395348837209,87,0,28,59,87,0,0.0,0.3218390804597701,0.6781609195402298,1.0,0.0
6054,110,19,91,62,48,0.17272727272727273,0.8272727272727273,0.5636363636363636,0.43636363636363634,190,0,54,136,186,4,0.0,0.28421052631578947,0.7157894736842105,0.9789473684210527,0.021052631578947368
6055,195,13,182,154,41,0.06666666666666667,0.9333333333333333,0.7897435897435897,0.21025641025641026,142,0,26,116,139,3,0.0,0.18309859154929578,0.8169014084507042,0.9788732394366197,0.02112676056338028
6056,57,9,48,26,31,0.15789473684210525,0.8421052631578947,0.45614035087719296,0.543859649122807,142,0,0,142,139,3,0.0,0.0,1.0,0.9788732394366197,0.02112676056338028
6057,74,20,54,29,45,0.2702702702702703,0.7297297297297297,0.3918918918918919,0.6081081081081081,103,0,30,73,103,0,0.0,0.2912621359223301,0.7087378640776699,1.0,0.0
6058,125,6,119,90,35,0.048,0.952,0.72,0.28,103,0,14,89,101,2,0.0,0.13592233009708737,0.8640776699029126,0.9805825242718447,0.019417475728155338
6059,71,17,54,24,47,0.23943661971830985,0.7605633802816901,0.3380281690140845,0.6619718309859155,104,0,31,73,104,0,0.0,0.2980769230769231,0.7019230769230769,1.0,0.0
6060,123,13,110,81,42,0.10569105691056911,0.8943089430894309,0.6585365853658537,0.34146341463414637,98,0,1,97,95,3,0.0,0.01020408163265306,0.9897959183673469,0.9693877551020408,0.030612244897959183
6061,113,7,106,89,24,0.061946902654867256,0.9380530973451328,0.7876106194690266,0.21238938053097345,87,0,9,78,85,2,0.0,0.10344827586206896,0.896551724137931,0.9770114942528736,0.022988505747126436
6062,167,19,148,115,52,0.11377245508982035,0.8862275449101796,0.688622754491018,0.31137724550898205,160,0,24,136,159,1,0.0,0.15,0.85,0.99375,0.00625
6063,125,15,110,78,47,0.12,0.88,0.624,0.376,117,0,1,116,113,4,0.0,0.008547008547008548,0.9914529914529915,0.9658119658119658,0.03418803418803419
6064,195,11,184,158,37,0.05641025641025641,0.9435897435897436,0.8102564102564103,0.18974358974358974,133,0,24,109,130,3,0.0,0.18045112781954886,0.8195488721804511,0.9774436090225563,0.022556390977443608
6065,80,15,65,41,39,0.1875,0.8125,0.5125,0.4875,96,0,32,64,96,0,0.0,0.3333333333333333,0.6666666666666666,1.0,0.0
6066,90,14,76,53,37,0.15555555555555556,0.8444444444444444,0.5888888888888889,0.4111111111111111,112,0,0,112,109,3,0.0,0.0,1.0,0.9732142857142857,0.026785714285714284
6067,58,11,47,26,32,0.1896551724137931,0.8103448275862069,0.4482758620689655,0.5517241379310345,126,0,0,126,124,2,0.0,0.0,1.0,0.9841269841269841,0.015873015873015872
6068,125,15,110,82,43,0.12,0.88,0.656,0.344,109,0,0,109,105,4,0.0,0.0,1.0,0.963302752293578,0.03669724770642202
6069,65,17,48,25,40,0.26153846153846155,0.7384615384615385,0.38461538461538464,0.6153846153846154,139,0,0,139,136,3,0.0,0.0,1.0,0.9784172661870504,0.02158273381294964
6070,92,16,76,57,35,0.17391304347826086,0.8260869565217391,0.6195652173913043,0.3804347826086957,109,0,0,109,106,3,0.0,0.0,1.0,0.9724770642201835,0.027522935779816515
6071,171,139,32,168,3,0.8128654970760234,0.1871345029239766,0.9824561403508771,0.017543859649122806,320,0,30,290,77,243,0.0,0.09375,0.90625,0.240625,0.759375
6072,127,17,110,80,47,0.13385826771653545,0.8661417322834646,0.6299212598425197,0.3700787401574803,102,0,1,101,98,4,0.0,0.00980392156862745,0.9901960784313726,0.9607843137254902,0.0392156862745098
6073,122,12,110,77,45,0.09836065573770492,0.9016393442622951,0.6311475409836066,0.36885245901639346,111,0,1,110,107,4,0.0,0.009009009009009009,0.990990990990991,0.963963963963964,0.036036036036036036
6074,80,17,63,40,40,0.2125,0.7875,0.5,0.5,102,0,28,74,102,0,0.0,0.27450980392156865,0.7254901960784313,1.0,0.0
6075,106,15,91,53,53,0.14150943396226415,0.8584905660377359,0.5,0.5,164,0,54,110,162,2,0.0,0.32926829268292684,0.6707317073170732,0.9878048780487805,0.012195121951219513
6076,109,6,103,87,22,0.05504587155963303,0.944954128440367,0.7981651376146789,0.2018348623853211,86,0,14,72,84,2,0.0,0.16279069767441862,0.8372093023255814,0.9767441860465116,0.023255813953488372
6077,108,17,91,60,48,0.1574074074074074,0.8425925925925926,0.5555555555555556,0.4444444444444444,179,0,54,125,176,3,0.0,0.3016759776536313,0.6983240223463687,0.9832402234636871,0.01675977653631285
6078,87,13,74,52,35,0.14942528735632185,0.8505747126436781,0.5977011494252874,0.40229885057471265,118,0,0,118,115,3,0.0,0.0,1.0,0.9745762711864406,0.025423728813559324
6079,108,17,91,63,45,0.1574074074074074,0.8425925925925926,0.5833333333333334,0.4166666666666667,170,0,54,116,167,3,0.0,0.3176470588235294,0.6823529411764706,0.9823529411764705,0.01764705882352941
6080,194,13,181,153,41,0.06701030927835051,0.9329896907216495,0.788659793814433,0.211340206185567,134,0,27,107,132,2,0.0,0.20149253731343283,0.7985074626865671,0.9850746268656716,0.014925373134328358
6081,111,6,105,81,30,0.05405405405405406,0.9459459459459459,0.7297297297297297,0.2702702702702703,88,0,15,73,86,2,0.0,0.17045454545454544,0.8295454545454546,0.9772727272727273,0.022727272727272728
6082,63,15,48,27,36,0.23809523809523808,0.7619047619047619,0.42857142857142855,0.5714285714285714,132,0,0,132,129,3,0.0,0.0,1.0,0.9772727272727273,0.022727272727272728
6083,61,14,47,29,32,0.22950819672131148,0.7704918032786885,0.47540983606557374,0.5245901639344263,144,0,0,144,142,2,0.0,0.0,1.0,0.9861111111111112,0.013888888888888888
6084,110,4,106,84,26,0.03636363636363636,0.9636363636363636,0.7636363636363637,0.23636363636363636,91,0,13,78,89,2,0.0,0.14285714285714285,0.8571428571428571,0.978021978021978,0.02197802197802198
6085,125,15,110,83,42,0.12,0.88,0.664,0.336,119,0,1,118,115,4,0.0,0.008403361344537815,0.9915966386554622,0.9663865546218487,0.03361344537815126
6086,82,16,66,37,45,0.1951219512195122,0.8048780487804879,0.45121951219512196,0.5487804878048781,104,0,30,74,104,0,0.0,0.28846153846153844,0.7115384615384616,1.0,0.0
6087,71,17,54,29,42,0.23943661971830985,0.7605633802816901,0.4084507042253521,0.5915492957746479,106,0,30,76,106,0,0.0,0.2830188679245283,0.7169811320754716,1.0,0.0
6088,109,5,104,94,15,0.045871559633027525,0.9541284403669725,0.8623853211009175,0.13761467889908258,85,0,10,75,83,2,0.0,0.11764705882352941,0.8823529411764706,0.9764705882352941,0.023529411764705882
6089,112,6,106,88,24,0.05357142857142857,0.9464285714285714,0.7857142857142857,0.21428571428571427,85,0,11,74,83,2,0.0,0.12941176470588237,0.8705882352941177,0.9764705882352941,0.023529411764705882
6090,192,13,179,152,40,0.06770833333333333,0.9322916666666666,0.7916666666666666,0.20833333333333334,138,0,26,112,135,3,0.0,0.18840579710144928,0.8115942028985508,0.9782608695652174,0.021739130434782608
6091,74,9,65,40,34,0.12162162162162163,0.8783783783783784,0.5405405405405406,0.4594594594594595,93,0,28,65,93,0,0.0,0.3010752688172043,0.6989247311827957,1.0,0.0
6092,113,22,91,53,60,0.19469026548672566,0.8053097345132744,0.4690265486725664,0.5309734513274337,183,0,54,129,180,3,0.0,0.29508196721311475,0.7049180327868853,0.9836065573770492,0.01639344262295082
6093,197,19,178,152,45,0.09644670050761421,0.9035532994923858,0.7715736040609137,0.22842639593908629,130,0,24,106,127,3,0.0,0.18461538461538463,0.8153846153846154,0.9769230769230769,0.023076923076923078
6094,126,6,120,94,32,0.047619047619047616,0.9523809523809523,0.746031746031746,0.25396825396825395,98,0,12,86,96,2,0.0,0.12244897959183673,0.8775510204081632,0.9795918367346939,0.02040816326530612
6095,56,9,47,30,26,0.16071428571428573,0.8392857142857143,0.5357142857142857,0.4642857142857143,135,0,0,135,132,3,0.0,0.0,1.0,0.9777777777777777,0.022222222222222223
6096,128,18,110,80,48,0.140625,0.859375,0.625,0.375,108,0,1,107,104,4,0.0,0.009259259259259259,0.9907407407407407,0.9629629629629629,0.037037037037037035
6097,166,18,148,107,59,0.10843373493975904,0.891566265060241,0.6445783132530121,0.35542168674698793,152,0,24,128,151,1,0.0,0.15789473684210525,0.8421052631578947,0.993421052631579,0.006578947368421052
6098,160,17,143,108,52,0.10625,0.89375,0.675,0.325,146,1,24,121,145,1,0.00684931506849315,0.1643835616438356,0.8287671232876712,0.9931506849315068,0.00684931506849315
6099,127,17,110,82,45,0.13385826771653545,0.8661417322834646,0.6456692913385826,0.3543307086614173,108,0,1,107,104,4,0.0,0.009259259259259259,0.9907407407407407,0.9629629629629629,0.037037037037037035
6100,82,15,67,41,41,0.18292682926829268,0.8170731707317073,0.5,0.5,87,0,28,59,87,0,0.0,0.3218390804597701,0.6781609195402298,1.0,0.0
6101,41,6,35,32,9,0.14634146341463414,0.8536585365853658,0.7804878048780488,0.21951219512195122,93,0,20,73,90,3,0.0,0.21505376344086022,0.7849462365591398,0.967741935483871,0.03225806451612903
6102,69,15,54,29,40,0.21739130434782608,0.782608695652174,0.42028985507246375,0.5797101449275363,111,0,30,81,111,0,0.0,0.2702702702702703,0.7297297297297297,1.0,0.0
6103,122,12,110,78,44,0.09836065573770492,0.9016393442622951,0.639344262295082,0.36065573770491804,107,0,1,106,103,4,0.0,0.009345794392523364,0.9906542056074766,0.9626168224299065,0.037383177570093455
6104,88,12,76,53,35,0.13636363636363635,0.8636363636363636,0.6022727272727273,0.3977272727272727,107,0,0,107,103,4,0.0,0.0,1.0,0.9626168224299065,0.037383177570093455
6105,125,15,110,75,50,0.12,0.88,0.6,0.4,118,0,1,117,115,3,0.0,0.00847457627118644,0.9915254237288136,0.9745762711864406,0.025423728813559324
6106,65,18,47,22,43,0.27692307692307694,0.7230769230769231,0.3384615384615385,0.6615384615384615,142,0,0,142,139,3,0.0,0.0,1.0,0.9788732394366197,0.02112676056338028
6107,125,15,110,84,41,0.12,0.88,0.672,0.328,112,0,1,111,108,4,0.0,0.008928571428571428,0.9910714285714286,0.9642857142857143,0.03571428571428571
6108,212,15,197,166,46,0.07075471698113207,0.9292452830188679,0.7830188679245284,0.2169811320754717,140,0,26,114,137,3,0.0,0.18571428571428572,0.8142857142857143,0.9785714285714285,0.02142857142857143
6109,111,20,91,59,52,0.18018018018018017,0.8198198198198198,0.5315315315315315,0.46846846846846846,189,0,54,135,187,2,0.0,0.2857142857142857,0.7142857142857143,0.9894179894179894,0.010582010582010581
6110,119,9,110,77,42,0.07563025210084033,0.9243697478991597,0.6470588235294118,0.35294117647058826,115,0,1,114,111,4,0.0,0.008695652173913044,0.991304347826087,0.9652173913043478,0.034782608695652174
6111,68,14,54,27,41,0.20588235294117646,0.7941176470588235,0.39705882352941174,0.6029411764705882,100,0,32,68,100,0,0.0,0.32,0.68,1.0,0.0
6112,192,13,179,152,40,0.06770833333333333,0.9322916666666666,0.7916666666666666,0.20833333333333334,136,0,28,108,133,3,0.0,0.20588235294117646,0.7941176470588235,0.9779411764705882,0.022058823529411766
6113,77,9,68,55,22,0.11688311688311688,0.8831168831168831,0.7142857142857143,0.2857142857142857,87,0,1,86,83,4,0.0,0.011494252873563218,0.9885057471264368,0.9540229885057471,0.04597701149425287
6114,198,20,178,150,48,0.10101010101010101,0.898989898989899,0.7575757575757576,0.24242424242424243,141,0,25,116,138,3,0.0,0.1773049645390071,0.8226950354609929,0.9787234042553191,0.02127659574468085
6115,199,20,179,154,45,0.10050251256281408,0.8994974874371859,0.7738693467336684,0.22613065326633167,140,0,27,113,137,3,0.0,0.19285714285714287,0.8071428571428572,0.9785714285714285,0.02142857142857143
6116,111,20,91,59,52,0.18018018018018017,0.8198198198198198,0.5315315315315315,0.46846846846846846,178,0,54,124,175,3,0.0,0.30337078651685395,0.6966292134831461,0.9831460674157303,0.016853932584269662
6117,111,9,102,78,33,0.08108108108108109,0.918918918918919,0.7027027027027027,0.2972972972972973,124,0,0,124,120,4,0.0,0.0,1.0,0.967741935483871,0.03225806451612903
6118,86,10,76,54,32,0.11627906976744186,0.8837209302325582,0.627906976744186,0.37209302325581395,122,0,0,122,119,3,0.0,0.0,1.0,0.9754098360655737,0.02459016393442623
6119,58,11,47,23,35,0.1896551724137931,0.8103448275862069,0.39655172413793105,0.603448275862069,137,0,0,137,134,3,0.0,0.0,1.0,0.9781021897810219,0.021897810218978103
6120,39,5,34,31,8,0.1282051282051282,0.8717948717948718,0.7948717948717948,0.20512820512820512,91,0,15,76,88,3,0.0,0.16483516483516483,0.8351648351648352,0.967032967032967,0.03296703296703297
6121,126,15,111,85,41,0.11904761904761904,0.8809523809523809,0.6746031746031746,0.3253968253968254,103,0,2,101,100,3,0.0,0.019417475728155338,0.9805825242718447,0.970873786407767,0.02912621359223301
6122,75,12,63,34,41,0.16,0.84,0.4533333333333333,0.5466666666666666,102,0,28,74,102,0,0.0,0.27450980392156865,0.7254901960784313,1.0,0.0
6123,114,12,102,68,46,0.10526315789473684,0.8947368421052632,0.5964912280701754,0.40350877192982454,130,0,0,130,128,2,0.0,0.0,1.0,0.9846153846153847,0.015384615384615385
6124,114,17,97,68,46,0.14912280701754385,0.8508771929824561,0.5964912280701754,0.40350877192982454,115,0,0,115,112,3,0.0,0.0,1.0,0.9739130434782609,0.02608695652173913
6125,40,5,35,33,7,0.125,0.875,0.825,0.175,88,0,16,72,85,3,0.0,0.18181818181818182,0.8181818181818182,0.9659090909090909,0.03409090909090909
6126,128,8,120,94,34,0.0625,0.9375,0.734375,0.265625,93,0,11,82,91,2,0.0,0.11827956989247312,0.8817204301075269,0.978494623655914,0.021505376344086023
6127,111,17,94,69,42,0.15315315315315314,0.8468468468468469,0.6216216216216216,0.3783783783783784,107,0,0,107,104,3,0.0,0.0,1.0,0.9719626168224299,0.028037383177570093
6128,193,13,180,153,40,0.06735751295336788,0.9326424870466321,0.7927461139896373,0.20725388601036268,138,0,25,113,136,2,0.0,0.18115942028985507,0.8188405797101449,0.9855072463768116,0.014492753623188406
6129,123,13,110,86,37,0.10569105691056911,0.8943089430894309,0.6991869918699187,0.3008130081300813,118,0,1,117,114,4,0.0,0.00847457627118644,0.9915254237288136,0.9661016949152542,0.03389830508474576
6130,59,12,47,27,32,0.2033898305084746,0.7966101694915254,0.4576271186440678,0.5423728813559322,139,0,0,139,136,3,0.0,0.0,1.0,0.9784172661870504,0.02158273381294964
6131,122,13,109,79,43,0.10655737704918032,0.8934426229508197,0.6475409836065574,0.3524590163934426,103,0,0,103,99,4,0.0,0.0,1.0,0.9611650485436893,0.038834951456310676
6132,37,3,34,29,8,0.08108108108108109,0.918918918918919,0.7837837837837838,0.21621621621621623,82,0,15,67,79,3,0.0,0.18292682926829268,0.8170731707317073,0.9634146341463414,0.036585365853658534
6133,129,20,109,83,46,0.15503875968992248,0.8449612403100775,0.6434108527131783,0.35658914728682173,111,0,1,110,107,4,0.0,0.009009009009009009,0.990990990990991,0.963963963963964,0.036036036036036036
6134,65,18,47,25,40,0.27692307692307694,0.7230769230769231,0.38461538461538464,0.6153846153846154,142,0,0,142,140,2,0.0,0.0,1.0,0.9859154929577465,0.014084507042253521
6135,128,17,111,84,44,0.1328125,0.8671875,0.65625,0.34375,120,0,2,118,116,4,0.0,0.016666666666666666,0.9833333333333333,0.9666666666666667,0.03333333333333333
6136,115,6,109,86,29,0.05217391304347826,0.9478260869565217,0.7478260869565218,0.25217391304347825,90,0,14,76,88,2,0.0,0.15555555555555556,0.8444444444444444,0.9777777777777777,0.022222222222222223
6137,60,13,47,27,33,0.21666666666666667,0.7833333333333333,0.45,0.55,150,0,0,150,147,3,0.0,0.0,1.0,0.98,0.02
6138,125,15,110,72,53,0.12,0.88,0.576,0.424,103,0,1,102,99,4,0.0,0.009708737864077669,0.9902912621359223,0.9611650485436893,0.038834951456310676
6139,198,18,180,156,42,0.09090909090909091,0.9090909090909091,0.7878787878787878,0.21212121212121213,135,0,27,108,132,3,0.0,0.2,0.8,0.9777777777777777,0.022222222222222223
6140,115,12,103,77,38,0.10434782608695652,0.8956521739130435,0.6695652173913044,0.33043478260869563,119,0,0,119,116,3,0.0,0.0,1.0,0.9747899159663865,0.025210084033613446
6141,125,16,109,78,47,0.128,0.872,0.624,0.376,119,0,1,118,115,4,0.0,0.008403361344537815,0.9915966386554622,0.9663865546218487,0.03361344537815126
6142,68,14,54,29,39,0.20588235294117646,0.7941176470588235,0.4264705882352941,0.5735294117647058,101,0,31,70,101,0,0.0,0.3069306930693069,0.693069306930693,1.0,0.0
6143,59,12,47,24,35,0.2033898305084746,0.7966101694915254,0.4067796610169492,0.5932203389830508,143,0,0,143,140,3,0.0,0.0,1.0,0.9790209790209791,0.02097902097902098
6144,201,18,183,162,39,0.08955223880597014,0.9104477611940298,0.8059701492537313,0.19402985074626866,148,0,25,123,145,3,0.0,0.16891891891891891,0.831081081081081,0.9797297297297297,0.02027027027027027
6145,126,17,109,83,43,0.1349206349206349,0.8650793650793651,0.6587301587301587,0.3412698412698413,111,0,1,110,107,4,0.0,0.009009009009009009,0.990990990990991,0.963963963963964,0.036036036036036036
6146,197,17,180,149,48,0.08629441624365482,0.9137055837563451,0.7563451776649747,0.2436548223350254,144,0,28,116,141,3,0.0,0.19444444444444445,0.8055555555555556,0.9791666666666666,0.020833333333333332
6147,59,12,47,29,30,0.2033898305084746,0.7966101694915254,0.4915254237288136,0.5084745762711864,154,0,0,154,151,3,0.0,0.0,1.0,0.9805194805194806,0.01948051948051948
6148,150,128,22,147,3,0.8533333333333334,0.14666666666666667,0.98,0.02,361,0,52,309,112,249,0.0,0.1440443213296399,0.8559556786703602,0.31024930747922436,0.6897506925207756
6149,195,17,178,154,41,0.08717948717948718,0.9128205128205128,0.7897435897435897,0.21025641025641026,142,0,25,117,140,2,0.0,0.176056338028169,0.823943661971831,0.9859154929577465,0.014084507042253521
6150,86,10,76,55,31,0.11627906976744186,0.8837209302325582,0.6395348837209303,0.36046511627906974,111,0,0,111,108,3,0.0,0.0,1.0,0.972972972972973,0.02702702702702703
6151,163,15,148,110,53,0.09202453987730061,0.9079754601226994,0.6748466257668712,0.32515337423312884,131,0,24,107,130,1,0.0,0.183206106870229,0.816793893129771,0.9923664122137404,0.007633587786259542
6152,89,13,76,53,36,0.14606741573033707,0.8539325842696629,0.5955056179775281,0.4044943820224719,120,0,0,120,118,2,0.0,0.0,1.0,0.9833333333333333,0.016666666666666666
6153,118,5,113,88,30,0.0423728813559322,0.9576271186440678,0.7457627118644068,0.2542372881355932,86,0,10,76,84,2,0.0,0.11627906976744186,0.8837209302325582,0.9767441860465116,0.023255813953488372
6154,60,13,47,26,34,0.21666666666666667,0.7833333333333333,0.43333333333333335,0.5666666666666667,151,0,0,151,149,2,0.0,0.0,1.0,0.9867549668874173,0.013245033112582781
6155,191,16,175,150,41,0.08376963350785341,0.9162303664921466,0.7853403141361257,0.21465968586387435,143,0,26,117,140,3,0.0,0.18181818181818182,0.8181818181818182,0.9790209790209791,0.02097902097902098
6156,197,15,182,156,41,0.07614213197969544,0.9238578680203046,0.7918781725888325,0.20812182741116753,132,0,26,106,129,3,0.0,0.19696969696969696,0.803030303030303,0.9772727272727273,0.022727272727272728
6157,111,5,106,87,24,0.04504504504504504,0.954954954954955,0.7837837837837838,0.21621621621621623,89,0,11,78,87,2,0.0,0.12359550561797752,0.8764044943820225,0.9775280898876404,0.02247191011235955
6158,124,14,110,77,47,0.11290322580645161,0.8870967741935484,0.6209677419354839,0.3790322580645161,110,0,1,109,106,4,0.0,0.00909090909090909,0.990909090909091,0.9636363636363636,0.03636363636363636
6159,123,13,110,80,43,0.10569105691056911,0.8943089430894309,0.6504065040650406,0.34959349593495936,105,0,0,105,102,3,0.0,0.0,1.0,0.9714285714285714,0.02857142857142857
6160,88,12,76,56,32,0.13636363636363635,0.8636363636363636,0.6363636363636364,0.36363636363636365,115,0,0,115,111,4,0.0,0.0,1.0,0.9652173913043478,0.034782608695652174
6161,126,15,111,88,38,0.11904761904761904,0.8809523809523809,0.6984126984126984,0.30158730158730157,109,0,2,107,105,4,0.0,0.01834862385321101,0.981651376146789,0.963302752293578,0.03669724770642202
6162,123,13,110,80,43,0.10569105691056911,0.8943089430894309,0.6504065040650406,0.34959349593495936,116,0,1,115,113,3,0.0,0.008620689655172414,0.9913793103448276,0.9741379310344828,0.02586206896551724
6163,68,14,54,26,42,0.20588235294117646,0.7941176470588235,0.38235294117647056,0.6176470588235294,103,0,31,72,103,0,0.0,0.30097087378640774,0.6990291262135923,1.0,0.0
6164,125,15,110,85,40,0.12,0.88,0.68,0.32,108,0,1,107,105,3,0.0,0.009259259259259259,0.9907407407407407,0.9722222222222222,0.027777777777777776
6165,123,17,106,75,48,0.13821138211382114,0.8617886178861789,0.6097560975609756,0.3902439024390244,114,0,0,114,110,4,0.0,0.0,1.0,0.9649122807017544,0.03508771929824561
6166,63,16,47,29,34,0.25396825396825395,0.746031746031746,0.4603174603174603,0.5396825396825397,140,0,0,140,137,3,0.0,0.0,1.0,0.9785714285714285,0.02142857142857143
6167,127,16,111,85,42,0.12598425196850394,0.8740157480314961,0.6692913385826772,0.33070866141732286,116,0,2,114,112,4,0.0,0.017241379310344827,0.9827586206896551,0.9655172413793104,0.034482758620689655
6168,109,11,98,69,40,0.10091743119266056,0.8990825688073395,0.6330275229357798,0.3669724770642202,121,0,0,121,118,3,0.0,0.0,1.0,0.9752066115702479,0.024793388429752067
6169,79,16,63,37,42,0.20253164556962025,0.7974683544303798,0.46835443037974683,0.5316455696202531,96,0,30,66,96,0,0.0,0.3125,0.6875,1.0,0.0
6170,118,8,110,80,38,0.06779661016949153,0.9322033898305084,0.6779661016949152,0.3220338983050847,115,0,1,114,111,4,0.0,0.008695652173913044,0.991304347826087,0.9652173913043478,0.034782608695652174
6171,39,5,34,31,8,0.1282051282051282,0.8717948717948718,0.7948717948717948,0.20512820512820512,83,0,14,69,80,3,0.0,0.1686746987951807,0.8313253012048193,0.963855421686747,0.03614457831325301
6172,163,15,148,116,47,0.09202453987730061,0.9079754601226994,0.7116564417177914,0.2883435582822086,151,0,24,127,150,1,0.0,0.15894039735099338,0.8410596026490066,0.9933774834437086,0.006622516556291391
6173,62,15,47,25,37,0.24193548387096775,0.7580645161290323,0.4032258064516129,0.5967741935483871,120,0,0,120,118,2,0.0,0.0,1.0,0.9833333333333333,0.016666666666666666
6174,111,15,96,74,37,0.13513513513513514,0.8648648648648649,0.6666666666666666,0.3333333333333333,102,0,0,102,99,3,0.0,0.0,1.0,0.9705882352941176,0.029411764705882353
6175,146,14,132,105,41,0.0958904109589041,0.9041095890410958,0.7191780821917808,0.2808219178082192,141,0,24,117,140,1,0.0,0.1702127659574468,0.8297872340425532,0.9929078014184397,0.0070921985815602835
6176,163,15,148,113,50,0.09202453987730061,0.9079754601226994,0.6932515337423313,0.3067484662576687,158,0,24,134,157,1,0.0,0.1518987341772152,0.8481012658227848,0.9936708860759493,0.006329113924050633
6177,40,6,34,32,8,0.15,0.85,0.8,0.2,84,0,13,71,81,3,0.0,0.15476190476190477,0.8452380952380952,0.9642857142857143,0.03571428571428571
6178,192,13,179,155,37,0.06770833333333333,0.9322916666666666,0.8072916666666666,0.19270833333333334,139,0,25,114,136,3,0.0,0.17985611510791366,0.8201438848920863,0.9784172661870504,0.02158273381294964
6179,59,11,48,29,30,0.1864406779661017,0.8135593220338984,0.4915254237288136,0.5084745762711864,146,0,0,146,143,3,0.0,0.0,1.0,0.9794520547945206,0.02054794520547945
6180,192,14,178,154,38,0.07291666666666667,0.9270833333333334,0.8020833333333334,0.19791666666666666,137,0,26,111,135,2,0.0,0.1897810218978102,0.8102189781021898,0.9854014598540146,0.014598540145985401
6181,131,20,111,80,51,0.15267175572519084,0.8473282442748091,0.6106870229007634,0.3893129770992366,114,0,2,112,110,4,0.0,0.017543859649122806,0.9824561403508771,0.9649122807017544,0.03508771929824561
6182,104,9,95,79,25,0.08653846153846154,0.9134615384615384,0.7596153846153846,0.2403846153846154,98,0,16,82,96,2,0.0,0.16326530612244897,0.8367346938775511,0.9795918367346939,0.02040816326530612
6183,96,20,76,54,42,0.20833333333333334,0.7916666666666666,0.5625,0.4375,101,0,0,101,99,2,0.0,0.0,1.0,0.9801980198019802,0.019801980198019802
6184,191,13,178,153,38,0.06806282722513089,0.9319371727748691,0.8010471204188482,0.19895287958115182,137,0,25,112,134,3,0.0,0.18248175182481752,0.8175182481751825,0.9781021897810219,0.021897810218978103
6185,124,15,109,77,47,0.12096774193548387,0.8790322580645161,0.6209677419354839,0.3790322580645161,109,0,1,108,105,4,0.0,0.009174311926605505,0.9908256880733946,0.963302752293578,0.03669724770642202
6186,124,14,110,85,39,0.11290322580645161,0.8870967741935484,0.6854838709677419,0.31451612903225806,105,0,1,104,101,4,0.0,0.009523809523809525,0.9904761904761905,0.9619047619047619,0.0380952380952381
6187,88,12,76,55,33,0.13636363636363635,0.8636363636363636,0.625,0.375,103,0,0,103,100,3,0.0,0.0,1.0,0.970873786407767,0.02912621359223301
6188,121,11,110,81,40,0.09090909090909091,0.9090909090909091,0.6694214876033058,0.3305785123966942,100,0,1,99,96,4,0.0,0.01,0.99,0.96,0.04
6189,69,15,54,27,42,0.21739130434782608,0.782608695652174,0.391304347826087,0.6086956521739131,119,0,32,87,119,0,0.0,0.2689075630252101,0.7310924369747899,1.0,0.0
6190,190,9,181,155,35,0.04736842105263158,0.9526315789473684,0.8157894736842105,0.18421052631578946,135,0,26,109,132,3,0.0,0.1925925925925926,0.8074074074074075,0.9777777777777777,0.022222222222222223
6191,64,16,48,27,37,0.25,0.75,0.421875,0.578125,130,0,0,130,127,3,0.0,0.0,1.0,0.9769230769230769,0.023076923076923078
6192,125,11,114,95,30,0.088,0.912,0.76,0.24,107,0,21,86,105,2,0.0,0.19626168224299065,0.8037383177570093,0.9813084112149533,0.018691588785046728
6193,167,19,148,116,51,0.11377245508982035,0.8862275449101796,0.6946107784431138,0.30538922155688625,158,0,24,134,157,1,0.0,0.1518987341772152,0.8481012658227848,0.9936708860759493,0.006329113924050633
6194,117,8,109,91,26,0.06837606837606838,0.9316239316239316,0.7777777777777778,0.2222222222222222,81,0,9,72,79,2,0.0,0.1111111111111111,0.8888888888888888,0.9753086419753086,0.024691358024691357
6195,213,18,195,167,46,0.08450704225352113,0.9154929577464789,0.784037558685446,0.215962441314554,146,0,27,119,143,3,0.0,0.18493150684931506,0.815068493150685,0.9794520547945206,0.02054794520547945
6196,124,15,109,77,47,0.12096774193548387,0.8790322580645161,0.6209677419354839,0.3790322580645161,101,0,1,100,97,4,0.0,0.009900990099009901,0.9900990099009901,0.9603960396039604,0.039603960396039604
6197,193,13,180,156,37,0.06735751295336788,0.9326424870466321,0.8082901554404145,0.19170984455958548,141,0,25,116,138,3,0.0,0.1773049645390071,0.8226950354609929,0.9787234042553191,0.02127659574468085
6198,198,17,181,154,44,0.08585858585858586,0.9141414141414141,0.7777777777777778,0.2222222222222222,137,0,26,111,134,3,0.0,0.1897810218978102,0.8102189781021898,0.9781021897810219,0.021897810218978103
6199,163,146,17,159,4,0.8957055214723927,0.10429447852760736,0.9754601226993865,0.024539877300613498,354,0,45,309,96,258,0.0,0.1271186440677966,0.8728813559322034,0.2711864406779661,0.7288135593220338
6200,123,12,111,84,39,0.0975609756097561,0.9024390243902439,0.6829268292682927,0.3170731707317073,112,0,2,110,108,4,0.0,0.017857142857142856,0.9821428571428571,0.9642857142857143,0.03571428571428571
6201,90,14,76,57,33,0.15555555555555556,0.8444444444444444,0.6333333333333333,0.36666666666666664,114,0,0,114,111,3,0.0,0.0,1.0,0.9736842105263158,0.02631578947368421
6202,102,11,91,58,44,0.10784313725490197,0.8921568627450981,0.5686274509803921,0.43137254901960786,196,0,54,142,193,3,0.0,0.2755102040816326,0.7244897959183674,0.9846938775510204,0.015306122448979591
6203,120,9,111,81,39,0.075,0.925,0.675,0.325,109,0,2,107,105,4,0.0,0.01834862385321101,0.981651376146789,0.963302752293578,0.03669724770642202
6204,66,12,54,27,39,0.18181818181818182,0.8181818181818182,0.4090909090909091,0.5909090909090909,114,0,30,84,114,0,0.0,0.2631578947368421,0.7368421052631579,1.0,0.0
6205,46,12,34,16,30,0.2608695652173913,0.7391304347826086,0.34782608695652173,0.6521739130434783,84,0,30,54,84,0,0.0,0.35714285714285715,0.6428571428571429,1.0,0.0
6206,79,7,72,52,27,0.08860759493670886,0.9113924050632911,0.6582278481012658,0.34177215189873417,81,0,1,80,77,4,0.0,0.012345679012345678,0.9876543209876543,0.9506172839506173,0.04938271604938271
6207,126,16,110,77,49,0.12698412698412698,0.873015873015873,0.6111111111111112,0.3888888888888889,122,0,1,121,118,4,0.0,0.00819672131147541,0.9918032786885246,0.9672131147540983,0.03278688524590164
6208,91,15,76,54,37,0.16483516483516483,0.8351648351648352,0.5934065934065934,0.4065934065934066,111,0,0,111,108,3,0.0,0.0,1.0,0.972972972972973,0.02702702702702703
6209,152,19,133,111,41,0.125,0.875,0.7302631578947368,0.26973684210526316,131,0,24,107,130,1,0.0,0.183206106870229,0.816793893129771,0.9923664122137404,0.007633587786259542
6210,60,13,47,29,31,0.21666666666666667,0.7833333333333333,0.48333333333333334,0.5166666666666667,140,0,0,140,137,3,0.0,0.0,1.0,0.9785714285714285,0.02142857142857143
6211,136,11,125,102,34,0.08088235294117647,0.9191176470588235,0.75,0.25,95,0,6,89,93,2,0.0,0.06315789473684211,0.9368421052631579,0.9789473684210527,0.021052631578947368
6212,58,10,48,27,31,0.1724137931034483,0.8275862068965517,0.46551724137931033,0.5344827586206896,139,0,0,139,137,2,0.0,0.0,1.0,0.9856115107913669,0.014388489208633094
6213,111,5,106,89,22,0.04504504504504504,0.954954954954955,0.8018018018018018,0.1981981981981982,90,0,14,76,88,2,0.0,0.15555555555555556,0.8444444444444444,0.9777777777777777,0.022222222222222223
6214,115,16,99,76,39,0.1391304347826087,0.8608695652173913,0.6608695652173913,0.3391304347826087,103,0,0,103,101,2,0.0,0.0,1.0,0.9805825242718447,0.019417475728155338
6215,127,17,110,74,53,0.13385826771653545,0.8661417322834646,0.5826771653543307,0.41732283464566927,99,0,1,98,95,4,0.0,0.010101010101010102,0.98989898989899,0.9595959595959596,0.04040404040404041
6216,115,5,110,93,22,0.043478260869565216,0.9565217391304348,0.808695652173913,0.19130434782608696,87,0,9,78,85,2,0.0,0.10344827586206896,0.896551724137931,0.9770114942528736,0.022988505747126436
6217,145,12,133,101,44,0.08275862068965517,0.9172413793103448,0.696551724137931,0.30344827586206896,125,0,24,101,124,1,0.0,0.192,0.808,0.992,0.008
6218,144,11,133,103,41,0.0763888888888889,0.9236111111111112,0.7152777777777778,0.2847222222222222,129,0,24,105,128,1,0.0,0.18604651162790697,0.813953488372093,0.9922480620155039,0.007751937984496124
6219,162,14,148,116,46,0.08641975308641975,0.9135802469135802,0.7160493827160493,0.2839506172839506,145,0,24,121,144,1,0.0,0.16551724137931034,0.8344827586206897,0.993103448275862,0.006896551724137931
6220,124,15,109,84,40,0.12096774193548387,0.8790322580645161,0.6774193548387096,0.3225806451612903,113,0,3,110,109,4,0.0,0.02654867256637168,0.9734513274336283,0.9646017699115044,0.035398230088495575
6221,75,11,64,35,40,0.14666666666666667,0.8533333333333334,0.4666666666666667,0.5333333333333333,84,0,28,56,84,0,0.0,0.3333333333333333,0.6666666666666666,1.0,0.0
6222,90,14,76,59,31,0.15555555555555556,0.8444444444444444,0.6555555555555556,0.34444444444444444,100,0,0,100,97,3,0.0,0.0,1.0,0.97,0.03
6223,196,15,181,157,39,0.07653061224489796,0.923469387755102,0.8010204081632653,0.1989795918367347,137,0,25,112,134,3,0.0,0.18248175182481752,0.8175182481751825,0.9781021897810219,0.021897810218978103
6224,124,13,111,83,41,0.10483870967741936,0.8951612903225806,0.6693548387096774,0.33064516129032256,106,0,2,104,102,4,0.0,0.018867924528301886,0.9811320754716981,0.9622641509433962,0.03773584905660377
6225,73,10,63,36,37,0.136986301369863,0.863013698630137,0.4931506849315068,0.5068493150684932,93,0,28,65,93,0,0.0,0.3010752688172043,0.6989247311827957,1.0,0.0
6226,91,15,76,54,37,0.16483516483516483,0.8351648351648352,0.5934065934065934,0.4065934065934066,114,0,0,114,111,3,0.0,0.0,1.0,0.9736842105263158,0.02631578947368421
6227,109,13,96,61,48,0.11926605504587157,0.8807339449541285,0.5596330275229358,0.44036697247706424,135,0,0,135,133,2,0.0,0.0,1.0,0.9851851851851852,0.014814814814814815
6228,168,20,148,114,54,0.11904761904761904,0.8809523809523809,0.6785714285714286,0.32142857142857145,151,0,24,127,150,1,0.0,0.15894039735099338,0.8410596026490066,0.9933774834437086,0.006622516556291391
6229,121,10,111,84,37,0.08264462809917356,0.9173553719008265,0.6942148760330579,0.30578512396694213,108,0,2,106,104,4,0.0,0.018518518518518517,0.9814814814814815,0.9629629629629629,0.037037037037037035
6230,127,16,111,84,43,0.12598425196850394,0.8740157480314961,0.6614173228346457,0.33858267716535434,103,0,2,101,99,4,0.0,0.019417475728155338,0.9805825242718447,0.9611650485436893,0.038834951456310676
6231,122,12,110,77,45,0.09836065573770492,0.9016393442622951,0.6311475409836066,0.36885245901639346,111,0,1,110,107,4,0.0,0.009009009009009009,0.990990990990991,0.963963963963964,0.036036036036036036
6232,164,16,148,115,49,0.0975609756097561,0.9024390243902439,0.7012195121951219,0.29878048780487804,150,0,24,126,149,1,0.0,0.16,0.84,0.9933333333333333,0.006666666666666667
6233,58,11,47,22,36,0.1896551724137931,0.8103448275862069,0.3793103448275862,0.6206896551724138,146,0,0,146,143,3,0.0,0.0,1.0,0.9794520547945206,0.02054794520547945
6234,88,12,76,56,32,0.13636363636363635,0.8636363636363636,0.6363636363636364,0.36363636363636365,103,0,0,103,100,3,0.0,0.0,1.0,0.970873786407767,0.02912621359223301
6235,93,17,76,50,43,0.1827956989247312,0.8172043010752689,0.5376344086021505,0.46236559139784944,99,0,0,99,97,2,0.0,0.0,1.0,0.9797979797979798,0.020202020202020204
6236,111,20,91,58,53,0.18018018018018017,0.8198198198198198,0.5225225225225225,0.4774774774774775,182,1,54,127,178,4,0.005494505494505495,0.2967032967032967,0.6978021978021978,0.978021978021978,0.02197802197802198
6237,127,16,111,83,44,0.12598425196850394,0.8740157480314961,0.6535433070866141,0.3464566929133858,113,0,1,112,109,4,0.0,0.008849557522123894,0.9911504424778761,0.9646017699115044,0.035398230088495575
6238,191,11,180,154,37,0.05759162303664921,0.9424083769633508,0.806282722513089,0.193717277486911,140,0,26,114,137,3,0.0,0.18571428571428572,0.8142857142857143,0.9785714285714285,0.02142857142857143
6239,126,16,110,80,46,0.12698412698412698,0.873015873015873,0.6349206349206349,0.36507936507936506,119,0,1,118,115,4,0.0,0.008403361344537815,0.9915966386554622,0.9663865546218487,0.03361344537815126
6240,122,12,110,78,44,0.09836065573770492,0.9016393442622951,0.639344262295082,0.36065573770491804,106,0,1,105,102,4,0.0,0.009433962264150943,0.9905660377358491,0.9622641509433962,0.03773584905660377
6241,61,14,47,26,35,0.22950819672131148,0.7704918032786885,0.4262295081967213,0.5737704918032787,144,0,0,144,141,3,0.0,0.0,1.0,0.9791666666666666,0.020833333333333332
6242,143,10,133,104,39,0.06993006993006994,0.9300699300699301,0.7272727272727273,0.2727272727272727,135,0,24,111,134,1,0.0,0.17777777777777778,0.8222222222222222,0.9925925925925926,0.007407407407407408
6243,86,10,76,56,30,0.11627906976744186,0.8837209302325582,0.6511627906976745,0.3488372093023256,100,0,0,100,96,4,0.0,0.0,1.0,0.96,0.04
6244,203,20,183,157,46,0.09852216748768473,0.9014778325123153,0.7733990147783252,0.22660098522167488,135,0,25,110,132,3,0.0,0.18518518518518517,0.8148148148148148,0.9777777777777777,0.022222222222222223
6245,109,6,103,91,18,0.05504587155963303,0.944954128440367,0.8348623853211009,0.1651376146788991,84,0,12,72,82,2,0.0,0.14285714285714285,0.8571428571428571,0.9761904761904762,0.023809523809523808
6246,125,15,110,85,40,0.12,0.88,0.68,0.32,115,0,1,114,111,4,0.0,0.008695652173913044,0.991304347826087,0.9652173913043478,0.034782608695652174
6247,127,9,118,100,27,0.07086614173228346,0.9291338582677166,0.7874015748031497,0.2125984251968504,106,0,16,90,104,2,0.0,0.1509433962264151,0.8490566037735849,0.9811320754716981,0.018867924528301886
6248,80,16,64,37,43,0.2,0.8,0.4625,0.5375,90,0,30,60,90,0,0.0,0.3333333333333333,0.6666666666666666,1.0,0.0
6249,143,13,130,108,35,0.09090909090909091,0.9090909090909091,0.7552447552447552,0.24475524475524477,132,0,25,107,131,1,0.0,0.1893939393939394,0.8106060606060606,0.9924242424242424,0.007575757575757576
6250,85,10,75,56,29,0.11764705882352941,0.8823529411764706,0.6588235294117647,0.3411764705882353,85,0,1,84,81,4,0.0,0.011764705882352941,0.9882352941176471,0.9529411764705882,0.047058823529411764
6251,65,18,47,27,38,0.27692307692307694,0.7230769230769231,0.4153846153846154,0.5846153846153846,147,0,0,147,144,3,0.0,0.0,1.0,0.9795918367346939,0.02040816326530612
6252,55,8,47,23,32,0.14545454545454545,0.8545454545454545,0.41818181818181815,0.5818181818181818,144,0,0,144,141,3,0.0,0.0,1.0,0.9791666666666666,0.020833333333333332
6253,128,18,110,83,45,0.140625,0.859375,0.6484375,0.3515625,111,0,1,110,107,4,0.0,0.009009009009009009,0.990990990990991,0.963963963963964,0.036036036036036036
6254,133,22,111,80,53,0.16541353383458646,0.8345864661654135,0.6015037593984962,0.39849624060150374,108,0,2,106,104,4,0.0,0.018518518518518517,0.9814814814814815,0.9629629629629629,0.037037037037037035
6255,193,14,179,156,37,0.07253886010362694,0.927461139896373,0.8082901554404145,0.19170984455958548,139,0,28,111,136,3,0.0,0.2014388489208633,0.7985611510791367,0.9784172661870504,0.02158273381294964
6256,48,14,34,18,30,0.2916666666666667,0.7083333333333334,0.375,0.625,81,0,32,49,81,0,0.0,0.3950617283950617,0.6049382716049383,1.0,0.0
6257,197,17,180,157,40,0.08629441624365482,0.9137055837563451,0.7969543147208121,0.20304568527918782,148,0,27,121,145,3,0.0,0.18243243243243243,0.8175675675675675,0.9797297297297297,0.02027027027027027
6258,185,8,177,151,34,0.043243243243243246,0.9567567567567568,0.8162162162162162,0.1837837837837838,141,0,26,115,139,2,0.0,0.18439716312056736,0.8156028368794326,0.9858156028368794,0.014184397163120567
6259,118,9,109,81,37,0.07627118644067797,0.923728813559322,0.6864406779661016,0.3135593220338983,111,0,1,110,107,4,0.0,0.009009009009009009,0.990990990990991,0.963963963963964,0.036036036036036036
6260,113,5,108,94,19,0.04424778761061947,0.9557522123893806,0.831858407079646,0.168141592920354,84,0,10,74,82,2,0.0,0.11904761904761904,0.8809523809523809,0.9761904761904762,0.023809523809523808
6261,198,21,177,151,47,0.10606060606060606,0.8939393939393939,0.7626262626262627,0.23737373737373738,144,0,27,117,141,3,0.0,0.1875,0.8125,0.9791666666666666,0.020833333333333332
6262,122,12,110,88,34,0.09836065573770492,0.9016393442622951,0.7213114754098361,0.2786885245901639,109,0,1,108,105,4,0.0,0.009174311926605505,0.9908256880733946,0.963302752293578,0.03669724770642202
6263,127,17,110,87,40,0.13385826771653545,0.8661417322834646,0.6850393700787402,0.31496062992125984,119,0,1,118,115,4,0.0,0.008403361344537815,0.9915966386554622,0.9663865546218487,0.03361344537815126
6264,109,18,91,51,58,0.1651376146788991,0.8348623853211009,0.46788990825688076,0.5321100917431193,194,0,54,140,191,3,0.0,0.27835051546391754,0.7216494845360825,0.9845360824742269,0.015463917525773196
6265,149,16,133,99,50,0.10738255033557047,0.8926174496644296,0.6644295302013423,0.33557046979865773,123,0,24,99,122,1,0.0,0.1951219512195122,0.8048780487804879,0.991869918699187,0.008130081300813009
6266,108,17,91,54,54,0.1574074074074074,0.8425925925925926,0.5,0.5,188,0,54,134,184,4,0.0,0.2872340425531915,0.7127659574468085,0.9787234042553191,0.02127659574468085
6267,212,15,197,173,39,0.07075471698113207,0.9292452830188679,0.8160377358490566,0.18396226415094338,139,0,26,113,137,2,0.0,0.18705035971223022,0.8129496402877698,0.9856115107913669,0.014388489208633094
6268,63,15,48,29,34,0.23809523809523808,0.7619047619047619,0.4603174603174603,0.5396825396825397,143,0,0,143,140,3,0.0,0.0,1.0,0.9790209790209791,0.02097902097902098
6269,216,16,200,174,42,0.07407407407407407,0.9259259259259259,0.8055555555555556,0.19444444444444445,133,0,27,106,130,3,0.0,0.20300751879699247,0.7969924812030075,0.9774436090225563,0.022556390977443608
6270,216,19,197,167,49,0.08796296296296297,0.9120370370370371,0.7731481481481481,0.22685185185185186,147,0,24,123,144,3,0.0,0.16326530612244897,0.8367346938775511,0.9795918367346939,0.02040816326530612
6271,124,15,109,80,44,0.12096774193548387,0.8790322580645161,0.6451612903225806,0.3548387096774194,106,0,1,105,103,3,0.0,0.009433962264150943,0.9905660377358491,0.9716981132075472,0.02830188679245283
6272,123,12,111,82,41,0.0975609756097561,0.9024390243902439,0.6666666666666666,0.3333333333333333,99,0,2,97,96,3,0.0,0.020202020202020204,0.9797979797979798,0.9696969696969697,0.030303030303030304
6273,125,15,110,77,48,0.12,0.88,0.616,0.384,110,0,1,109,106,4,0.0,0.00909090909090909,0.990909090909091,0.9636363636363636,0.03636363636363636
6274,68,14,54,30,38,0.20588235294117646,0.7941176470588235,0.4411764705882353,0.5588235294117647,107,0,30,77,107,0,0.0,0.2803738317757009,0.719626168224299,1.0,0.0
6275,115,24,91,58,57,0.20869565217391303,0.7913043478260869,0.5043478260869565,0.4956521739130435,176,0,54,122,174,2,0.0,0.3068181818181818,0.6931818181818182,0.9886363636363636,0.011363636363636364
6276,122,14,108,81,41,0.11475409836065574,0.8852459016393442,0.6639344262295082,0.3360655737704918,114,0,1,113,110,4,0.0,0.008771929824561403,0.9912280701754386,0.9649122807017544,0.03508771929824561
6277,113,6,107,91,22,0.05309734513274336,0.9469026548672567,0.8053097345132744,0.19469026548672566,88,0,10,78,86,2,0.0,0.11363636363636363,0.8863636363636364,0.9772727272727273,0.022727272727272728
6278,87,11,76,59,28,0.12643678160919541,0.8735632183908046,0.6781609195402298,0.3218390804597701,112,0,0,112,109,3,0.0,0.0,1.0,0.9732142857142857,0.026785714285714284
6279,214,16,198,168,46,0.07476635514018691,0.9252336448598131,0.7850467289719626,0.21495327102803738,142,0,25,117,139,3,0.0,0.176056338028169,0.823943661971831,0.9788732394366197,0.02112676056338028
6280,124,14,110,86,38,0.11290322580645161,0.8870967741935484,0.6935483870967742,0.3064516129032258,102,0,1,101,98,4,0.0,0.00980392156862745,0.9901960784313726,0.9607843137254902,0.0392156862745098
6281,57,10,47,25,32,0.17543859649122806,0.8245614035087719,0.43859649122807015,0.5614035087719298,137,0,0,137,134,3,0.0,0.0,1.0,0.9781021897810219,0.021897810218978103
6282,110,16,94,65,45,0.14545454545454545,0.8545454545454545,0.5909090909090909,0.4090909090909091,119,0,0,119,116,3,0.0,0.0,1.0,0.9747899159663865,0.025210084033613446
6283,120,7,113,99,21,0.058333333333333334,0.9416666666666667,0.825,0.175,80,0,8,72,78,2,0.0,0.1,0.9,0.975,0.025
6284,108,17,91,47,61,0.1574074074074074,0.8425925925925926,0.4351851851851852,0.5648148148148148,176,0,54,122,173,3,0.0,0.3068181818181818,0.6931818181818182,0.9829545454545454,0.017045454545454544
6285,152,19,133,100,52,0.125,0.875,0.6578947368421053,0.34210526315789475,124,0,24,100,123,1,0.0,0.1935483870967742,0.8064516129032258,0.9919354838709677,0.008064516129032258
6286,121,12,109,76,45,0.09917355371900827,0.9008264462809917,0.628099173553719,0.371900826446281,113,0,1,112,109,4,0.0,0.008849557522123894,0.9911504424778761,0.9646017699115044,0.035398230088495575
6287,122,12,110,78,44,0.09836065573770492,0.9016393442622951,0.639344262295082,0.36065573770491804,117,0,1,116,113,4,0.0,0.008547008547008548,0.9914529914529915,0.9658119658119658,0.03418803418803419
6288,105,14,91,54,51,0.13333333333333333,0.8666666666666667,0.5142857142857142,0.4857142857142857,176,0,54,122,173,3,0.0,0.3068181818181818,0.6931818181818182,0.9829545454545454,0.017045454545454544
6289,171,23,148,109,62,0.13450292397660818,0.8654970760233918,0.6374269005847953,0.36257309941520466,150,0,24,126,149,1,0.0,0.16,0.84,0.9933333333333333,0.006666666666666667
6290,59,12,47,25,34,0.2033898305084746,0.7966101694915254,0.423728813559322,0.576271186440678,132,0,0,132,129,3,0.0,0.0,1.0,0.9772727272727273,0.022727272727272728
6291,199,17,182,158,41,0.08542713567839195,0.914572864321608,0.7939698492462312,0.20603015075376885,138,0,27,111,135,3,0.0,0.1956521739130435,0.8043478260869565,0.9782608695652174,0.021739130434782608
6292,109,6,103,85,24,0.05504587155963303,0.944954128440367,0.7798165137614679,0.22018348623853212,94,0,17,77,92,2,0.0,0.18085106382978725,0.8191489361702128,0.9787234042553191,0.02127659574468085
6293,119,10,109,79,40,0.08403361344537816,0.9159663865546218,0.6638655462184874,0.33613445378151263,118,0,1,117,114,4,0.0,0.00847457627118644,0.9915254237288136,0.9661016949152542,0.03389830508474576
6294,72,18,54,29,43,0.25,0.75,0.4027777777777778,0.5972222222222222,101,0,30,71,101,0,0.0,0.297029702970297,0.7029702970297029,1.0,0.0
6295,169,21,148,120,49,0.1242603550295858,0.8757396449704142,0.7100591715976331,0.28994082840236685,148,0,24,124,147,1,0.0,0.16216216216216217,0.8378378378378378,0.9932432432432432,0.006756756756756757
6296,76,11,65,39,37,0.14473684210526316,0.8552631578947368,0.5131578947368421,0.4868421052631579,100,0,32,68,100,0,0.0,0.32,0.68,1.0,0.0
6297,110,6,104,85,25,0.05454545454545454,0.9454545454545454,0.7727272727272727,0.22727272727272727,88,0,15,73,86,2,0.0,0.17045454545454544,0.8295454545454546,0.9772727272727273,0.022727272727272728
6298,40,6,34,31,9,0.15,0.85,0.775,0.225,85,0,15,70,83,2,0.0,0.17647058823529413,0.8235294117647058,0.9764705882352941,0.023529411764705882
6299,198,20,178,152,46,0.10101010101010101,0.898989898989899,0.7676767676767676,0.23232323232323232,133,0,26,107,130,3,0.0,0.19548872180451127,0.8045112781954887,0.9774436090225563,0.022556390977443608
6300,75,11,64,36,39,0.14666666666666667,0.8533333333333334,0.48,0.52,92,0,30,62,92,0,0.0,0.32608695652173914,0.6739130434782609,1.0,0.0
6301,113,16,97,68,45,0.1415929203539823,0.8584070796460177,0.6017699115044248,0.39823008849557523,111,0,0,111,108,3,0.0,0.0,1.0,0.972972972972973,0.02702702702702703
6302,166,18,148,117,49,0.10843373493975904,0.891566265060241,0.7048192771084337,0.29518072289156627,138,0,24,114,137,1,0.0,0.17391304347826086,0.8260869565217391,0.9927536231884058,0.007246376811594203
6303,88,12,76,53,35,0.13636363636363635,0.8636363636363636,0.6022727272727273,0.3977272727272727,105,0,0,105,102,3,0.0,0.0,1.0,0.9714285714285714,0.02857142857142857
6304,69,15,54,32,37,0.21739130434782608,0.782608695652174,0.463768115942029,0.5362318840579711,99,0,30,69,99,0,0.0,0.30303030303030304,0.696969696969697,1.0,0.0
6305,37,4,33,30,7,0.10810810810810811,0.8918918918918919,0.8108108108108109,0.1891891891891892,89,0,16,73,87,2,0.0,0.1797752808988764,0.8202247191011236,0.9775280898876404,0.02247191011235955
6306,90,14,76,57,33,0.15555555555555556,0.8444444444444444,0.6333333333333333,0.36666666666666664,115,0,0,115,112,3,0.0,0.0,1.0,0.9739130434782609,0.02608695652173913
6307,93,17,76,54,39,0.1827956989247312,0.8172043010752689,0.5806451612903226,0.41935483870967744,112,0,0,112,108,4,0.0,0.0,1.0,0.9642857142857143,0.03571428571428571
6308,210,13,197,170,40,0.06190476190476191,0.9380952380952381,0.8095238095238095,0.19047619047619047,144,0,26,118,141,3,0.0,0.18055555555555555,0.8194444444444444,0.9791666666666666,0.020833333333333332
6309,73,19,54,26,47,0.2602739726027397,0.7397260273972602,0.3561643835616438,0.6438356164383562,106,0,32,74,106,0,0.0,0.3018867924528302,0.6981132075471698,1.0,0.0
6310,107,18,89,56,51,0.16822429906542055,0.8317757009345794,0.5233644859813084,0.4766355140186916,182,1,53,128,179,3,0.005494505494505495,0.29120879120879123,0.7032967032967034,0.9835164835164835,0.016483516483516484
6311,72,7,65,51,21,0.09722222222222222,0.9027777777777778,0.7083333333333334,0.2916666666666667,79,0,1,78,76,3,0.0,0.012658227848101266,0.9873417721518988,0.9620253164556962,0.0379746835443038
6312,121,10,111,80,41,0.08264462809917356,0.9173553719008265,0.6611570247933884,0.33884297520661155,113,0,2,111,109,4,0.0,0.017699115044247787,0.9823008849557522,0.9646017699115044,0.035398230088495575
6313,122,12,110,84,38,0.09836065573770492,0.9016393442622951,0.6885245901639344,0.3114754098360656,108,0,0,108,105,3,0.0,0.0,1.0,0.9722222222222222,0.027777777777777776
6314,113,8,105,88,25,0.07079646017699115,0.9292035398230089,0.7787610619469026,0.22123893805309736,86,0,14,72,84,2,0.0,0.16279069767441862,0.8372093023255814,0.9767441860465116,0.023255813953488372
6315,119,9,110,85,34,0.07563025210084033,0.9243697478991597,0.7142857142857143,0.2857142857142857,112,0,1,111,108,4,0.0,0.008928571428571428,0.9910714285714286,0.9642857142857143,0.03571428571428571
6316,110,19,91,52,58,0.17272727272727273,0.8272727272727273,0.4727272727272727,0.5272727272727272,175,0,54,121,172,3,0.0,0.30857142857142855,0.6914285714285714,0.9828571428571429,0.017142857142857144
6317,86,10,76,54,32,0.11627906976744186,0.8837209302325582,0.627906976744186,0.37209302325581395,108,0,0,108,105,3,0.0,0.0,1.0,0.9722222222222222,0.027777777777777776
6318,60,13,47,27,33,0.21666666666666667,0.7833333333333333,0.45,0.55,133,0,0,133,130,3,0.0,0.0,1.0,0.9774436090225563,0.022556390977443608
6319,90,14,76,54,36,0.15555555555555556,0.8444444444444444,0.6,0.4,114,0,0,114,111,3,0.0,0.0,1.0,0.9736842105263158,0.02631578947368421
6320,124,14,110,78,46,0.11290322580645161,0.8870967741935484,0.6290322580645161,0.3709677419354839,104,0,2,102,100,4,0.0,0.019230769230769232,0.9807692307692307,0.9615384615384616,0.038461538461538464
6321,65,18,47,28,37,0.27692307692307694,0.7230769230769231,0.4307692307692308,0.5692307692307692,142,0,0,142,139,3,0.0,0.0,1.0,0.9788732394366197,0.02112676056338028
6322,165,17,148,112,53,0.10303030303030303,0.896969696969697,0.6787878787878788,0.3212121212121212,147,0,24,123,146,1,0.0,0.16326530612244897,0.8367346938775511,0.9931972789115646,0.006802721088435374
6323,116,19,97,64,52,0.16379310344827586,0.8362068965517241,0.5517241379310345,0.4482758620689655,131,0,0,131,128,3,0.0,0.0,1.0,0.9770992366412213,0.022900763358778626
6324,117,6,111,99,18,0.05128205128205128,0.9487179487179487,0.8461538461538461,0.15384615384615385,81,0,7,74,79,2,0.0,0.08641975308641975,0.9135802469135802,0.9753086419753086,0.024691358024691357
6325,126,7,119,101,25,0.05555555555555555,0.9444444444444444,0.8015873015873016,0.1984126984126984,104,0,16,88,102,2,0.0,0.15384615384615385,0.8461538461538461,0.9807692307692307,0.019230769230769232
6326,129,7,122,101,28,0.05426356589147287,0.9457364341085271,0.7829457364341085,0.21705426356589147,97,0,11,86,95,2,0.0,0.1134020618556701,0.8865979381443299,0.979381443298969,0.020618556701030927
6327,192,14,178,151,41,0.07291666666666667,0.9270833333333334,0.7864583333333334,0.21354166666666666,147,0,26,121,144,3,0.0,0.17687074829931973,0.8231292517006803,0.9795918367346939,0.02040816326530612
6328,160,18,142,110,50,0.1125,0.8875,0.6875,0.3125,156,0,24,132,155,1,0.0,0.15384615384615385,0.8461538461538461,0.9935897435897436,0.00641025641025641
6329,118,12,106,78,40,0.1016949152542373,0.8983050847457628,0.6610169491525424,0.3389830508474576,130,0,0,130,126,4,0.0,0.0,1.0,0.9692307692307692,0.03076923076923077
6330,209,26,183,159,50,0.12440191387559808,0.8755980861244019,0.7607655502392344,0.23923444976076555,151,0,26,125,147,4,0.0,0.17218543046357615,0.8278145695364238,0.9735099337748344,0.026490066225165563
6331,58,11,47,24,34,0.1896551724137931,0.8103448275862069,0.41379310344827586,0.5862068965517241,148,0,0,148,145,3,0.0,0.0,1.0,0.9797297297297297,0.02027027027027027
6332,122,13,109,84,38,0.10655737704918032,0.8934426229508197,0.6885245901639344,0.3114754098360656,107,0,1,106,103,4,0.0,0.009345794392523364,0.9906542056074766,0.9626168224299065,0.037383177570093455
6333,109,18,91,57,52,0.1651376146788991,0.8348623853211009,0.5229357798165137,0.47706422018348627,174,0,54,120,172,2,0.0,0.3103448275862069,0.6896551724137931,0.9885057471264368,0.011494252873563218
6334,59,15,44,21,38,0.2542372881355932,0.7457627118644068,0.3559322033898305,0.6440677966101694,96,0,32,64,96,0,0.0,0.3333333333333333,0.6666666666666666,1.0,0.0
6335,110,10,100,78,32,0.09090909090909091,0.9090909090909091,0.7090909090909091,0.2909090909090909,136,0,0,136,132,4,0.0,0.0,1.0,0.9705882352941176,0.029411764705882353
6336,129,18,111,85,44,0.13953488372093023,0.8604651162790697,0.6589147286821705,0.34108527131782945,104,0,2,102,100,4,0.0,0.019230769230769232,0.9807692307692307,0.9615384615384616,0.038461538461538464
6337,100,5,95,87,13,0.05,0.95,0.87,0.13,86,0,17,69,84,2,0.0,0.19767441860465115,0.8023255813953488,0.9767441860465116,0.023255813953488372
6338,80,16,64,38,42,0.2,0.8,0.475,0.525,104,0,30,74,104,0,0.0,0.28846153846153844,0.7115384615384616,1.0,0.0
6339,39,5,34,31,8,0.1282051282051282,0.8717948717948718,0.7948717948717948,0.20512820512820512,82,0,14,68,79,3,0.0,0.17073170731707318,0.8292682926829268,0.9634146341463414,0.036585365853658534
6340,0,0,0,0,0,0.0,0.0,0.0,0.0,0,0,0,0,0,0,0.0,0.0,0.0,0.0,0.0
6341,92,11,81,60,32,0.11956521739130435,0.8804347826086957,0.6521739130434783,0.34782608695652173,89,0,1,88,85,4,0.0,0.011235955056179775,0.9887640449438202,0.9550561797752809,0.0449438202247191
6342,122,12,110,77,45,0.09836065573770492,0.9016393442622951,0.6311475409836066,0.36885245901639346,113,0,1,112,109,4,0.0,0.008849557522123894,0.9911504424778761,0.9646017699115044,0.035398230088495575
6343,91,15,76,52,39,0.16483516483516483,0.8351648351648352,0.5714285714285714,0.42857142857142855,101,0,0,101,97,4,0.0,0.0,1.0,0.9603960396039604,0.039603960396039604
6344,121,11,110,83,38,0.09090909090909091,0.9090909090909091,0.6859504132231405,0.3140495867768595,122,0,1,121,118,4,0.0,0.00819672131147541,0.9918032786885246,0.9672131147540983,0.03278688524590164
6345,92,16,76,57,35,0.17391304347826086,0.8260869565217391,0.6195652173913043,0.3804347826086957,104,0,0,104,101,3,0.0,0.0,1.0,0.9711538461538461,0.028846153846153848
6346,60,12,48,28,32,0.2,0.8,0.4666666666666667,0.5333333333333333,144,0,0,144,142,2,0.0,0.0,1.0,0.9861111111111112,0.013888888888888888
6347,126,16,110,76,50,0.12698412698412698,0.873015873015873,0.6031746031746031,0.3968253968253968,110,0,1,109,106,4,0.0,0.00909090909090909,0.990909090909091,0.9636363636363636,0.03636363636363636
6348,91,15,76,53,38,0.16483516483516483,0.8351648351648352,0.5824175824175825,0.4175824175824176,105,0,0,105,102,3,0.0,0.0,1.0,0.9714285714285714,0.02857142857142857
6349,86,10,76,57,29,0.11627906976744186,0.8837209302325582,0.6627906976744186,0.3372093023255814,111,0,0,111,108,3,0.0,0.0,1.0,0.972972972972973,0.02702702702702703
6350,115,9,106,88,27,0.0782608695652174,0.9217391304347826,0.7652173913043478,0.23478260869565218,84,0,10,74,82,2,0.0,0.11904761904761904,0.8809523809523809,0.9761904761904762,0.023809523809523808
6351,58,14,44,22,36,0.2413793103448276,0.7586206896551724,0.3793103448275862,0.6206896551724138,92,0,30,62,92,0,0.0,0.32608695652173914,0.6739130434782609,1.0,0.0
6352,81,16,65,40,41,0.19753086419753085,0.8024691358024691,0.49382716049382713,0.5061728395061729,106,0,30,76,106,0,0.0,0.2830188679245283,0.7169811320754716,1.0,0.0
6353,114,5,109,91,23,0.043859649122807015,0.956140350877193,0.7982456140350878,0.20175438596491227,86,0,8,78,84,2,0.0,0.09302325581395349,0.9069767441860465,0.9767441860465116,0.023255813953488372
6354,41,7,34,31,10,0.17073170731707318,0.8292682926829268,0.7560975609756098,0.24390243902439024,86,0,19,67,83,3,0.0,0.22093023255813954,0.7790697674418605,0.9651162790697675,0.03488372093023256
6355,119,9,110,84,35,0.07563025210084033,0.9243697478991597,0.7058823529411765,0.29411764705882354,113,0,1,112,109,4,0.0,0.008849557522123894,0.9911504424778761,0.9646017699115044,0.035398230088495575
6356,61,14,47,23,38,0.22950819672131148,0.7704918032786885,0.3770491803278688,0.6229508196721312,146,0,0,146,143,3,0.0,0.0,1.0,0.9794520547945206,0.02054794520547945
6357,90,8,82,62,28,0.08888888888888889,0.9111111111111111,0.6888888888888889,0.3111111111111111,85,0,1,84,81,4,0.0,0.011764705882352941,0.9882352941176471,0.9529411764705882,0.047058823529411764
6358,80,17,63,37,43,0.2125,0.7875,0.4625,0.5375,109,0,28,81,109,0,0.0,0.25688073394495414,0.7431192660550459,1.0,0.0
6359,79,14,65,38,41,0.17721518987341772,0.8227848101265823,0.4810126582278481,0.5189873417721519,96,0,29,67,96,0,0.0,0.3020833333333333,0.6979166666666666,1.0,0.0
6360,107,4,103,79,28,0.037383177570093455,0.9626168224299065,0.7383177570093458,0.2616822429906542,89,0,12,77,87,2,0.0,0.1348314606741573,0.8651685393258427,0.9775280898876404,0.02247191011235955
6361,129,19,110,79,50,0.14728682170542637,0.8527131782945736,0.6124031007751938,0.3875968992248062,107,0,1,106,103,4,0.0,0.009345794392523364,0.9906542056074766,0.9626168224299065,0.037383177570093455
6362,121,4,117,92,29,0.03305785123966942,0.9669421487603306,0.7603305785123967,0.2396694214876033,104,0,13,91,102,2,0.0,0.125,0.875,0.9807692307692307,0.019230769230769232
6363,93,17,76,58,35,0.1827956989247312,0.8172043010752689,0.6236559139784946,0.3763440860215054,117,0,0,117,113,4,0.0,0.0,1.0,0.9658119658119658,0.03418803418803419
6364,131,21,110,80,51,0.16030534351145037,0.8396946564885496,0.6106870229007634,0.3893129770992366,112,0,0,112,109,3,0.0,0.0,1.0,0.9732142857142857,0.026785714285714284
6365,189,11,178,155,34,0.0582010582010582,0.9417989417989417,0.8201058201058201,0.17989417989417988,138,0,25,113,136,2,0.0,0.18115942028985507,0.8188405797101449,0.9855072463768116,0.014492753623188406
6366,112,9,103,86,26,0.08035714285714286,0.9196428571428571,0.7678571428571429,0.23214285714285715,91,0,13,78,89,2,0.0,0.14285714285714285,0.8571428571428571,0.978021978021978,0.02197802197802198
6367,87,11,76,54,33,0.12643678160919541,0.8735632183908046,0.6206896551724138,0.3793103448275862,106,0,0,106,103,3,0.0,0.0,1.0,0.9716981132075472,0.02830188679245283
6368,109,18,91,55,54,0.1651376146788991,0.8348623853211009,0.5045871559633027,0.4954128440366973,185,0,54,131,182,3,0.0,0.2918918918918919,0.7081081081081081,0.9837837837837838,0.016216216216216217
6369,120,9,111,81,39,0.075,0.925,0.675,0.325,118,0,2,116,114,4,0.0,0.01694915254237288,0.9830508474576272,0.9661016949152542,0.03389830508474576
6370,198,20,178,156,42,0.10101010101010101,0.898989898989899,0.7878787878787878,0.21212121212121213,143,0,27,116,140,3,0.0,0.1888111888111888,0.8111888111888111,0.9790209790209791,0.02097902097902098
6371,124,15,109,87,37,0.12096774193548387,0.8790322580645161,0.7016129032258065,0.29838709677419356,97,0,1,96,93,4,0.0,0.010309278350515464,0.9896907216494846,0.9587628865979382,0.041237113402061855
6372,203,23,180,155,48,0.11330049261083744,0.8866995073891626,0.7635467980295566,0.23645320197044334,140,0,26,114,137,3,0.0,0.18571428571428572,0.8142857142857143,0.9785714285714285,0.02142857142857143
6373,88,12,76,56,32,0.13636363636363635,0.8636363636363636,0.6363636363636364,0.36363636363636365,105,0,0,105,101,4,0.0,0.0,1.0,0.9619047619047619,0.0380952380952381
6374,129,19,110,80,49,0.14728682170542637,0.8527131782945736,0.6201550387596899,0.3798449612403101,111,0,1,110,107,4,0.0,0.009009009009009009,0.990990990990991,0.963963963963964,0.036036036036036036
6375,110,19,91,59,51,0.17272727272727273,0.8272727272727273,0.5363636363636364,0.4636363636363636,179,0,54,125,176,3,0.0,0.3016759776536313,0.6983240223463687,0.9832402234636871,0.01675977653631285
6376,122,12,110,77,45,0.09836065573770492,0.9016393442622951,0.6311475409836066,0.36885245901639346,106,0,1,105,102,4,0.0,0.009433962264150943,0.9905660377358491,0.9622641509433962,0.03773584905660377
6377,127,17,110,78,49,0.13385826771653545,0.8661417322834646,0.6141732283464567,0.3858267716535433,113,0,2,111,109,4,0.0,0.017699115044247787,0.9823008849557522,0.9646017699115044,0.035398230088495575
6378,118,8,110,80,38,0.06779661016949153,0.9322033898305084,0.6779661016949152,0.3220338983050847,111,0,1,110,107,4,0.0,0.009009009009009009,0.990990990990991,0.963963963963964,0.036036036036036036
6379,192,14,178,151,41,0.07291666666666667,0.9270833333333334,0.7864583333333334,0.21354166666666666,155,0,26,129,152,3,0.0,0.16774193548387098,0.832258064516129,0.9806451612903225,0.01935483870967742
6380,125,14,111,83,42,0.112,0.888,0.664,0.336,116,0,2,114,113,3,0.0,0.017241379310344827,0.9827586206896551,0.9741379310344828,0.02586206896551724
6381,124,14,110,79,45,0.11290322580645161,0.8870967741935484,0.6370967741935484,0.3629032258064516,105,0,1,104,101,4,0.0,0.009523809523809525,0.9904761904761905,0.9619047619047619,0.0380952380952381
6382,60,13,47,29,31,0.21666666666666667,0.7833333333333333,0.48333333333333334,0.5166666666666667,145,0,0,145,142,3,0.0,0.0,1.0,0.9793103448275862,0.020689655172413793
6383,128,18,110,74,54,0.140625,0.859375,0.578125,0.421875,118,0,1,117,114,4,0.0,0.00847457627118644,0.9915254237288136,0.9661016949152542,0.03389830508474576
6384,54,6,48,26,28,0.1111111111111111,0.8888888888888888,0.48148148148148145,0.5185185185185185,141,0,0,141,138,3,0.0,0.0,1.0,0.9787234042553191,0.02127659574468085
6385,97,21,76,55,42,0.21649484536082475,0.7835051546391752,0.5670103092783505,0.4329896907216495,112,0,0,112,109,3,0.0,0.0,1.0,0.9732142857142857,0.026785714285714284
6386,59,12,47,27,32,0.2033898305084746,0.7966101694915254,0.4576271186440678,0.5423728813559322,135,0,0,135,132,3,0.0,0.0,1.0,0.9777777777777777,0.022222222222222223
6387,120,10,110,77,43,0.08333333333333333,0.9166666666666666,0.6416666666666667,0.35833333333333334,111,0,1,110,108,3,0.0,0.009009009009009009,0.990990990990991,0.972972972972973,0.02702702702702703
6388,58,14,44,24,34,0.2413793103448276,0.7586206896551724,0.41379310344827586,0.5862068965517241,102,0,32,70,102,0,0.0,0.3137254901960784,0.6862745098039216,1.0,0.0
6389,124,6,118,96,28,0.04838709677419355,0.9516129032258065,0.7741935483870968,0.22580645161290322,97,0,14,83,95,2,0.0,0.14432989690721648,0.8556701030927835,0.979381443298969,0.020618556701030927
6390,167,24,143,111,56,0.1437125748502994,0.8562874251497006,0.6646706586826348,0.33532934131736525,142,0,24,118,141,1,0.0,0.16901408450704225,0.8309859154929577,0.9929577464788732,0.007042253521126761
6391,58,11,47,24,34,0.1896551724137931,0.8103448275862069,0.41379310344827586,0.5862068965517241,133,0,0,133,130,3,0.0,0.0,1.0,0.9774436090225563,0.022556390977443608
6392,99,4,95,76,23,0.04040404040404041,0.9595959595959596,0.7676767676767676,0.23232323232323232,88,0,14,74,85,3,0.0,0.1590909090909091,0.8409090909090909,0.9659090909090909,0.03409090909090909
6393,212,18,194,165,47,0.08490566037735849,0.9150943396226415,0.7783018867924528,0.22169811320754718,137,0,25,112,134,3,0.0,0.18248175182481752,0.8175182481751825,0.9781021897810219,0.021897810218978103
6394,160,12,148,116,44,0.075,0.925,0.725,0.275,154,0,24,130,153,1,0.0,0.15584415584415584,0.8441558441558441,0.9935064935064936,0.006493506493506494
6395,195,15,180,156,39,0.07692307692307693,0.9230769230769231,0.8,0.2,136,0,26,110,133,3,0.0,0.19117647058823528,0.8088235294117647,0.9779411764705882,0.022058823529411766
6396,217,20,197,168,49,0.09216589861751152,0.9078341013824884,0.7741935483870968,0.22580645161290322,142,0,24,118,139,3,0.0,0.16901408450704225,0.8309859154929577,0.9788732394366197,0.02112676056338028
6397,165,17,148,116,49,0.10303030303030303,0.896969696969697,0.703030303030303,0.296969696969697,146,0,24,122,145,1,0.0,0.1643835616438356,0.8356164383561644,0.9931506849315068,0.00684931506849315
6398,88,6,82,55,33,0.06818181818181818,0.9318181818181818,0.625,0.375,82,0,1,81,78,4,0.0,0.012195121951219513,0.9878048780487805,0.9512195121951219,0.04878048780487805
6399,128,18,110,83,45,0.140625,0.859375,0.6484375,0.3515625,115,0,1,114,111,4,0.0,0.008695652173913044,0.991304347826087,0.9652173913043478,0.034782608695652174
6400,144,120,24,141,3,0.8333333333333334,0.16666666666666666,0.9791666666666666,0.020833333333333332,314,0,39,275,99,215,0.0,0.12420382165605096,0.8757961783439491,0.31528662420382164,0.6847133757961783
6401,37,4,33,32,5,0.10810810810810811,0.8918918918918919,0.8648648648648649,0.13513513513513514,83,0,15,68,80,3,0.0,0.18072289156626506,0.8192771084337349,0.963855421686747,0.03614457831325301
6402,63,16,47,27,36,0.25396825396825395,0.746031746031746,0.42857142857142855,0.5714285714285714,143,0,0,143,140,3,0.0,0.0,1.0,0.9790209790209791,0.02097902097902098
6403,80,16,64,41,39,0.2,0.8,0.5125,0.4875,97,0,29,68,97,0,0.0,0.29896907216494845,0.7010309278350515,1.0,0.0
6404,109,18,91,54,55,0.1651376146788991,0.8348623853211009,0.4954128440366973,0.5045871559633027,189,0,54,135,187,2,0.0,0.2857142857142857,0.7142857142857143,0.9894179894179894,0.010582010582010581
6405,81,7,74,53,28,0.08641975308641975,0.9135802469135802,0.654320987654321,0.345679012345679,84,0,1,83,81,3,0.0,0.011904761904761904,0.9880952380952381,0.9642857142857143,0.03571428571428571
6406,88,12,76,53,35,0.13636363636363635,0.8636363636363636,0.6022727272727273,0.3977272727272727,105,0,0,105,101,4,0.0,0.0,1.0,0.9619047619047619,0.0380952380952381
6407,195,16,179,154,41,0.08205128205128205,0.9179487179487179,0.7897435897435897,0.21025641025641026,145,0,26,119,142,3,0.0,0.1793103448275862,0.8206896551724138,0.9793103448275862,0.020689655172413793
6408,116,7,109,94,22,0.0603448275862069,0.9396551724137931,0.8103448275862069,0.1896551724137931,85,0,11,74,83,2,0.0,0.12941176470588237,0.8705882352941177,0.9764705882352941,0.023529411764705882
6409,124,15,109,80,44,0.12096774193548387,0.8790322580645161,0.6451612903225806,0.3548387096774194,121,0,1,120,117,4,0.0,0.008264462809917356,0.9917355371900827,0.9669421487603306,0.03305785123966942
6410,88,12,76,58,30,0.13636363636363635,0.8636363636363636,0.6590909090909091,0.3409090909090909,109,0,0,109,105,4,0.0,0.0,1.0,0.963302752293578,0.03669724770642202
6411,139,7,132,98,41,0.050359712230215826,0.9496402877697842,0.7050359712230215,0.2949640287769784,125,0,24,101,124,1,0.0,0.192,0.808,0.992,0.008
6412,68,14,54,28,40,0.20588235294117646,0.7941176470588235,0.4117647058823529,0.5882352941176471,97,0,31,66,97,0,0.0,0.31958762886597936,0.6804123711340206,1.0,0.0
6413,90,14,76,55,35,0.15555555555555556,0.8444444444444444,0.6111111111111112,0.3888888888888889,117,0,0,117,114,3,0.0,0.0,1.0,0.9743589743589743,0.02564102564102564
6414,59,11,48,29,30,0.1864406779661017,0.8135593220338984,0.4915254237288136,0.5084745762711864,152,0,0,152,149,3,0.0,0.0,1.0,0.9802631578947368,0.019736842105263157
6415,122,11,111,77,45,0.09016393442622951,0.9098360655737705,0.6311475409836066,0.36885245901639346,110,0,2,108,106,4,0.0,0.01818181818181818,0.9818181818181818,0.9636363636363636,0.03636363636363636
6416,57,10,47,25,32,0.17543859649122806,0.8245614035087719,0.43859649122807015,0.5614035087719298,135,0,0,135,132,3,0.0,0.0,1.0,0.9777777777777777,0.022222222222222223
6417,74,20,54,28,46,0.2702702702702703,0.7297297297297297,0.3783783783783784,0.6216216216216216,107,0,32,75,107,0,0.0,0.29906542056074764,0.7009345794392523,1.0,0.0
6418,127,17,110,82,45,0.13385826771653545,0.8661417322834646,0.6456692913385826,0.3543307086614173,108,0,1,107,104,4,0.0,0.009259259259259259,0.9907407407407407,0.9629629629629629,0.037037037037037035
6419,91,9,82,63,28,0.0989010989010989,0.9010989010989011,0.6923076923076923,0.3076923076923077,82,0,1,81,78,4,0.0,0.012195121951219513,0.9878048780487805,0.9512195121951219,0.04878048780487805
6420,80,16,64,37,43,0.2,0.8,0.4625,0.5375,85,0,28,57,85,0,0.0,0.32941176470588235,0.6705882352941176,1.0,0.0
6421,121,11,110,75,46,0.09090909090909091,0.9090909090909091,0.6198347107438017,0.38016528925619836,103,0,1,102,100,3,0.0,0.009708737864077669,0.9902912621359223,0.970873786407767,0.02912621359223301
6422,121,11,110,78,43,0.09090909090909091,0.9090909090909091,0.6446280991735537,0.35537190082644626,121,0,1,120,117,4,0.0,0.008264462809917356,0.9917355371900827,0.9669421487603306,0.03305785123966942
6423,89,13,76,55,34,0.14606741573033707,0.8539325842696629,0.6179775280898876,0.38202247191011235,105,0,0,105,102,3,0.0,0.0,1.0,0.9714285714285714,0.02857142857142857
6424,71,17,54,30,41,0.23943661971830985,0.7605633802816901,0.4225352112676056,0.5774647887323944,111,0,32,79,111,0,0.0,0.2882882882882883,0.7117117117117117,1.0,0.0
6425,44,9,35,33,11,0.20454545454545456,0.7954545454545454,0.75,0.25,82,0,11,71,79,3,0.0,0.13414634146341464,0.8658536585365854,0.9634146341463414,0.036585365853658534
6426,122,12,110,85,37,0.09836065573770492,0.9016393442622951,0.6967213114754098,0.30327868852459017,105,0,1,104,101,4,0.0,0.009523809523809525,0.9904761904761905,0.9619047619047619,0.0380952380952381
6427,63,16,47,22,41,0.25396825396825395,0.746031746031746,0.3492063492063492,0.6507936507936508,150,0,0,150,147,3,0.0,0.0,1.0,0.98,0.02
6428,67,20,47,27,40,0.29850746268656714,0.7014925373134329,0.40298507462686567,0.5970149253731343,141,0,0,141,138,3,0.0,0.0,1.0,0.9787234042553191,0.02127659574468085
6429,124,6,118,97,27,0.04838709677419355,0.9516129032258065,0.782258064516129,0.21774193548387097,100,0,16,84,98,2,0.0,0.16,0.84,0.98,0.02
6430,59,11,48,25,34,0.1864406779661017,0.8135593220338984,0.423728813559322,0.576271186440678,144,0,0,144,141,3,0.0,0.0,1.0,0.9791666666666666,0.020833333333333332
6431,125,15,110,84,41,0.12,0.88,0.672,0.328,115,0,1,114,112,3,0.0,0.008695652173913044,0.991304347826087,0.9739130434782609,0.02608695652173913
6432,88,12,76,55,33,0.13636363636363635,0.8636363636363636,0.625,0.375,118,0,0,118,115,3,0.0,0.0,1.0,0.9745762711864406,0.025423728813559324
6433,59,12,47,29,30,0.2033898305084746,0.7966101694915254,0.4915254237288136,0.5084745762711864,137,0,0,137,134,3,0.0,0.0,1.0,0.9781021897810219,0.021897810218978103
6434,43,9,34,16,27,0.20930232558139536,0.7906976744186046,0.37209302325581395,0.627906976744186,90,0,30,60,90,0,0.0,0.3333333333333333,0.6666666666666666,1.0,0.0
6435,125,14,111,85,40,0.112,0.888,0.68,0.32,104,0,2,102,100,4,0.0,0.019230769230769232,0.9807692307692307,0.9615384615384616,0.038461538461538464
6436,123,14,109,85,38,0.11382113821138211,0.8861788617886179,0.6910569105691057,0.3089430894308943,115,0,1,114,111,4,0.0,0.008695652173913044,0.991304347826087,0.9652173913043478,0.034782608695652174
6437,59,15,44,23,36,0.2542372881355932,0.7457627118644068,0.3898305084745763,0.6101694915254238,90,0,30,60,90,0,0.0,0.3333333333333333,0.6666666666666666,1.0,0.0
6438,124,14,110,83,41,0.11290322580645161,0.8870967741935484,0.6693548387096774,0.33064516129032256,111,0,1,110,107,4,0.0,0.009009009009009009,0.990990990990991,0.963963963963964,0.036036036036036036
6439,79,16,63,35,44,0.20253164556962025,0.7974683544303798,0.4430379746835443,0.5569620253164557,93,0,30,63,93,0,0.0,0.3225806451612903,0.6774193548387096,1.0,0.0
6440,74,20,54,28,46,0.2702702702702703,0.7297297297297297,0.3783783783783784,0.6216216216216216,101,0,30,71,101,0,0.0,0.297029702970297,0.7029702970297029,1.0,0.0
6441,61,14,47,25,36,0.22950819672131148,0.7704918032786885,0.4098360655737705,0.5901639344262295,135,0,0,135,132,3,0.0,0.0,1.0,0.9777777777777777,0.022222222222222223
6442,122,12,110,81,41,0.09836065573770492,0.9016393442622951,0.6639344262295082,0.3360655737704918,110,0,2,108,106,4,0.0,0.01818181818181818,0.9818181818181818,0.9636363636363636,0.03636363636363636
6443,131,20,111,81,50,0.15267175572519084,0.8473282442748091,0.6183206106870229,0.3816793893129771,102,0,2,100,98,4,0.0,0.0196078431372549,0.9803921568627451,0.9607843137254902,0.0392156862745098
6444,163,15,148,119,44,0.09202453987730061,0.9079754601226994,0.7300613496932515,0.26993865030674846,147,0,24,123,146,1,0.0,0.16326530612244897,0.8367346938775511,0.9931972789115646,0.006802721088435374
6445,77,13,64,37,40,0.16883116883116883,0.8311688311688312,0.4805194805194805,0.5194805194805194,98,0,30,68,98,0,0.0,0.30612244897959184,0.6938775510204082,1.0,0.0
6446,121,11,110,77,44,0.09090909090909091,0.9090909090909091,0.6363636363636364,0.36363636363636365,104,0,1,103,100,4,0.0,0.009615384615384616,0.9903846153846154,0.9615384615384616,0.038461538461538464
6447,211,13,198,173,38,0.061611374407582936,0.9383886255924171,0.8199052132701422,0.18009478672985782,149,0,25,124,146,3,0.0,0.16778523489932887,0.8322147651006712,0.9798657718120806,0.020134228187919462
6448,76,6,70,52,24,0.07894736842105263,0.9210526315789473,0.6842105263157895,0.3157894736842105,81,0,0,81,77,4,0.0,0.0,1.0,0.9506172839506173,0.04938271604938271
6449,123,13,110,83,40,0.10569105691056911,0.8943089430894309,0.6747967479674797,0.3252032520325203,109,0,1,108,105,4,0.0,0.009174311926605505,0.9908256880733946,0.963302752293578,0.03669724770642202
6450,68,7,61,49,19,0.10294117647058823,0.8970588235294118,0.7205882352941176,0.27941176470588236,82,0,1,81,78,4,0.0,0.012195121951219513,0.9878048780487805,0.9512195121951219,0.04878048780487805
6451,88,12,76,54,34,0.13636363636363635,0.8636363636363636,0.6136363636363636,0.38636363636363635,100,0,0,100,96,4,0.0,0.0,1.0,0.96,0.04
6452,171,23,148,117,54,0.13450292397660818,0.8654970760233918,0.6842105263157895,0.3157894736842105,153,0,24,129,152,1,0.0,0.1568627450980392,0.8431372549019608,0.9934640522875817,0.006535947712418301
6453,134,15,119,96,38,0.11194029850746269,0.8880597014925373,0.7164179104477612,0.2835820895522388,99,0,13,86,97,2,0.0,0.13131313131313133,0.8686868686868687,0.9797979797979798,0.020202020202020204
6454,100,4,96,79,21,0.04,0.96,0.79,0.21,88,0,15,73,86,2,0.0,0.17045454545454544,0.8295454545454546,0.9772727272727273,0.022727272727272728
6455,112,14,98,73,39,0.125,0.875,0.6517857142857143,0.3482142857142857,127,0,0,127,123,4,0.0,0.0,1.0,0.968503937007874,0.031496062992125984
6456,125,15,110,77,48,0.12,0.88,0.616,0.384,102,0,0,102,98,4,0.0,0.0,1.0,0.9607843137254902,0.0392156862745098
6457,69,6,63,45,24,0.08695652173913043,0.9130434782608695,0.6521739130434783,0.34782608695652173,80,0,1,79,76,4,0.0,0.0125,0.9875,0.95,0.05
6458,129,19,110,84,45,0.14728682170542637,0.8527131782945736,0.6511627906976745,0.3488372093023256,106,0,1,105,102,4,0.0,0.009433962264150943,0.9905660377358491,0.9622641509433962,0.03773584905660377
6459,37,4,33,31,6,0.10810810810810811,0.8918918918918919,0.8378378378378378,0.16216216216216217,85,0,17,68,82,3,0.0,0.2,0.8,0.9647058823529412,0.03529411764705882
6460,120,11,109,82,38,0.09166666666666666,0.9083333333333333,0.6833333333333333,0.31666666666666665,99,0,1,98,95,4,0.0,0.010101010101010102,0.98989898989899,0.9595959595959596,0.04040404040404041
6461,130,20,110,82,48,0.15384615384615385,0.8461538461538461,0.6307692307692307,0.36923076923076925,115,0,1,114,111,4,0.0,0.008695652173913044,0.991304347826087,0.9652173913043478,0.034782608695652174
6462,123,12,111,82,41,0.0975609756097561,0.9024390243902439,0.6666666666666666,0.3333333333333333,117,0,1,116,113,4,0.0,0.008547008547008548,0.9914529914529915,0.9658119658119658,0.03418803418803419
6463,70,16,54,27,43,0.22857142857142856,0.7714285714285715,0.38571428571428573,0.6142857142857143,85,0,32,53,85,0,0.0,0.3764705882352941,0.6235294117647059,1.0,0.0
6464,167,19,148,113,54,0.11377245508982035,0.8862275449101796,0.6766467065868264,0.32335329341317365,146,0,24,122,145,1,0.0,0.1643835616438356,0.8356164383561644,0.9931506849315068,0.00684931506849315
6465,77,13,64,36,41,0.16883116883116883,0.8311688311688312,0.4675324675324675,0.5324675324675324,104,0,30,74,104,0,0.0,0.28846153846153844,0.7115384615384616,1.0,0.0
6466,122,11,111,76,46,0.09016393442622951,0.9098360655737705,0.6229508196721312,0.3770491803278688,115,0,2,113,111,4,0.0,0.017391304347826087,0.9826086956521739,0.9652173913043478,0.034782608695652174
6467,116,6,110,94,22,0.05172413793103448,0.9482758620689655,0.8103448275862069,0.1896551724137931,87,0,10,77,85,2,0.0,0.11494252873563218,0.8850574712643678,0.9770114942528736,0.022988505747126436
6468,108,8,100,90,18,0.07407407407407407,0.9259259259259259,0.8333333333333334,0.16666666666666666,94,0,14,80,92,2,0.0,0.14893617021276595,0.851063829787234,0.9787234042553191,0.02127659574468085
6469,120,10,110,84,36,0.08333333333333333,0.9166666666666666,0.7,0.3,124,0,1,123,120,4,0.0,0.008064516129032258,0.9919354838709677,0.967741935483871,0.03225806451612903
6470,162,19,143,108,54,0.11728395061728394,0.8827160493827161,0.6666666666666666,0.3333333333333333,131,0,24,107,130,1,0.0,0.183206106870229,0.816793893129771,0.9923664122137404,0.007633587786259542
6471,39,5,34,15,24,0.1282051282051282,0.8717948717948718,0.38461538461538464,0.6153846153846154,80,0,30,50,80,0,0.0,0.375,0.625,1.0,0.0
6472,120,10,110,76,44,0.08333333333333333,0.9166666666666666,0.6333333333333333,0.36666666666666664,115,0,1,114,111,4,0.0,0.008695652173913044,0.991304347826087,0.9652173913043478,0.034782608695652174
6473,87,11,76,54,33,0.12643678160919541,0.8735632183908046,0.6206896551724138,0.3793103448275862,119,0,0,119,115,4,0.0,0.0,1.0,0.9663865546218487,0.03361344537815126
6474,202,22,180,152,50,0.10891089108910891,0.8910891089108911,0.7524752475247525,0.24752475247524752,127,0,25,102,124,3,0.0,0.1968503937007874,0.8031496062992126,0.9763779527559056,0.023622047244094488
6475,38,3,35,31,7,0.07894736842105263,0.9210526315789473,0.8157894736842105,0.18421052631578946,86,0,15,71,83,3,0.0,0.1744186046511628,0.8255813953488372,0.9651162790697675,0.03488372093023256
6476,111,7,104,88,23,0.06306306306306306,0.9369369369369369,0.7927927927927928,0.2072072072072072,86,0,13,73,84,2,0.0,0.1511627906976744,0.8488372093023255,0.9767441860465116,0.023255813953488372
6477,175,27,148,110,65,0.15428571428571428,0.8457142857142858,0.6285714285714286,0.37142857142857144,136,0,24,112,135,1,0.0,0.17647058823529413,0.8235294117647058,0.9926470588235294,0.007352941176470588
6478,192,13,179,156,36,0.06770833333333333,0.9322916666666666,0.8125,0.1875,143,0,25,118,140,3,0.0,0.17482517482517482,0.8251748251748252,0.9790209790209791,0.02097902097902098
6479,56,9,47,26,30,0.16071428571428573,0.8392857142857143,0.4642857142857143,0.5357142857142857,146,0,0,146,143,3,0.0,0.0,1.0,0.9794520547945206,0.02054794520547945
6480,191,13,178,155,36,0.06806282722513089,0.9319371727748691,0.8115183246073299,0.18848167539267016,143,0,26,117,141,2,0.0,0.18181818181818182,0.8181818181818182,0.986013986013986,0.013986013986013986
6481,65,18,47,24,41,0.27692307692307694,0.7230769230769231,0.36923076923076925,0.6307692307692307,139,0,0,139,137,2,0.0,0.0,1.0,0.9856115107913669,0.014388489208633094
6482,199,17,182,158,41,0.08542713567839195,0.914572864321608,0.7939698492462312,0.20603015075376885,141,0,27,114,138,3,0.0,0.19148936170212766,0.8085106382978723,0.9787234042553191,0.02127659574468085
6483,110,6,104,85,25,0.05454545454545454,0.9454545454545454,0.7727272727272727,0.22727272727272727,90,0,10,80,88,2,0.0,0.1111111111111111,0.8888888888888888,0.9777777777777777,0.022222222222222223
6484,84,9,75,57,27,0.10714285714285714,0.8928571428571429,0.6785714285714286,0.32142857142857145,79,0,1,78,75,4,0.0,0.012658227848101266,0.9873417721518988,0.9493670886075949,0.05063291139240506
6485,187,9,178,150,37,0.0481283422459893,0.9518716577540107,0.8021390374331551,0.19786096256684493,143,0,26,117,140,3,0.0,0.18181818181818182,0.8181818181818182,0.9790209790209791,0.02097902097902098
6486,119,15,104,71,48,0.12605042016806722,0.8739495798319328,0.5966386554621849,0.40336134453781514,115,0,0,115,112,3,0.0,0.0,1.0,0.9739130434782609,0.02608695652173913
6487,57,13,44,24,33,0.22807017543859648,0.7719298245614035,0.42105263157894735,0.5789473684210527,94,0,30,64,94,0,0.0,0.3191489361702128,0.6808510638297872,1.0,0.0
6488,70,16,54,29,41,0.22857142857142856,0.7714285714285715,0.4142857142857143,0.5857142857142857,111,0,32,79,111,0,0.0,0.2882882882882883,0.7117117117117117,1.0,0.0
6489,61,14,47,26,35,0.22950819672131148,0.7704918032786885,0.4262295081967213,0.5737704918032787,138,0,0,138,136,2,0.0,0.0,1.0,0.9855072463768116,0.014492753623188406
6490,133,8,125,104,29,0.06015037593984962,0.9398496240601504,0.7819548872180451,0.21804511278195488,92,0,10,82,90,2,0.0,0.10869565217391304,0.8913043478260869,0.9782608695652174,0.021739130434782608
6491,86,10,76,55,31,0.11627906976744186,0.8837209302325582,0.6395348837209303,0.36046511627906974,113,0,0,113,109,4,0.0,0.0,1.0,0.9646017699115044,0.035398230088495575
6492,89,13,76,55,34,0.14606741573033707,0.8539325842696629,0.6179775280898876,0.38202247191011235,100,0,0,100,96,4,0.0,0.0,1.0,0.96,0.04
6493,119,9,110,80,39,0.07563025210084033,0.9243697478991597,0.6722689075630253,0.3277310924369748,113,0,1,112,109,4,0.0,0.008849557522123894,0.9911504424778761,0.9646017699115044,0.035398230088495575
6494,62,15,47,25,37,0.24193548387096775,0.7580645161290323,0.4032258064516129,0.5967741935483871,148,0,0,148,145,3,0.0,0.0,1.0,0.9797297297297297,0.02027027027027027
6495,130,19,111,89,41,0.14615384615384616,0.8538461538461538,0.6846153846153846,0.3153846153846154,110,0,2,108,106,4,0.0,0.01818181818181818,0.9818181818181818,0.9636363636363636,0.03636363636363636
6496,73,8,65,55,18,0.1095890410958904,0.8904109589041096,0.7534246575342466,0.2465753424657534,80,0,0,80,76,4,0.0,0.0,1.0,0.95,0.05
6497,46,12,34,14,32,0.2608695652173913,0.7391304347826086,0.30434782608695654,0.6956521739130435,88,0,30,58,88,0,0.0,0.3409090909090909,0.6590909090909091,1.0,0.0
6498,120,11,109,79,41,0.09166666666666666,0.9083333333333333,0.6583333333333333,0.3416666666666667,117,0,1,116,113,4,0.0,0.008547008547008548,0.9914529914529915,0.9658119658119658,0.03418803418803419
6499,82,19,63,37,45,0.23170731707317074,0.7682926829268293,0.45121951219512196,0.5487804878048781,88,0,28,60,88,0,0.0,0.3181818181818182,0.6818181818181818,1.0,0.0
6500,110,19,91,66,44,0.17272727272727273,0.8272727272727273,0.6,0.4,178,0,54,124,176,2,0.0,0.30337078651685395,0.6966292134831461,0.9887640449438202,0.011235955056179775
6501,86,10,76,52,34,0.11627906976744186,0.8837209302325582,0.6046511627906976,0.3953488372093023,91,0,0,91,88,3,0.0,0.0,1.0,0.967032967032967,0.03296703296703297
6502,148,15,133,103,45,0.10135135135135136,0.8986486486486487,0.6959459459459459,0.30405405405405406,128,0,24,104,127,1,0.0,0.1875,0.8125,0.9921875,0.0078125
6503,40,7,33,31,9,0.175,0.825,0.775,0.225,84,0,16,68,81,3,0.0,0.19047619047619047,0.8095238095238095,0.9642857142857143,0.03571428571428571
6504,110,8,102,83,27,0.07272727272727272,0.9272727272727272,0.7545454545454545,0.24545454545454545,89,0,15,74,87,2,0.0,0.16853932584269662,0.8314606741573034,0.9775280898876404,0.02247191011235955
6505,111,7,104,92,19,0.06306306306306306,0.9369369369369369,0.8288288288288288,0.17117117117117117,82,0,13,69,80,2,0.0,0.15853658536585366,0.8414634146341463,0.975609756097561,0.024390243902439025
6506,64,16,48,30,34,0.25,0.75,0.46875,0.53125,138,0,0,138,135,3,0.0,0.0,1.0,0.9782608695652174,0.021739130434782608
6507,109,4,105,88,21,0.03669724770642202,0.963302752293578,0.8073394495412844,0.1926605504587156,90,0,15,75,88,2,0.0,0.16666666666666666,0.8333333333333334,0.9777777777777777,0.022222222222222223
6508,40,7,33,29,11,0.175,0.825,0.725,0.275,92,0,19,73,89,3,0.0,0.20652173913043478,0.7934782608695652,0.967391304347826,0.03260869565217391
6509,120,8,112,92,28,0.06666666666666667,0.9333333333333333,0.7666666666666667,0.23333333333333334,86,0,8,78,84,2,0.0,0.09302325581395349,0.9069767441860465,0.9767441860465116,0.023255813953488372
6510,89,13,76,59,30,0.14606741573033707,0.8539325842696629,0.6629213483146067,0.33707865168539325,112,0,0,112,109,3,0.0,0.0,1.0,0.9732142857142857,0.026785714285714284
6511,73,19,54,28,45,0.2602739726027397,0.7397260273972602,0.3835616438356164,0.6164383561643836,108,0,32,76,108,0,0.0,0.2962962962962963,0.7037037037037037,1.0,0.0
6512,124,12,112,92,32,0.0967741935483871,0.9032258064516129,0.7419354838709677,0.25806451612903225,103,0,19,84,101,2,0.0,0.18446601941747573,0.8155339805825242,0.9805825242718447,0.019417475728155338
6513,193,13,180,152,41,0.06735751295336788,0.9326424870466321,0.7875647668393783,0.21243523316062177,137,0,27,110,134,3,0.0,0.19708029197080293,0.8029197080291971,0.9781021897810219,0.021897810218978103
6514,62,18,44,18,44,0.2903225806451613,0.7096774193548387,0.2903225806451613,0.7096774193548387,90,0,30,60,90,0,0.0,0.3333333333333333,0.6666666666666666,1.0,0.0
6515,89,13,76,51,38,0.14606741573033707,0.8539325842696629,0.5730337078651685,0.42696629213483145,111,0,0,111,108,3,0.0,0.0,1.0,0.972972972972973,0.02702702702702703
6516,112,12,100,73,39,0.10714285714285714,0.8928571428571429,0.6517857142857143,0.3482142857142857,107,0,0,107,104,3,0.0,0.0,1.0,0.9719626168224299,0.028037383177570093
6517,110,4,106,85,25,0.03636363636363636,0.9636363636363636,0.7727272727272727,0.22727272727272727,86,0,9,77,84,2,0.0,0.10465116279069768,0.8953488372093024,0.9767441860465116,0.023255813953488372
6518,197,17,180,152,45,0.08629441624365482,0.9137055837563451,0.7715736040609137,0.22842639593908629,136,0,26,110,133,3,0.0,0.19117647058823528,0.8088235294117647,0.9779411764705882,0.022058823529411766
6519,128,11,117,96,32,0.0859375,0.9140625,0.75,0.25,92,0,15,77,90,2,0.0,0.16304347826086957,0.8369565217391305,0.9782608695652174,0.021739130434782608
6520,56,12,44,24,32,0.21428571428571427,0.7857142857142857,0.42857142857142855,0.5714285714285714,90,0,30,60,90,0,0.0,0.3333333333333333,0.6666666666666666,1.0,0.0
6521,129,6,123,99,30,0.046511627906976744,0.9534883720930233,0.7674418604651163,0.23255813953488372,101,0,11,90,99,2,0.0,0.10891089108910891,0.8910891089108911,0.9801980198019802,0.019801980198019802
6522,122,16,106,80,42,0.13114754098360656,0.8688524590163934,0.6557377049180327,0.3442622950819672,106,0,1,105,103,3,0.0,0.009433962264150943,0.9905660377358491,0.9716981132075472,0.02830188679245283
6523,121,11,110,76,45,0.09090909090909091,0.9090909090909091,0.628099173553719,0.371900826446281,111,0,1,110,107,4,0.0,0.009009009009009009,0.990990990990991,0.963963963963964,0.036036036036036036
6524,150,18,132,110,40,0.12,0.88,0.7333333333333333,0.26666666666666666,130,0,24,106,129,1,0.0,0.18461538461538463,0.8153846153846154,0.9923076923076923,0.007692307692307693
6525,201,16,185,158,43,0.07960199004975124,0.9203980099502488,0.7860696517412935,0.21393034825870647,134,0,23,111,131,3,0.0,0.17164179104477612,0.8283582089552238,0.9776119402985075,0.022388059701492536
6526,105,4,101,80,25,0.0380952380952381,0.9619047619047619,0.7619047619047619,0.23809523809523808,92,0,16,76,90,2,0.0,0.17391304347826086,0.8260869565217391,0.9782608695652174,0.021739130434782608
6527,119,8,111,84,35,0.06722689075630252,0.9327731092436975,0.7058823529411765,0.29411764705882354,112,0,2,110,108,4,0.0,0.017857142857142856,0.9821428571428571,0.9642857142857143,0.03571428571428571
6528,124,8,116,99,25,0.06451612903225806,0.9354838709677419,0.7983870967741935,0.20161290322580644,93,0,13,80,91,2,0.0,0.13978494623655913,0.8602150537634409,0.978494623655914,0.021505376344086023
6529,198,20,178,153,45,0.10101010101010101,0.898989898989899,0.7727272727272727,0.22727272727272727,139,0,25,114,136,3,0.0,0.17985611510791366,0.8201438848920863,0.9784172661870504,0.02158273381294964
6530,119,10,109,77,42,0.08403361344537816,0.9159663865546218,0.6470588235294118,0.35294117647058826,110,0,1,109,107,3,0.0,0.00909090909090909,0.990909090909091,0.9727272727272728,0.02727272727272727
6531,106,5,101,94,12,0.04716981132075472,0.9528301886792453,0.8867924528301887,0.11320754716981132,91,0,12,79,89,2,0.0,0.13186813186813187,0.8681318681318682,0.978021978021978,0.02197802197802198
6532,64,10,54,25,39,0.15625,0.84375,0.390625,0.609375,105,0,30,75,105,0,0.0,0.2857142857142857,0.7142857142857143,1.0,0.0
6533,114,23,91,59,55,0.20175438596491227,0.7982456140350878,0.5175438596491229,0.4824561403508772,177,0,54,123,174,3,0.0,0.3050847457627119,0.6949152542372882,0.9830508474576272,0.01694915254237288
6534,166,18,148,115,51,0.10843373493975904,0.891566265060241,0.6927710843373494,0.3072289156626506,150,0,24,126,149,1,0.0,0.16,0.84,0.9933333333333333,0.006666666666666667
6535,159,19,140,109,50,0.11949685534591195,0.8805031446540881,0.6855345911949685,0.31446540880503143,133,0,25,108,132,1,0.0,0.18796992481203006,0.8120300751879699,0.9924812030075187,0.007518796992481203
6536,85,9,76,52,33,0.10588235294117647,0.8941176470588236,0.611764705882353,0.38823529411764707,114,0,0,114,111,3,0.0,0.0,1.0,0.9736842105263158,0.02631578947368421
6537,123,12,111,87,36,0.0975609756097561,0.9024390243902439,0.7073170731707317,0.2926829268292683,109,0,2,107,105,4,0.0,0.01834862385321101,0.981651376146789,0.963302752293578,0.03669724770642202
6538,87,11,76,56,31,0.12643678160919541,0.8735632183908046,0.6436781609195402,0.3563218390804598,111,0,0,111,108,3,0.0,0.0,1.0,0.972972972972973,0.02702702702702703
6539,126,16,110,75,51,0.12698412698412698,0.873015873015873,0.5952380952380952,0.40476190476190477,111,0,1,110,107,4,0.0,0.009009009009009009,0.990990990990991,0.963963963963964,0.036036036036036036
6540,69,15,54,31,38,0.21739130434782608,0.782608695652174,0.4492753623188406,0.5507246376811594,101,0,30,71,101,0,0.0,0.297029702970297,0.7029702970297029,1.0,0.0
6541,122,13,109,77,45,0.10655737704918032,0.8934426229508197,0.6311475409836066,0.36885245901639346,114,0,1,113,110,4,0.0,0.008771929824561403,0.9912280701754386,0.9649122807017544,0.03508771929824561
6542,150,17,133,112,38,0.11333333333333333,0.8866666666666667,0.7466666666666667,0.25333333333333335,132,0,24,108,131,1,0.0,0.18181818181818182,0.8181818181818182,0.9924242424242424,0.007575757575757576
6543,199,20,179,156,43,0.10050251256281408,0.8994974874371859,0.7839195979899497,0.21608040201005024,135,0,25,110,132,3,0.0,0.18518518518518517,0.8148148148148148,0.9777777777777777,0.022222222222222223
6544,70,16,54,29,41,0.22857142857142856,0.7714285714285715,0.4142857142857143,0.5857142857142857,104,0,32,72,104,0,0.0,0.3076923076923077,0.6923076923076923,1.0,0.0
6545,121,11,110,75,46,0.09090909090909091,0.9090909090909091,0.6198347107438017,0.38016528925619836,101,0,1,100,98,3,0.0,0.009900990099009901,0.9900990099009901,0.9702970297029703,0.0297029702970297
6546,191,13,178,151,40,0.06806282722513089,0.9319371727748691,0.7905759162303665,0.2094240837696335,149,0,26,123,146,3,0.0,0.174496644295302,0.825503355704698,0.9798657718120806,0.020134228187919462
6547,83,9,74,58,25,0.10843373493975904,0.891566265060241,0.6987951807228916,0.30120481927710846,79,0,1,78,75,4,0.0,0.012658227848101266,0.9873417721518988,0.9493670886075949,0.05063291139240506
6548,119,7,112,99,20,0.058823529411764705,0.9411764705882353,0.8319327731092437,0.16806722689075632,86,0,7,79,84,2,0.0,0.08139534883720931,0.9186046511627907,0.9767441860465116,0.023255813953488372
6549,198,16,182,157,41,0.08080808080808081,0.9191919191919192,0.7929292929292929,0.20707070707070707,139,0,26,113,136,3,0.0,0.18705035971223022,0.8129496402877698,0.9784172661870504,0.02158273381294964
6550,196,14,182,158,38,0.07142857142857142,0.9285714285714286,0.8061224489795918,0.19387755102040816,136,0,27,109,133,3,0.0,0.19852941176470587,0.8014705882352942,0.9779411764705882,0.022058823529411766
6551,143,11,132,102,41,0.07692307692307693,0.9230769230769231,0.7132867132867133,0.2867132867132867,128,0,24,104,127,1,0.0,0.1875,0.8125,0.9921875,0.0078125
6552,122,12,110,77,45,0.09836065573770492,0.9016393442622951,0.6311475409836066,0.36885245901639346,114,0,1,113,110,4,0.0,0.008771929824561403,0.9912280701754386,0.9649122807017544,0.03508771929824561
6553,128,17,111,84,44,0.1328125,0.8671875,0.65625,0.34375,105,0,2,103,102,3,0.0,0.01904761904761905,0.9809523809523809,0.9714285714285714,0.02857142857142857
6554,42,8,34,20,22,0.19047619047619047,0.8095238095238095,0.47619047619047616,0.5238095238095238,89,0,32,57,89,0,0.0,0.3595505617977528,0.6404494382022472,1.0,0.0
6555,91,15,76,54,37,0.16483516483516483,0.8351648351648352,0.5934065934065934,0.4065934065934066,110,0,0,110,107,3,0.0,0.0,1.0,0.9727272727272728,0.02727272727272727
6556,126,15,111,75,51,0.11904761904761904,0.8809523809523809,0.5952380952380952,0.40476190476190477,108,0,2,106,105,3,0.0,0.018518518518518517,0.9814814814814815,0.9722222222222222,0.027777777777777776
6557,124,15,109,87,37,0.12096774193548387,0.8790322580645161,0.7016129032258065,0.29838709677419356,107,0,1,106,103,4,0.0,0.009345794392523364,0.9906542056074766,0.9626168224299065,0.037383177570093455
6558,110,13,97,70,40,0.11818181818181818,0.8818181818181818,0.6363636363636364,0.36363636363636365,118,0,1,117,115,3,0.0,0.00847457627118644,0.9915254237288136,0.9745762711864406,0.025423728813559324
6559,39,6,33,30,9,0.15384615384615385,0.8461538461538461,0.7692307692307693,0.23076923076923078,86,0,21,65,83,3,0.0,0.2441860465116279,0.7558139534883721,0.9651162790697675,0.03488372093023256
6560,161,13,148,109,52,0.08074534161490683,0.9192546583850931,0.6770186335403726,0.32298136645962733,152,1,24,127,151,1,0.006578947368421052,0.15789473684210525,0.8355263157894737,0.993421052631579,0.006578947368421052
6561,59,12,47,30,29,0.2033898305084746,0.7966101694915254,0.5084745762711864,0.4915254237288136,149,0,0,149,146,3,0.0,0.0,1.0,0.9798657718120806,0.020134228187919462
6562,125,15,110,78,47,0.12,0.88,0.624,0.376,118,0,1,117,115,3,0.0,0.00847457627118644,0.9915254237288136,0.9745762711864406,0.025423728813559324
6563,188,13,175,151,37,0.06914893617021277,0.9308510638297872,0.8031914893617021,0.19680851063829788,143,0,27,116,140,3,0.0,0.1888111888111888,0.8111888111888111,0.9790209790209791,0.02097902097902098
6564,174,144,30,171,3,0.8275862068965517,0.1724137931034483,0.9827586206896551,0.017241379310344827,296,0,32,264,84,212,0.0,0.10810810810810811,0.8918918918918919,0.28378378378378377,0.7162162162162162
6565,186,9,177,152,34,0.04838709677419355,0.9516129032258065,0.8172043010752689,0.1827956989247312,143,0,27,116,141,2,0.0,0.1888111888111888,0.8111888111888111,0.986013986013986,0.013986013986013986
6566,66,18,48,30,36,0.2727272727272727,0.7272727272727273,0.45454545454545453,0.5454545454545454,140,0,0,140,137,3,0.0,0.0,1.0,0.9785714285714285,0.02142857142857143
6567,126,15,111,81,45,0.11904761904761904,0.8809523809523809,0.6428571428571429,0.35714285714285715,108,0,2,106,104,4,0.0,0.018518518518518517,0.9814814814814815,0.9629629629629629,0.037037037037037035
6568,103,5,98,85,18,0.04854368932038835,0.9514563106796117,0.8252427184466019,0.17475728155339806,82,0,14,68,80,2,0.0,0.17073170731707318,0.8292682926829268,0.975609756097561,0.024390243902439025
6569,191,13,178,154,37,0.06806282722513089,0.9319371727748691,0.806282722513089,0.193717277486911,131,0,26,105,128,3,0.0,0.1984732824427481,0.8015267175572519,0.9770992366412213,0.022900763358778626
6570,123,13,110,77,46,0.10569105691056911,0.8943089430894309,0.6260162601626016,0.37398373983739835,104,0,1,103,100,4,0.0,0.009615384615384616,0.9903846153846154,0.9615384615384616,0.038461538461538464
6571,106,5,101,90,16,0.04716981132075472,0.9528301886792453,0.8490566037735849,0.1509433962264151,96,0,15,81,94,2,0.0,0.15625,0.84375,0.9791666666666666,0.020833333333333332
6572,105,7,98,85,20,0.06666666666666667,0.9333333333333333,0.8095238095238095,0.19047619047619047,88,0,16,72,86,2,0.0,0.18181818181818182,0.8181818181818182,0.9772727272727273,0.022727272727272728
6573,108,6,102,88,20,0.05555555555555555,0.9444444444444444,0.8148148148148148,0.18518518518518517,95,0,16,79,93,2,0.0,0.16842105263157894,0.8315789473684211,0.9789473684210527,0.021052631578947368
6574,121,11,110,78,43,0.09090909090909091,0.9090909090909091,0.6446280991735537,0.35537190082644626,102,0,1,101,98,4,0.0,0.00980392156862745,0.9901960784313726,0.9607843137254902,0.0392156862745098
6575,124,14,110,79,45,0.11290322580645161,0.8870967741935484,0.6370967741935484,0.3629032258064516,111,0,1,110,107,4,0.0,0.009009009009009009,0.990990990990991,0.963963963963964,0.036036036036036036
6576,123,13,110,77,46,0.10569105691056911,0.8943089430894309,0.6260162601626016,0.37398373983739835,107,0,1,106,103,4,0.0,0.009345794392523364,0.9906542056074766,0.9626168224299065,0.037383177570093455
6577,93,17,76,55,38,0.1827956989247312,0.8172043010752689,0.5913978494623656,0.40860215053763443,123,0,0,123,120,3,0.0,0.0,1.0,0.975609756097561,0.024390243902439025
6578,120,13,107,80,40,0.10833333333333334,0.8916666666666667,0.6666666666666666,0.3333333333333333,110,0,2,108,106,4,0.0,0.01818181818181818,0.9818181818181818,0.9636363636363636,0.03636363636363636
6579,91,15,76,55,36,0.16483516483516483,0.8351648351648352,0.6043956043956044,0.3956043956043956,97,0,0,97,93,4,0.0,0.0,1.0,0.9587628865979382,0.041237113402061855
6580,111,7,104,82,29,0.06306306306306306,0.9369369369369369,0.7387387387387387,0.26126126126126126,93,0,15,78,91,2,0.0,0.16129032258064516,0.8387096774193549,0.978494623655914,0.021505376344086023
6581,89,13,76,55,34,0.14606741573033707,0.8539325842696629,0.6179775280898876,0.38202247191011235,108,0,0,108,105,3,0.0,0.0,1.0,0.9722222222222222,0.027777777777777776
6582,166,18,148,114,52,0.10843373493975904,0.891566265060241,0.6867469879518072,0.3132530120481928,149,0,24,125,148,1,0.0,0.1610738255033557,0.8389261744966443,0.9932885906040269,0.006711409395973154
6583,64,10,54,29,35,0.15625,0.84375,0.453125,0.546875,108,0,30,78,108,0,0.0,0.2777777777777778,0.7222222222222222,1.0,0.0
6584,97,5,92,80,17,0.05154639175257732,0.9484536082474226,0.8247422680412371,0.17525773195876287,100,0,18,82,98,2,0.0,0.18,0.82,0.98,0.02
6585,168,20,148,115,53,0.11904761904761904,0.8809523809523809,0.6845238095238095,0.31547619047619047,152,0,24,128,151,1,0.0,0.15789473684210525,0.8421052631578947,0.993421052631579,0.006578947368421052
6586,186,8,178,152,34,0.043010752688172046,0.956989247311828,0.8172043010752689,0.1827956989247312,144,0,25,119,141,3,0.0,0.1736111111111111,0.8263888888888888,0.9791666666666666,0.020833333333333332
6587,57,10,47,25,32,0.17543859649122806,0.8245614035087719,0.43859649122807015,0.5614035087719298,132,0,0,132,130,2,0.0,0.0,1.0,0.9848484848484849,0.015151515151515152
6588,109,5,104,88,21,0.045871559633027525,0.9541284403669725,0.8073394495412844,0.1926605504587156,92,0,14,78,90,2,0.0,0.15217391304347827,0.8478260869565217,0.9782608695652174,0.021739130434782608
6589,81,17,64,36,45,0.20987654320987653,0.7901234567901234,0.4444444444444444,0.5555555555555556,96,0,30,66,96,0,0.0,0.3125,0.6875,1.0,0.0
6590,153,20,133,105,48,0.13071895424836602,0.869281045751634,0.6862745098039216,0.3137254901960784,134,0,24,110,133,1,0.0,0.1791044776119403,0.8208955223880597,0.9925373134328358,0.007462686567164179
6591,124,13,111,85,39,0.10483870967741936,0.8951612903225806,0.6854838709677419,0.31451612903225806,112,0,1,111,108,4,0.0,0.008928571428571428,0.9910714285714286,0.9642857142857143,0.03571428571428571
6592,123,14,109,82,41,0.11382113821138211,0.8861788617886179,0.6666666666666666,0.3333333333333333,115,0,1,114,111,4,0.0,0.008695652173913044,0.991304347826087,0.9652173913043478,0.034782608695652174
6593,40,6,34,31,9,0.15,0.85,0.775,0.225,82,0,12,70,79,3,0.0,0.14634146341463414,0.8536585365853658,0.9634146341463414,0.036585365853658534
6594,86,10,76,55,31,0.11627906976744186,0.8837209302325582,0.6395348837209303,0.36046511627906974,119,0,0,119,116,3,0.0,0.0,1.0,0.9747899159663865,0.025210084033613446
6595,43,9,34,15,28,0.20930232558139536,0.7906976744186046,0.3488372093023256,0.6511627906976745,85,0,30,55,85,0,0.0,0.35294117647058826,0.6470588235294118,1.0,0.0
6596,78,6,72,54,24,0.07692307692307693,0.9230769230769231,0.6923076923076923,0.3076923076923077,69,0,0,69,66,3,0.0,0.0,1.0,0.9565217391304348,0.043478260869565216
6597,59,12,47,26,33,0.2033898305084746,0.7966101694915254,0.4406779661016949,0.559322033898305,135,0,0,135,132,3,0.0,0.0,1.0,0.9777777777777777,0.022222222222222223
6598,104,8,96,74,30,0.07692307692307693,0.9230769230769231,0.7115384615384616,0.28846153846153844,138,0,0,138,134,4,0.0,0.0,1.0,0.9710144927536232,0.028985507246376812
6599,75,11,64,38,37,0.14666666666666667,0.8533333333333334,0.5066666666666667,0.49333333333333335,91,0,31,60,91,0,0.0,0.34065934065934067,0.6593406593406593,1.0,0.0
6600,69,15,54,30,39,0.21739130434782608,0.782608695652174,0.43478260869565216,0.5652173913043478,104,0,30,74,104,0,0.0,0.28846153846153844,0.7115384615384616,1.0,0.0
6601,59,12,47,22,37,0.2033898305084746,0.7966101694915254,0.3728813559322034,0.6271186440677966,134,0,0,134,131,3,0.0,0.0,1.0,0.9776119402985075,0.022388059701492536
6602,47,13,34,17,30,0.2765957446808511,0.723404255319149,0.3617021276595745,0.6382978723404256,88,0,32,56,88,0,0.0,0.36363636363636365,0.6363636363636364,1.0,0.0
6603,63,19,44,27,36,0.30158730158730157,0.6984126984126984,0.42857142857142855,0.5714285714285714,96,0,30,66,96,0,0.0,0.3125,0.6875,1.0,0.0
6604,81,5,76,54,27,0.06172839506172839,0.9382716049382716,0.6666666666666666,0.3333333333333333,116,0,0,116,112,4,0.0,0.0,1.0,0.9655172413793104,0.034482758620689655
6605,124,14,110,79,45,0.11290322580645161,0.8870967741935484,0.6370967741935484,0.3629032258064516,114,0,0,114,110,4,0.0,0.0,1.0,0.9649122807017544,0.03508771929824561
6606,157,14,143,106,51,0.08917197452229299,0.910828025477707,0.6751592356687898,0.3248407643312102,148,0,24,124,147,1,0.0,0.16216216216216217,0.8378378378378378,0.9932432432432432,0.006756756756756757
6607,109,5,104,92,17,0.045871559633027525,0.9541284403669725,0.8440366972477065,0.1559633027522936,82,0,11,71,80,2,0.0,0.13414634146341464,0.8658536585365854,0.975609756097561,0.024390243902439025
6608,74,20,54,32,42,0.2702702702702703,0.7297297297297297,0.43243243243243246,0.5675675675675675,104,0,32,72,104,0,0.0,0.3076923076923077,0.6923076923076923,1.0,0.0
6609,165,17,148,112,53,0.10303030303030303,0.896969696969697,0.6787878787878788,0.3212121212121212,150,0,24,126,149,1,0.0,0.16,0.84,0.9933333333333333,0.006666666666666667
6610,116,8,108,82,34,0.06896551724137931,0.9310344827586207,0.7068965517241379,0.29310344827586204,104,0,1,103,101,3,0.0,0.009615384615384616,0.9903846153846154,0.9711538461538461,0.028846153846153848
6611,132,7,125,97,35,0.05303030303030303,0.946969696969697,0.7348484848484849,0.26515151515151514,103,0,9,94,101,2,0.0,0.08737864077669903,0.912621359223301,0.9805825242718447,0.019417475728155338
6612,109,9,100,67,42,0.08256880733944955,0.9174311926605505,0.6146788990825688,0.3853211009174312,146,0,0,146,142,4,0.0,0.0,1.0,0.9726027397260274,0.0273972602739726
6613,203,22,181,154,49,0.10837438423645321,0.8916256157635468,0.7586206896551724,0.2413793103448276,145,0,26,119,142,3,0.0,0.1793103448275862,0.8206896551724138,0.9793103448275862,0.020689655172413793
6614,190,12,178,151,39,0.06315789473684211,0.9368421052631579,0.7947368421052632,0.20526315789473684,141,0,25,116,138,3,0.0,0.1773049645390071,0.8226950354609929,0.9787234042553191,0.02127659574468085
6615,125,8,117,96,29,0.064,0.936,0.768,0.232,101,0,15,86,99,2,0.0,0.1485148514851485,0.8514851485148515,0.9801980198019802,0.019801980198019802
6616,122,6,116,97,25,0.04918032786885246,0.9508196721311475,0.7950819672131147,0.20491803278688525,93,0,10,83,90,3,0.0,0.10752688172043011,0.8924731182795699,0.967741935483871,0.03225806451612903
6617,130,20,110,86,44,0.15384615384615385,0.8461538461538461,0.6615384615384615,0.3384615384615385,113,0,1,112,110,3,0.0,0.008849557522123894,0.9911504424778761,0.9734513274336283,0.02654867256637168
6618,63,15,48,27,36,0.23809523809523808,0.7619047619047619,0.42857142857142855,0.5714285714285714,150,0,0,150,147,3,0.0,0.0,1.0,0.98,0.02
6619,190,16,174,146,44,0.08421052631578947,0.9157894736842105,0.7684210526315789,0.23157894736842105,136,0,25,111,133,3,0.0,0.18382352941176472,0.8161764705882353,0.9779411764705882,0.022058823529411766
6620,124,14,110,79,45,0.11290322580645161,0.8870967741935484,0.6370967741935484,0.3629032258064516,113,0,1,112,109,4,0.0,0.008849557522123894,0.9911504424778761,0.9646017699115044,0.035398230088495575
6621,107,4,103,90,17,0.037383177570093455,0.9626168224299065,0.8411214953271028,0.1588785046728972,89,0,11,78,87,2,0.0,0.12359550561797752,0.8764044943820225,0.9775280898876404,0.02247191011235955
6622,43,8,35,31,12,0.18604651162790697,0.813953488372093,0.7209302325581395,0.27906976744186046,81,0,14,67,78,3,0.0,0.1728395061728395,0.8271604938271605,0.9629629629629629,0.037037037037037035
6623,122,12,110,85,37,0.09836065573770492,0.9016393442622951,0.6967213114754098,0.30327868852459017,112,0,1,111,108,4,0.0,0.008928571428571428,0.9910714285714286,0.9642857142857143,0.03571428571428571
6624,196,16,180,155,41,0.08163265306122448,0.9183673469387755,0.7908163265306123,0.20918367346938777,133,0,27,106,130,3,0.0,0.20300751879699247,0.7969924812030075,0.9774436090225563,0.022556390977443608
6625,67,4,63,44,23,0.05970149253731343,0.9402985074626866,0.6567164179104478,0.34328358208955223,73,0,0,73,69,4,0.0,0.0,1.0,0.9452054794520548,0.0547945205479452
6626,64,16,48,28,36,0.25,0.75,0.4375,0.5625,154,0,0,154,151,3,0.0,0.0,1.0,0.9805194805194806,0.01948051948051948
6627,119,9,110,74,45,0.07563025210084033,0.9243697478991597,0.6218487394957983,0.37815126050420167,113,0,1,112,109,4,0.0,0.008849557522123894,0.9911504424778761,0.9646017699115044,0.035398230088495575
6628,106,14,92,58,48,0.1320754716981132,0.8679245283018868,0.5471698113207547,0.4528301886792453,138,0,0,138,134,4,0.0,0.0,1.0,0.9710144927536232,0.028985507246376812
6629,117,15,102,70,47,0.1282051282051282,0.8717948717948718,0.5982905982905983,0.4017094017094017,121,0,0,121,118,3,0.0,0.0,1.0,0.9752066115702479,0.024793388429752067
6630,61,14,47,22,39,0.22950819672131148,0.7704918032786885,0.36065573770491804,0.639344262295082,141,0,0,141,139,2,0.0,0.0,1.0,0.9858156028368794,0.014184397163120567
6631,110,11,99,89,21,0.1,0.9,0.8090909090909091,0.19090909090909092,90,0,14,76,88,2,0.0,0.15555555555555556,0.8444444444444444,0.9777777777777777,0.022222222222222223
6632,51,7,44,23,28,0.13725490196078433,0.8627450980392157,0.45098039215686275,0.5490196078431373,108,0,32,76,108,0,0.0,0.2962962962962963,0.7037037037037037,1.0,0.0
6633,72,5,67,53,19,0.06944444444444445,0.9305555555555556,0.7361111111111112,0.2638888888888889,76,0,0,76,72,4,0.0,0.0,1.0,0.9473684210526315,0.05263157894736842
6634,107,7,100,84,23,0.06542056074766354,0.9345794392523364,0.7850467289719626,0.21495327102803738,87,0,13,74,85,2,0.0,0.14942528735632185,0.8505747126436781,0.9770114942528736,0.022988505747126436
6635,121,12,109,94,27,0.09917355371900827,0.9008264462809917,0.7768595041322314,0.2231404958677686,80,0,8,72,78,2,0.0,0.1,0.9,0.975,0.025
6636,114,5,109,83,31,0.043859649122807015,0.956140350877193,0.7280701754385965,0.2719298245614035,114,0,1,113,111,3,0.0,0.008771929824561403,0.9912280701754386,0.9736842105263158,0.02631578947368421
6637,42,8,34,16,26,0.19047619047619047,0.8095238095238095,0.38095238095238093,0.6190476190476191,86,0,30,56,86,0,0.0,0.3488372093023256,0.6511627906976745,1.0,0.0
6638,131,7,124,96,35,0.05343511450381679,0.9465648854961832,0.732824427480916,0.26717557251908397,97,0,9,88,95,2,0.0,0.09278350515463918,0.9072164948453608,0.979381443298969,0.020618556701030927
6639,195,16,179,154,41,0.08205128205128205,0.9179487179487179,0.7897435897435897,0.21025641025641026,144,0,27,117,141,3,0.0,0.1875,0.8125,0.9791666666666666,0.020833333333333332
6640,217,22,195,165,52,0.10138248847926268,0.8986175115207373,0.7603686635944701,0.23963133640552994,154,0,26,128,151,3,0.0,0.16883116883116883,0.8311688311688312,0.9805194805194806,0.01948051948051948
6641,127,9,118,98,29,0.07086614173228346,0.9291338582677166,0.7716535433070866,0.2283464566929134,110,0,17,93,108,2,0.0,0.15454545454545454,0.8454545454545455,0.9818181818181818,0.01818181818181818
6642,120,10,110,81,39,0.08333333333333333,0.9166666666666666,0.675,0.325,111,0,1,110,107,4,0.0,0.009009009009009009,0.990990990990991,0.963963963963964,0.036036036036036036
6643,59,12,47,24,35,0.2033898305084746,0.7966101694915254,0.4067796610169492,0.5932203389830508,147,0,0,147,145,2,0.0,0.0,1.0,0.9863945578231292,0.013605442176870748
6644,195,13,182,157,38,0.06666666666666667,0.9333333333333333,0.8051282051282052,0.19487179487179487,134,0,24,110,131,3,0.0,0.1791044776119403,0.8208955223880597,0.9776119402985075,0.022388059701492536
6645,110,7,103,86,24,0.06363636363636363,0.9363636363636364,0.7818181818181819,0.21818181818181817,86,0,15,71,84,2,0.0,0.1744186046511628,0.8255813953488372,0.9767441860465116,0.023255813953488372
6646,128,7,121,101,27,0.0546875,0.9453125,0.7890625,0.2109375,101,0,12,89,99,2,0.0,0.1188118811881188,0.8811881188118812,0.9801980198019802,0.019801980198019802
6647,78,16,62,37,41,0.20512820512820512,0.7948717948717948,0.47435897435897434,0.5256410256410257,92,0,26,66,92,0,0.0,0.2826086956521739,0.717391304347826,1.0,0.0
6648,89,13,76,58,31,0.14606741573033707,0.8539325842696629,0.651685393258427,0.34831460674157305,98,0,0,98,95,3,0.0,0.0,1.0,0.9693877551020408,0.030612244897959183
6649,118,8,110,85,33,0.06779661016949153,0.9322033898305084,0.7203389830508474,0.2796610169491525,113,0,1,112,109,4,0.0,0.008849557522123894,0.9911504424778761,0.9646017699115044,0.035398230088495575
6650,85,7,78,63,22,0.08235294117647059,0.9176470588235294,0.7411764705882353,0.25882352941176473,84,0,1,83,80,4,0.0,0.011904761904761904,0.9880952380952381,0.9523809523809523,0.047619047619047616
6651,195,13,182,155,40,0.06666666666666667,0.9333333333333333,0.7948717948717948,0.20512820512820512,140,0,26,114,137,3,0.0,0.18571428571428572,0.8142857142857143,0.9785714285714285,0.02142857142857143
6652,123,7,116,98,25,0.056910569105691054,0.943089430894309,0.7967479674796748,0.2032520325203252,104,0,14,90,102,2,0.0,0.1346153846153846,0.8653846153846154,0.9807692307692307,0.019230769230769232
6653,63,15,48,28,35,0.23809523809523808,0.7619047619047619,0.4444444444444444,0.5555555555555556,146,0,0,146,143,3,0.0,0.0,1.0,0.9794520547945206,0.02054794520547945
6654,108,5,103,84,24,0.046296296296296294,0.9537037037037037,0.7777777777777778,0.2222222222222222,84,0,11,73,81,3,0.0,0.13095238095238096,0.8690476190476191,0.9642857142857143,0.03571428571428571
6655,88,12,76,52,36,0.13636363636363635,0.8636363636363636,0.5909090909090909,0.4090909090909091,116,0,0,116,113,3,0.0,0.0,1.0,0.9741379310344828,0.02586206896551724
6656,122,13,109,81,41,0.10655737704918032,0.8934426229508197,0.6639344262295082,0.3360655737704918,115,0,1,114,111,4,0.0,0.008695652173913044,0.991304347826087,0.9652173913043478,0.034782608695652174
6657,91,15,76,52,39,0.16483516483516483,0.8351648351648352,0.5714285714285714,0.42857142857142855,114,0,0,114,111,3,0.0,0.0,1.0,0.9736842105263158,0.02631578947368421
6658,59,11,48,25,34,0.1864406779661017,0.8135593220338984,0.423728813559322,0.576271186440678,141,0,0,141,138,3,0.0,0.0,1.0,0.9787234042553191,0.02127659574468085
6659,121,11,110,83,38,0.09090909090909091,0.9090909090909091,0.6859504132231405,0.3140495867768595,110,0,1,109,106,4,0.0,0.00909090909090909,0.990909090909091,0.9636363636363636,0.03636363636363636
6660,146,13,133,103,43,0.08904109589041095,0.910958904109589,0.7054794520547946,0.2945205479452055,129,0,24,105,128,1,0.0,0.18604651162790697,0.813953488372093,0.9922480620155039,0.007751937984496124
6661,110,15,95,64,46,0.13636363636363635,0.8636363636363636,0.5818181818181818,0.41818181818181815,120,0,0,120,117,3,0.0,0.0,1.0,0.975,0.025
6662,142,125,17,139,3,0.8802816901408451,0.11971830985915492,0.9788732394366197,0.02112676056338028,372,0,34,338,94,278,0.0,0.0913978494623656,0.9086021505376344,0.25268817204301075,0.7473118279569892
6663,108,17,91,60,48,0.1574074074074074,0.8425925925925926,0.5555555555555556,0.4444444444444444,183,0,54,129,180,3,0.0,0.29508196721311475,0.7049180327868853,0.9836065573770492,0.01639344262295082
6664,58,10,48,26,32,0.1724137931034483,0.8275862068965517,0.4482758620689655,0.5517241379310345,133,0,0,133,130,3,0.0,0.0,1.0,0.9774436090225563,0.022556390977443608
6665,57,10,47,27,30,0.17543859649122806,0.8245614035087719,0.47368421052631576,0.5263157894736842,144,0,0,144,141,3,0.0,0.0,1.0,0.9791666666666666,0.020833333333333332
6666,58,10,48,27,31,0.1724137931034483,0.8275862068965517,0.46551724137931033,0.5344827586206896,135,0,0,135,132,3,0.0,0.0,1.0,0.9777777777777777,0.022222222222222223
6667,194,17,177,152,42,0.08762886597938144,0.9123711340206185,0.7835051546391752,0.21649484536082475,143,0,27,116,140,3,0.0,0.1888111888111888,0.8111888111888111,0.9790209790209791,0.02097902097902098
6668,164,16,148,114,50,0.0975609756097561,0.9024390243902439,0.6951219512195121,0.3048780487804878,155,1,24,130,154,1,0.0064516129032258064,0.15483870967741936,0.8387096774193549,0.9935483870967742,0.0064516129032258064
6669,73,19,54,26,47,0.2602739726027397,0.7397260273972602,0.3561643835616438,0.6438356164383562,105,0,30,75,105,0,0.0,0.2857142857142857,0.7142857142857143,1.0,0.0
6670,89,13,76,59,30,0.14606741573033707,0.8539325842696629,0.6629213483146067,0.33707865168539325,106,0,0,106,103,3,0.0,0.0,1.0,0.9716981132075472,0.02830188679245283
6671,62,14,48,26,36,0.22580645161290322,0.7741935483870968,0.41935483870967744,0.5806451612903226,136,0,0,136,133,3,0.0,0.0,1.0,0.9779411764705882,0.022058823529411766
6672,112,6,106,86,26,0.05357142857142857,0.9464285714285714,0.7678571428571429,0.23214285714285715,86,0,13,73,84,2,0.0,0.1511627906976744,0.8488372093023255,0.9767441860465116,0.023255813953488372
6673,124,13,111,75,49,0.10483870967741936,0.8951612903225806,0.6048387096774194,0.3951612903225806,106,0,2,104,103,3,0.0,0.018867924528301886,0.9811320754716981,0.9716981132075472,0.02830188679245283
6674,112,6,106,93,19,0.05357142857142857,0.9464285714285714,0.8303571428571429,0.16964285714285715,86,0,10,76,84,2,0.0,0.11627906976744186,0.8837209302325582,0.9767441860465116,0.023255813953488372
6675,87,20,67,39,48,0.22988505747126436,0.7701149425287356,0.4482758620689655,0.5517241379310345,98,0,30,68,98,0,0.0,0.30612244897959184,0.6938775510204082,1.0,0.0
6676,105,6,99,76,29,0.05714285714285714,0.9428571428571428,0.7238095238095238,0.2761904761904762,97,0,18,79,95,2,0.0,0.18556701030927836,0.8144329896907216,0.979381443298969,0.020618556701030927
6677,112,4,108,89,23,0.03571428571428571,0.9642857142857143,0.7946428571428571,0.20535714285714285,88,0,13,75,86,2,0.0,0.14772727272727273,0.8522727272727273,0.9772727272727273,0.022727272727272728
6678,102,5,97,81,21,0.049019607843137254,0.9509803921568627,0.7941176470588235,0.20588235294117646,96,0,15,81,94,2,0.0,0.15625,0.84375,0.9791666666666666,0.020833333333333332
6679,117,13,104,70,47,0.1111111111111111,0.8888888888888888,0.5982905982905983,0.4017094017094017,121,0,0,121,118,3,0.0,0.0,1.0,0.9752066115702479,0.024793388429752067
6680,120,10,110,80,40,0.08333333333333333,0.9166666666666666,0.6666666666666666,0.3333333333333333,102,0,1,101,99,3,0.0,0.00980392156862745,0.9901960784313726,0.9705882352941176,0.029411764705882353
6681,114,19,95,69,45,0.16666666666666666,0.8333333333333334,0.6052631578947368,0.39473684210526316,112,0,0,112,109,3,0.0,0.0,1.0,0.9732142857142857,0.026785714285714284
6682,158,15,143,111,47,0.0949367088607595,0.9050632911392406,0.7025316455696202,0.2974683544303797,152,0,24,128,151,1,0.0,0.15789473684210525,0.8421052631578947,0.993421052631579,0.006578947368421052
6683,56,9,47,27,29,0.16071428571428573,0.8392857142857143,0.48214285714285715,0.5178571428571429,140,0,0,140,137,3,0.0,0.0,1.0,0.9785714285714285,0.02142857142857143
6684,75,21,54,27,48,0.28,0.72,0.36,0.64,108,0,31,77,108,0,0.0,0.28703703703703703,0.7129629629629629,1.0,0.0
6685,110,7,103,90,20,0.06363636363636363,0.9363636363636364,0.8181818181818182,0.18181818181818182,82,0,9,73,80,2,0.0,0.10975609756097561,0.8902439024390244,0.975609756097561,0.024390243902439025
6686,145,12,133,103,42,0.08275862068965517,0.9172413793103448,0.7103448275862069,0.2896551724137931,131,0,24,107,130,1,0.0,0.183206106870229,0.816793893129771,0.9923664122137404,0.007633587786259542
6687,88,12,76,53,35,0.13636363636363635,0.8636363636363636,0.6022727272727273,0.3977272727272727,109,0,0,109,105,4,0.0,0.0,1.0,0.963302752293578,0.03669724770642202
6688,125,14,111,87,38,0.112,0.888,0.696,0.304,106,0,2,104,102,4,0.0,0.018867924528301886,0.9811320754716981,0.9622641509433962,0.03773584905660377
6689,117,8,109,94,23,0.06837606837606838,0.9316239316239316,0.8034188034188035,0.19658119658119658,86,0,9,77,84,2,0.0,0.10465116279069768,0.8953488372093024,0.9767441860465116,0.023255813953488372
6690,198,18,180,154,44,0.09090909090909091,0.9090909090909091,0.7777777777777778,0.2222222222222222,136,0,26,110,133,3,0.0,0.19117647058823528,0.8088235294117647,0.9779411764705882,0.022058823529411766
6691,115,8,107,94,21,0.06956521739130435,0.9304347826086956,0.8173913043478261,0.1826086956521739,89,0,10,79,87,2,0.0,0.11235955056179775,0.8876404494382022,0.9775280898876404,0.02247191011235955
6692,85,22,63,37,48,0.25882352941176473,0.7411764705882353,0.43529411764705883,0.5647058823529412,89,0,32,57,89,0,0.0,0.3595505617977528,0.6404494382022472,1.0,0.0
6693,195,12,183,158,37,0.06153846153846154,0.9384615384615385,0.8102564102564103,0.18974358974358974,146,0,27,119,144,2,0.0,0.18493150684931506,0.815068493150685,0.9863013698630136,0.0136986301369863
6694,87,7,80,66,21,0.08045977011494253,0.9195402298850575,0.7586206896551724,0.2413793103448276,81,0,1,80,77,4,0.0,0.012345679012345678,0.9876543209876543,0.9506172839506173,0.04938271604938271
6695,39,6,33,31,8,0.15384615384615385,0.8461538461538461,0.7948717948717948,0.20512820512820512,85,0,14,71,82,3,0.0,0.16470588235294117,0.8352941176470589,0.9647058823529412,0.03529411764705882
6696,122,12,110,76,46,0.09836065573770492,0.9016393442622951,0.6229508196721312,0.3770491803278688,103,0,1,102,99,4,0.0,0.009708737864077669,0.9902912621359223,0.9611650485436893,0.038834951456310676
6697,210,14,196,165,45,0.06666666666666667,0.9333333333333333,0.7857142857142857,0.21428571428571427,142,0,24,118,139,3,0.0,0.16901408450704225,0.8309859154929577,0.9788732394366197,0.02112676056338028
6698,95,19,76,56,39,0.2,0.8,0.5894736842105263,0.4105263157894737,115,0,0,115,113,2,0.0,0.0,1.0,0.9826086956521739,0.017391304347826087
6699,108,12,96,60,48,0.1111111111111111,0.8888888888888888,0.5555555555555556,0.4444444444444444,124,0,0,124,122,2,0.0,0.0,1.0,0.9838709677419355,0.016129032258064516
6700,61,14,47,28,33,0.22950819672131148,0.7704918032786885,0.45901639344262296,0.5409836065573771,130,0,0,130,128,2,0.0,0.0,1.0,0.9846153846153847,0.015384615384615385
6701,127,17,110,79,48,0.13385826771653545,0.8661417322834646,0.6220472440944882,0.3779527559055118,107,0,1,106,103,4,0.0,0.009345794392523364,0.9906542056074766,0.9626168224299065,0.037383177570093455
6702,122,13,109,78,44,0.10655737704918032,0.8934426229508197,0.639344262295082,0.36065573770491804,112,0,1,111,108,4,0.0,0.008928571428571428,0.9910714285714286,0.9642857142857143,0.03571428571428571
6703,66,19,47,23,43,0.2878787878787879,0.7121212121212122,0.3484848484848485,0.6515151515151515,130,0,0,130,127,3,0.0,0.0,1.0,0.9769230769230769,0.023076923076923078
6704,88,12,76,55,33,0.13636363636363635,0.8636363636363636,0.625,0.375,104,0,0,104,101,3,0.0,0.0,1.0,0.9711538461538461,0.028846153846153848
6705,199,19,180,156,43,0.09547738693467336,0.9045226130653267,0.7839195979899497,0.21608040201005024,149,0,25,124,146,3,0.0,0.16778523489932887,0.8322147651006712,0.9798657718120806,0.020134228187919462
6706,91,15,76,53,38,0.16483516483516483,0.8351648351648352,0.5824175824175825,0.4175824175824176,109,0,0,109,106,3,0.0,0.0,1.0,0.9724770642201835,0.027522935779816515
6707,108,17,91,66,42,0.1574074074074074,0.8425925925925926,0.6111111111111112,0.3888888888888889,193,0,54,139,189,4,0.0,0.27979274611398963,0.7202072538860104,0.9792746113989638,0.02072538860103627
6708,127,17,110,79,48,0.13385826771653545,0.8661417322834646,0.6220472440944882,0.3779527559055118,123,0,1,122,119,4,0.0,0.008130081300813009,0.991869918699187,0.967479674796748,0.032520325203252036
6709,60,13,47,26,34,0.21666666666666667,0.7833333333333333,0.43333333333333335,0.5666666666666667,139,0,0,139,136,3,0.0,0.0,1.0,0.9784172661870504,0.02158273381294964
6710,84,19,65,42,42,0.2261904761904762,0.7738095238095238,0.5,0.5,90,0,30,60,90,0,0.0,0.3333333333333333,0.6666666666666666,1.0,0.0
6711,88,12,76,56,32,0.13636363636363635,0.8636363636363636,0.6363636363636364,0.36363636363636365,108,0,0,108,105,3,0.0,0.0,1.0,0.9722222222222222,0.027777777777777776
6712,64,16,48,31,33,0.25,0.75,0.484375,0.515625,141,0,0,141,139,2,0.0,0.0,1.0,0.9858156028368794,0.014184397163120567
6713,85,9,76,53,32,0.10588235294117647,0.8941176470588236,0.6235294117647059,0.3764705882352941,113,0,0,113,109,4,0.0,0.0,1.0,0.9646017699115044,0.035398230088495575
6714,219,20,199,166,53,0.091324200913242,0.908675799086758,0.7579908675799086,0.2420091324200913,133,0,24,109,130,3,0.0,0.18045112781954886,0.8195488721804511,0.9774436090225563,0.022556390977443608
6715,115,13,102,70,45,0.11304347826086956,0.8869565217391304,0.6086956521739131,0.391304347826087,126,0,0,126,122,4,0.0,0.0,1.0,0.9682539682539683,0.031746031746031744
6716,84,8,76,57,27,0.09523809523809523,0.9047619047619048,0.6785714285714286,0.32142857142857145,104,0,0,104,100,4,0.0,0.0,1.0,0.9615384615384616,0.038461538461538464
6717,125,16,109,79,46,0.128,0.872,0.632,0.368,112,0,1,111,108,4,0.0,0.008928571428571428,0.9910714285714286,0.9642857142857143,0.03571428571428571
6718,126,16,110,83,43,0.12698412698412698,0.873015873015873,0.6587301587301587,0.3412698412698413,110,0,1,109,106,4,0.0,0.00909090909090909,0.990909090909091,0.9636363636363636,0.03636363636363636
6719,78,6,72,56,22,0.07692307692307693,0.9230769230769231,0.717948717948718,0.28205128205128205,83,0,1,82,79,4,0.0,0.012048192771084338,0.9879518072289156,0.9518072289156626,0.04819277108433735
6720,64,20,44,22,42,0.3125,0.6875,0.34375,0.65625,107,0,30,77,107,0,0.0,0.2803738317757009,0.719626168224299,1.0,0.0
6721,64,17,47,27,37,0.265625,0.734375,0.421875,0.578125,138,0,0,138,135,3,0.0,0.0,1.0,0.9782608695652174,0.021739130434782608
6722,92,16,76,56,36,0.17391304347826086,0.8260869565217391,0.6086956521739131,0.391304347826087,101,0,0,101,98,3,0.0,0.0,1.0,0.9702970297029703,0.0297029702970297
6723,107,16,91,61,46,0.14953271028037382,0.8504672897196262,0.5700934579439252,0.42990654205607476,177,1,54,122,174,3,0.005649717514124294,0.3050847457627119,0.6892655367231638,0.9830508474576272,0.01694915254237288
6724,121,11,110,82,39,0.09090909090909091,0.9090909090909091,0.6776859504132231,0.32231404958677684,111,0,1,110,107,4,0.0,0.009009009009009009,0.990990990990991,0.963963963963964,0.036036036036036036
6725,117,26,91,60,57,0.2222222222222222,0.7777777777777778,0.5128205128205128,0.48717948717948717,186,1,54,131,184,2,0.005376344086021506,0.2903225806451613,0.7043010752688172,0.989247311827957,0.010752688172043012
6726,124,15,109,83,41,0.12096774193548387,0.8790322580645161,0.6693548387096774,0.33064516129032256,111,0,1,110,108,3,0.0,0.009009009009009009,0.990990990990991,0.972972972972973,0.02702702702702703
6727,76,12,64,40,36,0.15789473684210525,0.8421052631578947,0.5263157894736842,0.47368421052631576,91,0,30,61,91,0,0.0,0.32967032967032966,0.6703296703296703,1.0,0.0
6728,200,22,178,154,46,0.11,0.89,0.77,0.23,136,0,26,110,133,3,0.0,0.19117647058823528,0.8088235294117647,0.9779411764705882,0.022058823529411766
6729,113,5,108,94,19,0.04424778761061947,0.9557522123893806,0.831858407079646,0.168141592920354,77,0,10,67,75,2,0.0,0.12987012987012986,0.8701298701298701,0.974025974025974,0.025974025974025976
6730,88,7,81,58,30,0.07954545454545454,0.9204545454545454,0.6590909090909091,0.3409090909090909,71,0,1,70,67,4,0.0,0.014084507042253521,0.9859154929577465,0.9436619718309859,0.056338028169014086
6731,122,8,114,99,23,0.06557377049180328,0.9344262295081968,0.8114754098360656,0.1885245901639344,108,0,17,91,106,2,0.0,0.1574074074074074,0.8425925925925926,0.9814814814814815,0.018518518518518517
6732,121,11,110,84,37,0.09090909090909091,0.9090909090909091,0.6942148760330579,0.30578512396694213,99,0,1,98,95,4,0.0,0.010101010101010102,0.98989898989899,0.9595959595959596,0.04040404040404041
6733,191,14,177,151,40,0.07329842931937172,0.9267015706806283,0.7905759162303665,0.2094240837696335,130,0,26,104,127,3,0.0,0.2,0.8,0.9769230769230769,0.023076923076923078
6734,107,12,95,69,38,0.11214953271028037,0.8878504672897196,0.6448598130841121,0.35514018691588783,121,0,1,120,117,4,0.0,0.008264462809917356,0.9917355371900827,0.9669421487603306,0.03305785123966942
6735,53,9,44,23,30,0.16981132075471697,0.8301886792452831,0.4339622641509434,0.5660377358490566,85,0,30,55,85,0,0.0,0.35294117647058826,0.6470588235294118,1.0,0.0
6736,115,13,102,70,45,0.11304347826086956,0.8869565217391304,0.6086956521739131,0.391304347826087,116,0,0,116,112,4,0.0,0.0,1.0,0.9655172413793104,0.034482758620689655
6737,57,10,47,25,32,0.17543859649122806,0.8245614035087719,0.43859649122807015,0.5614035087719298,140,0,0,140,137,3,0.0,0.0,1.0,0.9785714285714285,0.02142857142857143
6738,108,8,100,86,22,0.07407407407407407,0.9259259259259259,0.7962962962962963,0.2037037037037037,91,0,11,80,89,2,0.0,0.12087912087912088,0.8791208791208791,0.978021978021978,0.02197802197802198
6739,158,15,143,116,42,0.0949367088607595,0.9050632911392406,0.7341772151898734,0.26582278481012656,144,0,24,120,143,1,0.0,0.16666666666666666,0.8333333333333334,0.9930555555555556,0.006944444444444444
6740,114,14,100,75,39,0.12280701754385964,0.8771929824561403,0.6578947368421053,0.34210526315789475,124,0,0,124,121,3,0.0,0.0,1.0,0.9758064516129032,0.024193548387096774
6741,41,8,33,30,11,0.1951219512195122,0.8048780487804879,0.7317073170731707,0.2682926829268293,92,0,21,71,89,3,0.0,0.22826086956521738,0.7717391304347826,0.967391304347826,0.03260869565217391
6742,120,11,109,80,40,0.09166666666666666,0.9083333333333333,0.6666666666666666,0.3333333333333333,111,0,1,110,107,4,0.0,0.009009009009009009,0.990990990990991,0.963963963963964,0.036036036036036036
6743,63,15,48,26,37,0.23809523809523808,0.7619047619047619,0.4126984126984127,0.5873015873015873,148,0,0,148,145,3,0.0,0.0,1.0,0.9797297297297297,0.02027027027027027
6744,88,12,76,55,33,0.13636363636363635,0.8636363636363636,0.625,0.375,115,0,0,115,112,3,0.0,0.0,1.0,0.9739130434782609,0.02608695652173913
6745,115,15,100,69,46,0.13043478260869565,0.8695652173913043,0.6,0.4,136,0,0,136,132,4,0.0,0.0,1.0,0.9705882352941176,0.029411764705882353
6746,67,13,54,28,39,0.19402985074626866,0.8059701492537313,0.417910447761194,0.582089552238806,90,0,30,60,90,0,0.0,0.3333333333333333,0.6666666666666666,1.0,0.0
6747,85,6,79,64,21,0.07058823529411765,0.9294117647058824,0.7529411764705882,0.24705882352941178,86,0,1,85,82,4,0.0,0.011627906976744186,0.9883720930232558,0.9534883720930233,0.046511627906976744
6748,38,5,33,29,9,0.13157894736842105,0.868421052631579,0.7631578947368421,0.23684210526315788,88,0,17,71,85,3,0.0,0.19318181818181818,0.8068181818181818,0.9659090909090909,0.03409090909090909
6749,124,14,110,79,45,0.11290322580645161,0.8870967741935484,0.6370967741935484,0.3629032258064516,117,0,1,116,113,4,0.0,0.008547008547008548,0.9914529914529915,0.9658119658119658,0.03418803418803419
6750,113,22,91,55,58,0.19469026548672566,0.8053097345132744,0.48672566371681414,0.5132743362831859,176,0,54,122,173,3,0.0,0.3068181818181818,0.6931818181818182,0.9829545454545454,0.017045454545454544
6751,84,19,65,38,46,0.2261904761904762,0.7738095238095238,0.4523809523809524,0.5476190476190477,102,0,28,74,102,0,0.0,0.27450980392156865,0.7254901960784313,1.0,0.0
6752,121,15,106,74,47,0.12396694214876033,0.8760330578512396,0.6115702479338843,0.3884297520661157,111,0,1,110,107,4,0.0,0.009009009009009009,0.990990990990991,0.963963963963964,0.036036036036036036
6753,79,7,72,52,27,0.08860759493670886,0.9113924050632911,0.6582278481012658,0.34177215189873417,74,0,1,73,71,3,0.0,0.013513513513513514,0.9864864864864865,0.9594594594594594,0.04054054054054054
6754,147,15,132,108,39,0.10204081632653061,0.8979591836734694,0.7346938775510204,0.2653061224489796,139,0,24,115,138,1,0.0,0.17266187050359713,0.8273381294964028,0.9928057553956835,0.007194244604316547
6755,66,12,54,26,40,0.18181818181818182,0.8181818181818182,0.3939393939393939,0.6060606060606061,93,0,30,63,93,0,0.0,0.3225806451612903,0.6774193548387096,1.0,0.0
6756,200,19,181,152,48,0.095,0.905,0.76,0.24,149,0,25,124,146,3,0.0,0.16778523489932887,0.8322147651006712,0.9798657718120806,0.020134228187919462
6757,82,4,78,56,26,0.04878048780487805,0.9512195121951219,0.6829268292682927,0.3170731707317073,87,0,1,86,83,4,0.0,0.011494252873563218,0.9885057471264368,0.9540229885057471,0.04597701149425287
6758,119,9,110,78,41,0.07563025210084033,0.9243697478991597,0.6554621848739496,0.3445378151260504,108,0,1,107,105,3,0.0,0.009259259259259259,0.9907407407407407,0.9722222222222222,0.027777777777777776
6759,87,11,76,54,33,0.12643678160919541,0.8735632183908046,0.6206896551724138,0.3793103448275862,113,0,0,113,109,4,0.0,0.0,1.0,0.9646017699115044,0.035398230088495575
6760,59,12,47,26,33,0.2033898305084746,0.7966101694915254,0.4406779661016949,0.559322033898305,138,0,0,138,136,2,0.0,0.0,1.0,0.9855072463768116,0.014492753623188406
6761,90,14,76,53,37,0.15555555555555556,0.8444444444444444,0.5888888888888889,0.4111111111111111,105,0,0,105,102,3,0.0,0.0,1.0,0.9714285714285714,0.02857142857142857
6762,157,14,143,114,43,0.08917197452229299,0.910828025477707,0.7261146496815286,0.27388535031847133,144,0,24,120,143,1,0.0,0.16666666666666666,0.8333333333333334,0.9930555555555556,0.006944444444444444
6763,194,16,178,148,46,0.08247422680412371,0.9175257731958762,0.7628865979381443,0.23711340206185566,141,0,25,116,139,2,0.0,0.1773049645390071,0.8226950354609929,0.9858156028368794,0.014184397163120567
6764,63,16,47,23,40,0.25396825396825395,0.746031746031746,0.36507936507936506,0.6349206349206349,139,0,0,139,136,3,0.0,0.0,1.0,0.9784172661870504,0.02158273381294964
6765,119,13,106,82,37,0.1092436974789916,0.8907563025210085,0.6890756302521008,0.31092436974789917,115,0,0,115,111,4,0.0,0.0,1.0,0.9652173913043478,0.034782608695652174
6766,77,12,65,44,33,0.15584415584415584,0.8441558441558441,0.5714285714285714,0.42857142857142855,95,0,28,67,95,0,0.0,0.29473684210526313,0.7052631578947368,1.0,0.0
6767,88,9,79,62,26,0.10227272727272728,0.8977272727272727,0.7045454545454546,0.29545454545454547,84,0,1,83,80,4,0.0,0.011904761904761904,0.9880952380952381,0.9523809523809523,0.047619047619047616
6768,90,14,76,57,33,0.15555555555555556,0.8444444444444444,0.6333333333333333,0.36666666666666664,122,0,0,122,118,4,0.0,0.0,1.0,0.9672131147540983,0.03278688524590164
6769,92,16,76,56,36,0.17391304347826086,0.8260869565217391,0.6086956521739131,0.391304347826087,117,0,0,117,113,4,0.0,0.0,1.0,0.9658119658119658,0.03418803418803419
6770,125,11,114,94,31,0.088,0.912,0.752,0.248,90,0,9,81,88,2,0.0,0.1,0.9,0.9777777777777777,0.022222222222222223
6771,57,10,47,27,30,0.17543859649122806,0.8245614035087719,0.47368421052631576,0.5263157894736842,134,0,0,134,131,3,0.0,0.0,1.0,0.9776119402985075,0.022388059701492536
6772,47,13,34,20,27,0.2765957446808511,0.723404255319149,0.425531914893617,0.574468085106383,78,0,26,52,78,0,0.0,0.3333333333333333,0.6666666666666666,1.0,0.0
6773,84,12,72,57,27,0.14285714285714285,0.8571428571428571,0.6785714285714286,0.32142857142857145,89,0,1,88,85,4,0.0,0.011235955056179775,0.9887640449438202,0.9550561797752809,0.0449438202247191
6774,129,19,110,78,51,0.14728682170542637,0.8527131782945736,0.6046511627906976,0.3953488372093023,104,0,1,103,100,4,0.0,0.009615384615384616,0.9903846153846154,0.9615384615384616,0.038461538461538464
6775,119,10,109,84,35,0.08403361344537816,0.9159663865546218,0.7058823529411765,0.29411764705882354,107,0,1,106,103,4,0.0,0.009345794392523364,0.9906542056074766,0.9626168224299065,0.037383177570093455
6776,87,11,76,53,34,0.12643678160919541,0.8735632183908046,0.6091954022988506,0.39080459770114945,111,0,0,111,108,3,0.0,0.0,1.0,0.972972972972973,0.02702702702702703
6777,67,13,54,30,37,0.19402985074626866,0.8059701492537313,0.44776119402985076,0.5522388059701493,111,0,30,81,111,0,0.0,0.2702702702702703,0.7297297297297297,1.0,0.0
6778,87,13,74,51,36,0.14942528735632185,0.8505747126436781,0.5862068965517241,0.41379310344827586,117,0,0,117,113,4,0.0,0.0,1.0,0.9658119658119658,0.03418803418803419
6779,126,16,110,80,46,0.12698412698412698,0.873015873015873,0.6349206349206349,0.36507936507936506,121,0,1,120,117,4,0.0,0.008264462809917356,0.9917355371900827,0.9669421487603306,0.03305785123966942
6780,109,18,91,54,55,0.1651376146788991,0.8348623853211009,0.4954128440366973,0.5045871559633027,178,0,54,124,174,4,0.0,0.30337078651685395,0.6966292134831461,0.9775280898876404,0.02247191011235955
6781,90,14,76,55,35,0.15555555555555556,0.8444444444444444,0.6111111111111112,0.3888888888888889,84,0,1,83,81,3,0.0,0.011904761904761904,0.9880952380952381,0.9642857142857143,0.03571428571428571
6782,124,14,110,82,42,0.11290322580645161,0.8870967741935484,0.6612903225806451,0.3387096774193548,105,0,1,104,101,4,0.0,0.009523809523809525,0.9904761904761905,0.9619047619047619,0.0380952380952381
6783,104,6,98,90,14,0.057692307692307696,0.9423076923076923,0.8653846153846154,0.1346153846153846,94,0,12,82,91,3,0.0,0.1276595744680851,0.8723404255319149,0.9680851063829787,0.031914893617021274
6784,119,13,106,74,45,0.1092436974789916,0.8907563025210085,0.6218487394957983,0.37815126050420167,112,0,1,111,109,3,0.0,0.008928571428571428,0.9910714285714286,0.9732142857142857,0.026785714285714284
6785,89,13,76,55,34,0.14606741573033707,0.8539325842696629,0.6179775280898876,0.38202247191011235,110,0,0,110,107,3,0.0,0.0,1.0,0.9727272727272728,0.02727272727272727
6786,130,20,110,79,51,0.15384615384615385,0.8461538461538461,0.6076923076923076,0.3923076923076923,107,0,1,106,103,4,0.0,0.009345794392523364,0.9906542056074766,0.9626168224299065,0.037383177570093455
6787,122,12,110,82,40,0.09836065573770492,0.9016393442622951,0.6721311475409836,0.32786885245901637,108,0,1,107,104,4,0.0,0.009259259259259259,0.9907407407407407,0.9629629629629629,0.037037037037037035
6788,65,18,47,26,39,0.27692307692307694,0.7230769230769231,0.4,0.6,127,0,0,127,124,3,0.0,0.0,1.0,0.9763779527559056,0.023622047244094488
6789,44,10,34,16,28,0.22727272727272727,0.7727272727272727,0.36363636363636365,0.6363636363636364,83,0,30,53,83,0,0.0,0.3614457831325301,0.6385542168674698,1.0,0.0
6790,187,7,180,152,35,0.0374331550802139,0.9625668449197861,0.8128342245989305,0.18716577540106952,137,0,26,111,134,3,0.0,0.1897810218978102,0.8102189781021898,0.9781021897810219,0.021897810218978103
6791,200,21,179,155,45,0.105,0.895,0.775,0.225,144,0,27,117,142,2,0.0,0.1875,0.8125,0.9861111111111112,0.013888888888888888
6792,113,16,97,73,40,0.1415929203539823,0.8584070796460177,0.6460176991150443,0.35398230088495575,109,0,0,109,106,3,0.0,0.0,1.0,0.9724770642201835,0.027522935779816515
6793,126,16,110,82,44,0.12698412698412698,0.873015873015873,0.6507936507936508,0.3492063492063492,106,0,1,105,102,4,0.0,0.009433962264150943,0.9905660377358491,0.9622641509433962,0.03773584905660377
6794,58,10,48,22,36,0.1724137931034483,0.8275862068965517,0.3793103448275862,0.6206896551724138,134,0,0,134,131,3,0.0,0.0,1.0,0.9776119402985075,0.022388059701492536
6795,45,11,34,19,26,0.24444444444444444,0.7555555555555555,0.4222222222222222,0.5777777777777777,85,0,30,55,85,0,0.0,0.35294117647058826,0.6470588235294118,1.0,0.0
6796,105,13,92,58,47,0.12380952380952381,0.8761904761904762,0.5523809523809524,0.44761904761904764,136,0,0,136,134,2,0.0,0.0,1.0,0.9852941176470589,0.014705882352941176
6797,126,16,110,78,48,0.12698412698412698,0.873015873015873,0.6190476190476191,0.38095238095238093,116,0,1,115,112,4,0.0,0.008620689655172414,0.9913793103448276,0.9655172413793104,0.034482758620689655
6798,89,13,76,52,37,0.14606741573033707,0.8539325842696629,0.5842696629213483,0.4157303370786517,109,0,0,109,106,3,0.0,0.0,1.0,0.9724770642201835,0.027522935779816515
6799,126,16,110,86,40,0.12698412698412698,0.873015873015873,0.6825396825396826,0.31746031746031744,113,0,1,112,109,4,0.0,0.008849557522123894,0.9911504424778761,0.9646017699115044,0.035398230088495575
6800,123,13,110,76,47,0.10569105691056911,0.8943089430894309,0.6178861788617886,0.3821138211382114,106,0,2,104,102,4,0.0,0.018867924528301886,0.9811320754716981,0.9622641509433962,0.03773584905660377
6801,107,4,103,91,16,0.037383177570093455,0.9626168224299065,0.8504672897196262,0.14953271028037382,91,0,14,77,89,2,0.0,0.15384615384615385,0.8461538461538461,0.978021978021978,0.02197802197802198
6802,106,7,99,84,22,0.0660377358490566,0.9339622641509434,0.7924528301886793,0.20754716981132076,83,0,10,73,81,2,0.0,0.12048192771084337,0.8795180722891566,0.9759036144578314,0.024096385542168676
6803,125,15,110,76,49,0.12,0.88,0.608,0.392,113,0,1,112,109,4,0.0,0.008849557522123894,0.9911504424778761,0.9646017699115044,0.035398230088495575
6804,125,16,109,76,49,0.128,0.872,0.608,0.392,110,0,1,109,106,4,0.0,0.00909090909090909,0.990909090909091,0.9636363636363636,0.03636363636363636
6805,90,14,76,55,35,0.15555555555555556,0.8444444444444444,0.6111111111111112,0.3888888888888889,112,0,0,112,109,3,0.0,0.0,1.0,0.9732142857142857,0.026785714285714284
6806,126,16,110,80,46,0.12698412698412698,0.873015873015873,0.6349206349206349,0.36507936507936506,111,0,1,110,108,3,0.0,0.009009009009009009,0.990990990990991,0.972972972972973,0.02702702702702703
6807,87,11,76,56,31,0.12643678160919541,0.8735632183908046,0.6436781609195402,0.3563218390804598,103,0,0,103,100,3,0.0,0.0,1.0,0.970873786407767,0.02912621359223301
6808,57,10,47,23,34,0.17543859649122806,0.8245614035087719,0.40350877192982454,0.5964912280701754,140,0,0,140,137,3,0.0,0.0,1.0,0.9785714285714285,0.02142857142857143
6809,66,12,54,27,39,0.18181818181818182,0.8181818181818182,0.4090909090909091,0.5909090909090909,104,0,30,74,104,0,0.0,0.28846153846153844,0.7115384615384616,1.0,0.0
6810,161,13,148,118,43,0.08074534161490683,0.9192546583850931,0.7329192546583851,0.2670807453416149,136,0,24,112,135,1,0.0,0.17647058823529413,0.8235294117647058,0.9926470588235294,0.007352941176470588
6811,200,21,179,154,46,0.105,0.895,0.77,0.23,136,0,25,111,133,3,0.0,0.18382352941176472,0.8161764705882353,0.9779411764705882,0.022058823529411766
6812,91,10,81,62,29,0.10989010989010989,0.8901098901098901,0.6813186813186813,0.31868131868131866,83,0,1,82,80,3,0.0,0.012048192771084338,0.9879518072289156,0.963855421686747,0.03614457831325301
6813,87,11,76,54,33,0.12643678160919541,0.8735632183908046,0.6206896551724138,0.3793103448275862,98,0,0,98,94,4,0.0,0.0,1.0,0.9591836734693877,0.04081632653061224
6814,122,11,111,83,39,0.09016393442622951,0.9098360655737705,0.680327868852459,0.319672131147541,114,0,2,112,110,4,0.0,0.017543859649122806,0.9824561403508771,0.9649122807017544,0.03508771929824561
6815,149,16,133,107,42,0.10738255033557047,0.8926174496644296,0.7181208053691275,0.28187919463087246,131,0,24,107,130,1,0.0,0.183206106870229,0.816793893129771,0.9923664122137404,0.007633587786259542
6816,94,18,76,54,40,0.19148936170212766,0.8085106382978723,0.574468085106383,0.425531914893617,112,0,0,112,109,3,0.0,0.0,1.0,0.9732142857142857,0.026785714285714284
6817,56,12,44,21,35,0.21428571428571427,0.7857142857142857,0.375,0.625,80,0,32,48,80,0,0.0,0.4,0.6,1.0,0.0
6818,37,4,33,31,6,0.10810810810810811,0.8918918918918919,0.8378378378378378,0.16216216216216217,92,0,20,72,89,3,0.0,0.21739130434782608,0.782608695652174,0.967391304347826,0.03260869565217391
6819,60,13,47,27,33,0.21666666666666667,0.7833333333333333,0.45,0.55,143,0,0,143,140,3,0.0,0.0,1.0,0.9790209790209791,0.02097902097902098
6820,125,14,111,80,45,0.112,0.888,0.64,0.36,106,0,2,104,102,4,0.0,0.018867924528301886,0.9811320754716981,0.9622641509433962,0.03773584905660377
6821,168,20,148,114,54,0.11904761904761904,0.8809523809523809,0.6785714285714286,0.32142857142857145,142,0,24,118,141,1,0.0,0.16901408450704225,0.8309859154929577,0.9929577464788732,0.007042253521126761
6822,124,14,110,81,43,0.11290322580645161,0.8870967741935484,0.6532258064516129,0.3467741935483871,104,0,1,103,101,3,0.0,0.009615384615384616,0.9903846153846154,0.9711538461538461,0.028846153846153848
6823,77,13,64,37,40,0.16883116883116883,0.8311688311688312,0.4805194805194805,0.5194805194805194,91,0,30,61,91,0,0.0,0.32967032967032966,0.6703296703296703,1.0,0.0
6824,126,16,110,78,48,0.12698412698412698,0.873015873015873,0.6190476190476191,0.38095238095238093,114,0,1,113,111,3,0.0,0.008771929824561403,0.9912280701754386,0.9736842105263158,0.02631578947368421
6825,121,11,110,77,44,0.09090909090909091,0.9090909090909091,0.6363636363636364,0.36363636363636365,109,0,1,108,105,4,0.0,0.009174311926605505,0.9908256880733946,0.963302752293578,0.03669724770642202
6826,112,7,105,85,27,0.0625,0.9375,0.7589285714285714,0.24107142857142858,83,0,11,72,81,2,0.0,0.13253012048192772,0.8674698795180723,0.9759036144578314,0.024096385542168676
6827,60,12,48,26,34,0.2,0.8,0.43333333333333335,0.5666666666666667,141,0,0,141,138,3,0.0,0.0,1.0,0.9787234042553191,0.02127659574468085
6828,130,19,111,81,49,0.14615384615384616,0.8538461538461538,0.6230769230769231,0.3769230769230769,112,0,2,110,108,4,0.0,0.017857142857142856,0.9821428571428571,0.9642857142857143,0.03571428571428571
6829,200,19,181,157,43,0.095,0.905,0.785,0.215,133,0,28,105,130,3,0.0,0.21052631578947367,0.7894736842105263,0.9774436090225563,0.022556390977443608
6830,128,11,117,97,31,0.0859375,0.9140625,0.7578125,0.2421875,104,0,14,90,102,2,0.0,0.1346153846153846,0.8653846153846154,0.9807692307692307,0.019230769230769232
6831,119,20,99,70,49,0.16806722689075632,0.8319327731092437,0.5882352941176471,0.4117647058823529,120,0,0,120,117,3,0.0,0.0,1.0,0.975,0.025
6832,127,17,110,81,46,0.13385826771653545,0.8661417322834646,0.6377952755905512,0.36220472440944884,112,0,1,111,108,4,0.0,0.008928571428571428,0.9910714285714286,0.9642857142857143,0.03571428571428571
6833,160,12,148,113,47,0.075,0.925,0.70625,0.29375,140,0,24,116,139,1,0.0,0.17142857142857143,0.8285714285714286,0.9928571428571429,0.007142857142857143
6834,85,9,76,52,33,0.10588235294117647,0.8941176470588236,0.611764705882353,0.38823529411764707,112,0,0,112,110,2,0.0,0.0,1.0,0.9821428571428571,0.017857142857142856
6835,109,11,98,75,34,0.10091743119266056,0.8990825688073395,0.6880733944954128,0.3119266055045872,133,0,0,133,130,3,0.0,0.0,1.0,0.9774436090225563,0.022556390977443608
6836,123,13,110,82,41,0.10569105691056911,0.8943089430894309,0.6666666666666666,0.3333333333333333,111,0,1,110,107,4,0.0,0.009009009009009009,0.990990990990991,0.963963963963964,0.036036036036036036
6837,132,9,123,99,33,0.06818181818181818,0.9318181818181818,0.75,0.25,103,0,13,90,101,2,0.0,0.1262135922330097,0.8737864077669902,0.9805825242718447,0.019417475728155338
6838,58,10,48,27,31,0.1724137931034483,0.8275862068965517,0.46551724137931033,0.5344827586206896,144,0,0,144,141,3,0.0,0.0,1.0,0.9791666666666666,0.020833333333333332
6839,81,18,63,39,42,0.2222222222222222,0.7777777777777778,0.48148148148148145,0.5185185185185185,86,0,30,56,86,0,0.0,0.3488372093023256,0.6511627906976745,1.0,0.0
6840,125,7,118,94,31,0.056,0.944,0.752,0.248,97,0,11,86,95,2,0.0,0.1134020618556701,0.8865979381443299,0.979381443298969,0.020618556701030927
6841,77,12,65,52,25,0.15584415584415584,0.8441558441558441,0.6753246753246753,0.3246753246753247,81,0,0,81,77,4,0.0,0.0,1.0,0.9506172839506173,0.04938271604938271
6842,124,14,110,80,44,0.11290322580645161,0.8870967741935484,0.6451612903225806,0.3548387096774194,114,0,1,113,110,4,0.0,0.008771929824561403,0.9912280701754386,0.9649122807017544,0.03508771929824561
6843,105,14,91,59,46,0.13333333333333333,0.8666666666666667,0.5619047619047619,0.4380952380952381,181,0,54,127,177,4,0.0,0.2983425414364641,0.7016574585635359,0.9779005524861878,0.022099447513812154
6844,206,11,195,165,41,0.05339805825242718,0.9466019417475728,0.8009708737864077,0.19902912621359223,138,0,26,112,136,2,0.0,0.18840579710144928,0.8115942028985508,0.9855072463768116,0.014492753623188406
6845,107,8,99,82,25,0.07476635514018691,0.9252336448598131,0.7663551401869159,0.2336448598130841,95,0,18,77,93,2,0.0,0.18947368421052632,0.8105263157894737,0.9789473684210527,0.021052631578947368
6846,193,16,177,156,37,0.08290155440414508,0.917098445595855,0.8082901554404145,0.19170984455958548,134,0,27,107,131,3,0.0,0.20149253731343283,0.7985074626865671,0.9776119402985075,0.022388059701492536
6847,36,3,33,29,7,0.08333333333333333,0.9166666666666666,0.8055555555555556,0.19444444444444445,92,0,20,72,90,2,0.0,0.21739130434782608,0.782608695652174,0.9782608695652174,0.021739130434782608
6848,88,5,83,69,19,0.056818181818181816,0.9431818181818182,0.7840909090909091,0.2159090909090909,87,0,1,86,83,4,0.0,0.011494252873563218,0.9885057471264368,0.9540229885057471,0.04597701149425287
6849,110,14,96,70,40,0.12727272727272726,0.8727272727272727,0.6363636363636364,0.36363636363636365,113,0,0,113,110,3,0.0,0.0,1.0,0.9734513274336283,0.02654867256637168
6850,128,18,110,76,52,0.140625,0.859375,0.59375,0.40625,117,0,1,116,113,4,0.0,0.008547008547008548,0.9914529914529915,0.9658119658119658,0.03418803418803419
6851,167,19,148,114,53,0.11377245508982035,0.8862275449101796,0.6826347305389222,0.31736526946107785,140,0,24,116,139,1,0.0,0.17142857142857143,0.8285714285714286,0.9928571428571429,0.007142857142857143
6852,50,16,34,16,34,0.32,0.68,0.32,0.68,83,0,31,52,83,0,0.0,0.37349397590361444,0.6265060240963856,1.0,0.0
6853,92,16,76,54,38,0.17391304347826086,0.8260869565217391,0.5869565217391305,0.41304347826086957,108,0,0,108,105,3,0.0,0.0,1.0,0.9722222222222222,0.027777777777777776
6854,111,6,105,94,17,0.05405405405405406,0.9459459459459459,0.8468468468468469,0.15315315315315314,86,0,12,74,84,2,0.0,0.13953488372093023,0.8604651162790697,0.9767441860465116,0.023255813953488372
6855,196,16,180,156,40,0.08163265306122448,0.9183673469387755,0.7959183673469388,0.20408163265306123,133,0,24,109,130,3,0.0,0.18045112781954886,0.8195488721804511,0.9774436090225563,0.022556390977443608
6856,92,26,66,43,49,0.2826086956521739,0.717391304347826,0.4673913043478261,0.532608695652174,89,0,30,59,89,0,0.0,0.33707865168539325,0.6629213483146067,1.0,0.0
6857,109,16,93,67,42,0.14678899082568808,0.8532110091743119,0.6146788990825688,0.3853211009174312,116,0,0,116,114,2,0.0,0.0,1.0,0.9827586206896551,0.017241379310344827
6858,92,12,80,67,25,0.13043478260869565,0.8695652173913043,0.7282608695652174,0.2717391304347826,88,0,1,87,84,4,0.0,0.011363636363636364,0.9886363636363636,0.9545454545454546,0.045454545454545456
6859,39,6,33,30,9,0.15384615384615385,0.8461538461538461,0.7692307692307693,0.23076923076923078,94,0,20,74,91,3,0.0,0.2127659574468085,0.7872340425531915,0.9680851063829787,0.031914893617021274
6860,92,16,76,57,35,0.17391304347826086,0.8260869565217391,0.6195652173913043,0.3804347826086957,105,0,0,105,101,4,0.0,0.0,1.0,0.9619047619047619,0.0380952380952381
6861,193,13,180,154,39,0.06735751295336788,0.9326424870466321,0.7979274611398963,0.20207253886010362,149,0,27,122,146,3,0.0,0.18120805369127516,0.8187919463087249,0.9798657718120806,0.020134228187919462
6862,121,11,110,80,41,0.09090909090909091,0.9090909090909091,0.6611570247933884,0.33884297520661155,100,0,1,99,97,3,0.0,0.01,0.99,0.97,0.03
6863,71,10,61,46,25,0.14084507042253522,0.8591549295774648,0.647887323943662,0.352112676056338,81,0,0,81,77,4,0.0,0.0,1.0,0.9506172839506173,0.04938271604938271
6864,123,13,110,79,44,0.10569105691056911,0.8943089430894309,0.6422764227642277,0.35772357723577236,108,0,1,107,104,4,0.0,0.009259259259259259,0.9907407407407407,0.9629629629629629,0.037037037037037035
6865,93,17,76,56,37,0.1827956989247312,0.8172043010752689,0.6021505376344086,0.3978494623655914,98,0,0,98,95,3,0.0,0.0,1.0,0.9693877551020408,0.030612244897959183
6866,113,6,107,91,22,0.05309734513274336,0.9469026548672567,0.8053097345132744,0.19469026548672566,75,0,7,68,73,2,0.0,0.09333333333333334,0.9066666666666666,0.9733333333333334,0.02666666666666667
6867,92,16,76,55,37,0.17391304347826086,0.8260869565217391,0.5978260869565217,0.40217391304347827,106,0,0,106,103,3,0.0,0.0,1.0,0.9716981132075472,0.02830188679245283
6868,195,17,178,152,43,0.08717948717948718,0.9128205128205128,0.7794871794871795,0.2205128205128205,142,0,26,116,139,3,0.0,0.18309859154929578,0.8169014084507042,0.9788732394366197,0.02112676056338028
6869,107,11,96,73,34,0.102803738317757,0.897196261682243,0.6822429906542056,0.3177570093457944,99,0,0,99,96,3,0.0,0.0,1.0,0.9696969696969697,0.030303030303030304
6870,84,19,65,34,50,0.2261904761904762,0.7738095238095238,0.40476190476190477,0.5952380952380952,38,0,30,8,38,0,0.0,0.7894736842105263,0.21052631578947367,1.0,0.0
6871,124,7,117,91,33,0.056451612903225805,0.9435483870967742,0.7338709677419355,0.2661290322580645,104,0,18,86,102,2,0.0,0.17307692307692307,0.8269230769230769,0.9807692307692307,0.019230769230769232
6872,195,17,178,153,42,0.08717948717948718,0.9128205128205128,0.7846153846153846,0.2153846153846154,133,0,28,105,130,3,0.0,0.21052631578947367,0.7894736842105263,0.9774436090225563,0.022556390977443608
6873,128,8,120,97,31,0.0625,0.9375,0.7578125,0.2421875,104,0,16,88,102,2,0.0,0.15384615384615385,0.8461538461538461,0.9807692307692307,0.019230769230769232
6874,197,18,179,155,42,0.09137055837563451,0.9086294416243654,0.7868020304568528,0.2131979695431472,143,0,27,116,140,3,0.0,0.1888111888111888,0.8111888111888111,0.9790209790209791,0.02097902097902098
6875,125,15,110,82,43,0.12,0.88,0.656,0.344,110,0,1,109,106,4,0.0,0.00909090909090909,0.990909090909091,0.9636363636363636,0.03636363636363636
6876,104,9,95,67,37,0.08653846153846154,0.9134615384615384,0.6442307692307693,0.3557692307692308,107,0,0,107,105,2,0.0,0.0,1.0,0.9813084112149533,0.018691588785046728
6877,124,14,110,85,39,0.11290322580645161,0.8870967741935484,0.6854838709677419,0.31451612903225806,114,0,1,113,110,4,0.0,0.008771929824561403,0.9912280701754386,0.9649122807017544,0.03508771929824561
6878,158,15,143,111,47,0.0949367088607595,0.9050632911392406,0.7025316455696202,0.2974683544303797,149,1,24,124,148,1,0.006711409395973154,0.1610738255033557,0.8322147651006712,0.9932885906040269,0.006711409395973154
6879,191,14,177,151,40,0.07329842931937172,0.9267015706806283,0.7905759162303665,0.2094240837696335,146,0,24,122,143,3,0.0,0.1643835616438356,0.8356164383561644,0.9794520547945206,0.02054794520547945
6880,68,14,54,26,42,0.20588235294117646,0.7941176470588235,0.38235294117647056,0.6176470588235294,111,0,30,81,111,0,0.0,0.2702702702702703,0.7297297297297297,1.0,0.0
6881,164,16,148,117,47,0.0975609756097561,0.9024390243902439,0.7134146341463414,0.2865853658536585,151,1,24,126,150,1,0.006622516556291391,0.15894039735099338,0.8344370860927153,0.9933774834437086,0.006622516556291391
6882,153,134,19,150,3,0.8758169934640523,0.12418300653594772,0.9803921568627451,0.0196078431372549,359,0,44,315,108,251,0.0,0.12256267409470752,0.8774373259052924,0.3008356545961003,0.6991643454038997
6883,89,15,74,53,36,0.16853932584269662,0.8314606741573034,0.5955056179775281,0.4044943820224719,110,0,0,110,107,3,0.0,0.0,1.0,0.9727272727272728,0.02727272727272727
6884,161,16,145,111,50,0.09937888198757763,0.9006211180124224,0.6894409937888198,0.3105590062111801,152,1,25,126,151,1,0.006578947368421052,0.16447368421052633,0.8289473684210527,0.993421052631579,0.006578947368421052
6885,107,6,101,87,20,0.056074766355140186,0.9439252336448598,0.8130841121495327,0.18691588785046728,87,0,15,72,85,2,0.0,0.1724137931034483,0.8275862068965517,0.9770114942528736,0.022988505747126436
6886,67,13,54,29,38,0.19402985074626866,0.8059701492537313,0.43283582089552236,0.5671641791044776,99,0,32,67,99,0,0.0,0.32323232323232326,0.6767676767676768,1.0,0.0
6887,110,19,91,58,52,0.17272727272727273,0.8272727272727273,0.5272727272727272,0.4727272727272727,191,0,54,137,187,4,0.0,0.28272251308900526,0.7172774869109948,0.9790575916230366,0.020942408376963352
6888,157,130,27,154,3,0.8280254777070064,0.17197452229299362,0.9808917197452229,0.01910828025477707,325,0,33,292,87,238,0.0,0.10153846153846154,0.8984615384615384,0.2676923076923077,0.7323076923076923
6889,67,13,54,27,40,0.19402985074626866,0.8059701492537313,0.40298507462686567,0.5970149253731343,106,0,31,75,106,0,0.0,0.29245283018867924,0.7075471698113207,1.0,0.0
6890,194,12,182,158,36,0.061855670103092786,0.9381443298969072,0.8144329896907216,0.18556701030927836,140,0,26,114,138,2,0.0,0.18571428571428572,0.8142857142857143,0.9857142857142858,0.014285714285714285
6891,122,13,109,81,41,0.10655737704918032,0.8934426229508197,0.6639344262295082,0.3360655737704918,115,0,1,114,111,4,0.0,0.008695652173913044,0.991304347826087,0.9652173913043478,0.034782608695652174
6892,108,4,104,82,26,0.037037037037037035,0.9629629629629629,0.7592592592592593,0.24074074074074073,96,0,15,81,94,2,0.0,0.15625,0.84375,0.9791666666666666,0.020833333333333332
6893,64,10,54,30,34,0.15625,0.84375,0.46875,0.53125,108,0,30,78,108,0,0.0,0.2777777777777778,0.7222222222222222,1.0,0.0
6894,89,13,76,59,30,0.14606741573033707,0.8539325842696629,0.6629213483146067,0.33707865168539325,78,0,1,77,74,4,0.0,0.01282051282051282,0.9871794871794872,0.9487179487179487,0.05128205128205128
6895,87,23,64,40,47,0.26436781609195403,0.735632183908046,0.45977011494252873,0.5402298850574713,89,0,28,61,89,0,0.0,0.3146067415730337,0.6853932584269663,1.0,0.0
6896,126,17,109,79,47,0.1349206349206349,0.8650793650793651,0.626984126984127,0.373015873015873,111,0,1,110,107,4,0.0,0.009009009009009009,0.990990990990991,0.963963963963964,0.036036036036036036
6897,128,11,117,94,34,0.0859375,0.9140625,0.734375,0.265625,98,0,18,80,96,2,0.0,0.1836734693877551,0.8163265306122449,0.9795918367346939,0.02040816326530612
6898,62,15,47,26,36,0.24193548387096775,0.7580645161290323,0.41935483870967744,0.5806451612903226,133,0,0,133,131,2,0.0,0.0,1.0,0.9849624060150376,0.015037593984962405
6899,107,16,91,57,50,0.14953271028037382,0.8504672897196262,0.5327102803738317,0.4672897196261682,193,0,54,139,189,4,0.0,0.27979274611398963,0.7202072538860104,0.9792746113989638,0.02072538860103627
6900,89,13,76,56,33,0.14606741573033707,0.8539325842696629,0.6292134831460674,0.3707865168539326,99,0,0,99,96,3,0.0,0.0,1.0,0.9696969696969697,0.030303030303030304
6901,121,11,110,82,39,0.09090909090909091,0.9090909090909091,0.6776859504132231,0.32231404958677684,102,0,1,101,98,4,0.0,0.00980392156862745,0.9901960784313726,0.9607843137254902,0.0392156862745098
6902,130,19,111,79,51,0.14615384615384616,0.8538461538461538,0.6076923076923076,0.3923076923076923,108,0,1,107,104,4,0.0,0.009259259259259259,0.9907407407407407,0.9629629629629629,0.037037037037037035
6903,186,11,175,146,40,0.05913978494623656,0.9408602150537635,0.7849462365591398,0.21505376344086022,138,0,26,112,135,3,0.0,0.18840579710144928,0.8115942028985508,0.9782608695652174,0.021739130434782608
6904,107,5,102,89,18,0.04672897196261682,0.9532710280373832,0.8317757009345794,0.16822429906542055,88,0,13,75,86,2,0.0,0.14772727272727273,0.8522727272727273,0.9772727272727273,0.022727272727272728
6905,58,11,47,29,29,0.1896551724137931,0.8103448275862069,0.5,0.5,136,0,0,136,133,3,0.0,0.0,1.0,0.9779411764705882,0.022058823529411766
6906,119,9,110,82,37,0.07563025210084033,0.9243697478991597,0.6890756302521008,0.31092436974789917,111,0,1,110,107,4,0.0,0.009009009009009009,0.990990990990991,0.963963963963964,0.036036036036036036
6907,167,19,148,106,61,0.11377245508982035,0.8862275449101796,0.6347305389221557,0.3652694610778443,148,0,24,124,147,1,0.0,0.16216216216216217,0.8378378378378378,0.9932432432432432,0.006756756756756757
6908,86,10,76,54,32,0.11627906976744186,0.8837209302325582,0.627906976744186,0.37209302325581395,117,0,0,117,115,2,0.0,0.0,1.0,0.9829059829059829,0.017094017094017096
6909,60,13,47,25,35,0.21666666666666667,0.7833333333333333,0.4166666666666667,0.5833333333333334,131,0,0,131,128,3,0.0,0.0,1.0,0.9770992366412213,0.022900763358778626
6910,199,17,182,157,42,0.08542713567839195,0.914572864321608,0.7889447236180904,0.21105527638190955,138,0,25,113,136,2,0.0,0.18115942028985507,0.8188405797101449,0.9855072463768116,0.014492753623188406
6911,89,13,76,54,35,0.14606741573033707,0.8539325842696629,0.6067415730337079,0.39325842696629215,115,0,0,115,111,4,0.0,0.0,1.0,0.9652173913043478,0.034782608695652174
6912,79,16,63,35,44,0.20253164556962025,0.7974683544303798,0.4430379746835443,0.5569620253164557,96,0,30,66,96,0,0.0,0.3125,0.6875,1.0,0.0
6913,88,9,79,56,32,0.10227272727272728,0.8977272727272727,0.6363636363636364,0.36363636363636365,75,0,1,74,71,4,0.0,0.013333333333333334,0.9866666666666667,0.9466666666666667,0.05333333333333334
6914,126,16,110,84,42,0.12698412698412698,0.873015873015873,0.6666666666666666,0.3333333333333333,108,0,1,107,104,4,0.0,0.009259259259259259,0.9907407407407407,0.9629629629629629,0.037037037037037035
6915,58,10,48,28,30,0.1724137931034483,0.8275862068965517,0.4827586206896552,0.5172413793103449,135,0,0,135,133,2,0.0,0.0,1.0,0.9851851851851852,0.014814814814814815
6916,126,16,110,84,42,0.12698412698412698,0.873015873015873,0.6666666666666666,0.3333333333333333,98,0,0,98,95,3,0.0,0.0,1.0,0.9693877551020408,0.030612244897959183
6917,123,14,109,86,37,0.11382113821138211,0.8861788617886179,0.6991869918699187,0.3008130081300813,109,0,1,108,105,4,0.0,0.009174311926605505,0.9908256880733946,0.963302752293578,0.03669724770642202
6918,163,15,148,115,48,0.09202453987730061,0.9079754601226994,0.7055214723926381,0.294478527607362,145,0,24,121,144,1,0.0,0.16551724137931034,0.8344827586206897,0.993103448275862,0.006896551724137931
6919,121,11,110,81,40,0.09090909090909091,0.9090909090909091,0.6694214876033058,0.3305785123966942,101,0,1,100,97,4,0.0,0.009900990099009901,0.9900990099009901,0.9603960396039604,0.039603960396039604
6920,127,16,111,80,47,0.12598425196850394,0.8740157480314961,0.6299212598425197,0.3700787401574803,114,0,2,112,110,4,0.0,0.017543859649122806,0.9824561403508771,0.9649122807017544,0.03508771929824561
6921,87,11,76,55,32,0.12643678160919541,0.8735632183908046,0.632183908045977,0.367816091954023,119,0,0,119,116,3,0.0,0.0,1.0,0.9747899159663865,0.025210084033613446
6922,123,13,110,80,43,0.10569105691056911,0.8943089430894309,0.6504065040650406,0.34959349593495936,118,0,1,117,114,4,0.0,0.00847457627118644,0.9915254237288136,0.9661016949152542,0.03389830508474576
6923,197,19,178,153,44,0.09644670050761421,0.9035532994923858,0.7766497461928934,0.2233502538071066,137,0,28,109,134,3,0.0,0.20437956204379562,0.7956204379562044,0.9781021897810219,0.021897810218978103
6924,111,20,91,54,57,0.18018018018018017,0.8198198198198198,0.4864864864864865,0.5135135135135135,178,0,54,124,174,4,0.0,0.30337078651685395,0.6966292134831461,0.9775280898876404,0.02247191011235955
6925,124,13,111,77,47,0.10483870967741936,0.8951612903225806,0.6209677419354839,0.3790322580645161,110,0,2,108,106,4,0.0,0.01818181818181818,0.9818181818181818,0.9636363636363636,0.03636363636363636
6926,61,14,47,27,34,0.22950819672131148,0.7704918032786885,0.4426229508196721,0.5573770491803278,141,0,0,141,138,3,0.0,0.0,1.0,0.9787234042553191,0.02127659574468085
6927,91,15,76,58,33,0.16483516483516483,0.8351648351648352,0.6373626373626373,0.3626373626373626,119,0,0,119,115,4,0.0,0.0,1.0,0.9663865546218487,0.03361344537815126
6928,70,16,54,26,44,0.22857142857142856,0.7714285714285715,0.37142857142857144,0.6285714285714286,105,0,30,75,105,0,0.0,0.2857142857142857,0.7142857142857143,1.0,0.0
6929,163,16,147,109,54,0.09815950920245399,0.901840490797546,0.6687116564417178,0.3312883435582822,139,0,24,115,138,1,0.0,0.17266187050359713,0.8273381294964028,0.9928057553956835,0.007194244604316547
6930,83,18,65,42,41,0.21686746987951808,0.7831325301204819,0.5060240963855421,0.4939759036144578,94,0,31,63,94,0,0.0,0.32978723404255317,0.6702127659574468,1.0,0.0
6931,128,17,111,80,48,0.1328125,0.8671875,0.625,0.375,118,0,2,116,114,4,0.0,0.01694915254237288,0.9830508474576272,0.9661016949152542,0.03389830508474576
6932,59,12,47,28,31,0.2033898305084746,0.7966101694915254,0.4745762711864407,0.5254237288135594,136,0,0,136,134,2,0.0,0.0,1.0,0.9852941176470589,0.014705882352941176
6933,118,7,111,78,40,0.059322033898305086,0.940677966101695,0.6610169491525424,0.3389830508474576,115,0,2,113,112,3,0.0,0.017391304347826087,0.9826086956521739,0.9739130434782609,0.02608695652173913
6934,61,14,47,27,34,0.22950819672131148,0.7704918032786885,0.4426229508196721,0.5573770491803278,136,0,0,136,133,3,0.0,0.0,1.0,0.9779411764705882,0.022058823529411766
6935,80,15,65,39,41,0.1875,0.8125,0.4875,0.5125,86,0,28,58,86,0,0.0,0.32558139534883723,0.6744186046511628,1.0,0.0
6936,124,13,111,78,46,0.10483870967741936,0.8951612903225806,0.6290322580645161,0.3709677419354839,102,0,2,100,98,4,0.0,0.0196078431372549,0.9803921568627451,0.9607843137254902,0.0392156862745098
6937,73,19,54,26,47,0.2602739726027397,0.7397260273972602,0.3561643835616438,0.6438356164383562,95,0,32,63,95,0,0.0,0.3368421052631579,0.6631578947368421,1.0,0.0
6938,111,14,97,75,36,0.12612612612612611,0.8738738738738738,0.6756756756756757,0.32432432432432434,115,0,0,115,112,3,0.0,0.0,1.0,0.9739130434782609,0.02608695652173913
6939,121,11,110,84,37,0.09090909090909091,0.9090909090909091,0.6942148760330579,0.30578512396694213,103,0,1,102,99,4,0.0,0.009708737864077669,0.9902912621359223,0.9611650485436893,0.038834951456310676
6940,86,20,66,42,44,0.23255813953488372,0.7674418604651163,0.4883720930232558,0.5116279069767442,90,0,28,62,90,0,0.0,0.3111111111111111,0.6888888888888889,1.0,0.0
6941,85,20,65,39,46,0.23529411764705882,0.7647058823529411,0.4588235294117647,0.5411764705882353,95,0,30,65,95,0,0.0,0.3157894736842105,0.6842105263157895,1.0,0.0
6942,41,7,34,31,10,0.17073170731707318,0.8292682926829268,0.7560975609756098,0.24390243902439024,84,0,18,66,81,3,0.0,0.21428571428571427,0.7857142857142857,0.9642857142857143,0.03571428571428571
6943,85,9,76,54,31,0.10588235294117647,0.8941176470588236,0.6352941176470588,0.36470588235294116,115,0,0,115,112,3,0.0,0.0,1.0,0.9739130434782609,0.02608695652173913
6944,108,17,91,62,46,0.1574074074074074,0.8425925925925926,0.5740740740740741,0.42592592592592593,174,0,54,120,170,4,0.0,0.3103448275862069,0.6896551724137931,0.9770114942528736,0.022988505747126436
6945,125,15,110,82,43,0.12,0.88,0.656,0.344,118,0,1,117,114,4,0.0,0.00847457627118644,0.9915254237288136,0.9661016949152542,0.03389830508474576
6946,67,8,59,43,24,0.11940298507462686,0.8805970149253731,0.6417910447761194,0.3582089552238806,80,0,0,80,76,4,0.0,0.0,1.0,0.95,0.05
6947,130,19,111,82,48,0.14615384615384616,0.8538461538461538,0.6307692307692307,0.36923076923076925,101,0,2,99,97,4,0.0,0.019801980198019802,0.9801980198019802,0.9603960396039604,0.039603960396039604
6948,125,14,111,81,44,0.112,0.888,0.648,0.352,110,0,2,108,107,3,0.0,0.01818181818181818,0.9818181818181818,0.9727272727272728,0.02727272727272727
6949,158,10,148,112,46,0.06329113924050633,0.9367088607594937,0.7088607594936709,0.2911392405063291,151,0,24,127,150,1,0.0,0.15894039735099338,0.8410596026490066,0.9933774834437086,0.006622516556291391
6950,201,23,178,151,50,0.11442786069651742,0.8855721393034826,0.7512437810945274,0.24875621890547264,147,0,26,121,144,3,0.0,0.17687074829931973,0.8231292517006803,0.9795918367346939,0.02040816326530612
6951,39,7,32,31,8,0.1794871794871795,0.8205128205128205,0.7948717948717948,0.20512820512820512,88,0,17,71,85,3,0.0,0.19318181818181818,0.8068181818181818,0.9659090909090909,0.03409090909090909
6952,173,25,148,109,64,0.14450867052023122,0.8554913294797688,0.630057803468208,0.3699421965317919,134,0,24,110,133,1,0.0,0.1791044776119403,0.8208955223880597,0.9925373134328358,0.007462686567164179
6953,93,17,76,56,37,0.1827956989247312,0.8172043010752689,0.6021505376344086,0.3978494623655914,90,0,0,90,86,4,0.0,0.0,1.0,0.9555555555555556,0.044444444444444446
6954,62,15,47,25,37,0.24193548387096775,0.7580645161290323,0.4032258064516129,0.5967741935483871,151,0,0,151,148,3,0.0,0.0,1.0,0.9801324503311258,0.019867549668874173
6955,71,17,54,28,43,0.23943661971830985,0.7605633802816901,0.39436619718309857,0.6056338028169014,120,0,32,88,120,0,0.0,0.26666666666666666,0.7333333333333333,1.0,0.0
6956,92,9,83,62,30,0.09782608695652174,0.9021739130434783,0.6739130434782609,0.32608695652173914,86,0,1,85,83,3,0.0,0.011627906976744186,0.9883720930232558,0.9651162790697675,0.03488372093023256
6957,61,17,44,22,39,0.2786885245901639,0.7213114754098361,0.36065573770491804,0.639344262295082,96,0,30,66,96,0,0.0,0.3125,0.6875,1.0,0.0
6958,189,13,176,151,38,0.06878306878306878,0.9312169312169312,0.798941798941799,0.20105820105820105,154,0,28,126,151,3,0.0,0.18181818181818182,0.8181818181818182,0.9805194805194806,0.01948051948051948
6959,88,12,76,57,31,0.13636363636363635,0.8636363636363636,0.6477272727272727,0.3522727272727273,118,0,0,118,115,3,0.0,0.0,1.0,0.9745762711864406,0.025423728813559324
6960,481,443,38,296,185,0.920997920997921,0.079002079002079,0.6153846153846154,0.38461538461538464,5,0,0,5,5,0,0.0,0.0,1.0,1.0,0.0
6961,101,92,9,86,15,0.9108910891089109,0.0891089108910891,0.8514851485148515,0.1485148514851485,13,0,0,13,10,3,0.0,0.0,1.0,0.7692307692307693,0.23076923076923078
6962,386,344,42,227,159,0.8911917098445595,0.10880829015544041,0.5880829015544041,0.4119170984455959,5,0,0,5,5,0,0.0,0.0,1.0,1.0,0.0
6963,485,416,69,304,181,0.8577319587628865,0.1422680412371134,0.6268041237113402,0.3731958762886598,5,0,0,5,5,0,0.0,0.0,1.0,1.0,0.0
6964,376,289,87,348,28,0.7686170212765957,0.23138297872340424,0.925531914893617,0.07446808510638298,13,0,0,13,10,3,0.0,0.0,1.0,0.7692307692307693,0.23076923076923078
6965,96,80,16,50,46,0.8333333333333334,0.16666666666666666,0.5208333333333334,0.4791666666666667,7,0,0,7,7,0,0.0,0.0,1.0,1.0,0.0
6966,18,11,7,13,5,0.6111111111111112,0.3888888888888889,0.7222222222222222,0.2777777777777778,7,0,0,7,7,0,0.0,0.0,1.0,1.0,0.0
6967,12,7,5,7,5,0.5833333333333334,0.4166666666666667,0.5833333333333334,0.4166666666666667,7,0,0,7,7,0,0.0,0.0,1.0,1.0,0.0
6968,404,357,47,237,167,0.8836633663366337,0.11633663366336634,0.5866336633663366,0.41336633663366334,7,0,0,7,7,0,0.0,0.0,1.0,1.0,0.0
6969,110,101,9,96,14,0.9181818181818182,0.08181818181818182,0.8727272727272727,0.12727272727272726,13,0,0,13,10,3,0.0,0.0,1.0,0.7692307692307693,0.23076923076923078
6970,105,87,18,58,47,0.8285714285714286,0.17142857142857143,0.5523809523809524,0.44761904761904764,5,0,0,5,5,0,0.0,0.0,1.0,1.0,0.0
6971,150,119,31,95,55,0.7933333333333333,0.20666666666666667,0.6333333333333333,0.36666666666666664,7,0,0,7,7,0,0.0,0.0,1.0,1.0,0.0
6972,31,18,13,20,11,0.5806451612903226,0.41935483870967744,0.6451612903225806,0.3548387096774194,7,0,0,7,7,0,0.0,0.0,1.0,1.0,0.0
6973,27,22,5,26,1,0.8148148148148148,0.18518518518518517,0.9629629629629629,0.037037037037037035,98,21,47,30,96,2,0.21428571428571427,0.47959183673469385,0.30612244897959184,0.9795918367346939,0.02040816326530612
6974,99,90,9,83,16,0.9090909090909091,0.09090909090909091,0.8383838383838383,0.16161616161616163,13,0,0,13,10,3,0.0,0.0,1.0,0.7692307692307693,0.23076923076923078
6975,48,48,0,33,15,1.0,0.0,0.6875,0.3125,5,0,0,5,5,0,0.0,0.0,1.0,1.0,0.0
6976,1561,1554,7,1245,316,0.9955156950672646,0.004484304932735426,0.7975656630365151,0.20243433696348495,8,0,0,8,8,0,0.0,0.0,1.0,1.0,0.0
6977,104,74,30,66,38,0.7115384615384616,0.28846153846153844,0.6346153846153846,0.36538461538461536,7,0,0,7,7,0,0.0,0.0,1.0,1.0,0.0
6978,132,120,12,71,61,0.9090909090909091,0.09090909090909091,0.5378787878787878,0.4621212121212121,7,0,0,7,7,0,0.0,0.0,1.0,1.0,0.0
6979,79,70,9,65,14,0.8860759493670886,0.11392405063291139,0.8227848101265823,0.17721518987341772,13,0,0,13,10,3,0.0,0.0,1.0,0.7692307692307693,0.23076923076923078
6980,27,14,13,20,7,0.5185185185185185,0.48148148148148145,0.7407407407407407,0.25925925925925924,13,0,0,13,10,3,0.0,0.0,1.0,0.7692307692307693,0.23076923076923078
6981,0,0,0,0,0,0.0,0.0,0.0,0.0,0,0,0,0,0,0,0.0,0.0,0.0,0.0,0.0
6982,0,0,0,0,0,0.0,0.0,0.0,0.0,0,0,0,0,0,0,0.0,0.0,0.0,0.0,0.0
6983,840,832,8,807,33,0.9904761904761905,0.009523809523809525,0.9607142857142857,0.039285714285714285,7,0,0,7,7,0,0.0,0.0,1.0,1.0,0.0
6984,110,84,26,68,42,0.7636363636363637,0.23636363636363636,0.6181818181818182,0.38181818181818183,7,0,0,7,7,0,0.0,0.0,1.0,1.0,0.0
6985,341,295,46,204,137,0.8651026392961877,0.1348973607038123,0.5982404692082112,0.40175953079178883,5,0,0,5,5,0,0.0,0.0,1.0,1.0,0.0
6986,49,38,11,48,1,0.7755102040816326,0.22448979591836735,0.9795918367346939,0.02040816326530612,122,42,41,39,120,2,0.3442622950819672,0.3360655737704918,0.319672131147541,0.9836065573770492,0.01639344262295082
6987,96,87,9,82,14,0.90625,0.09375,0.8541666666666666,0.14583333333333334,13,0,0,13,10,3,0.0,0.0,1.0,0.7692307692307693,0.23076923076923078
6988,583,503,80,359,224,0.8627787307032591,0.137221269296741,0.6157804459691252,0.38421955403087477,5,0,0,5,5,0,0.0,0.0,1.0,1.0,0.0
6989,22,14,8,14,8,0.6363636363636364,0.36363636363636365,0.6363636363636364,0.36363636363636365,7,0,0,7,7,0,0.0,0.0,1.0,1.0,0.0
6990,90,50,40,61,29,0.5555555555555556,0.4444444444444444,0.6777777777777778,0.32222222222222224,13,0,0,13,10,3,0.0,0.0,1.0,0.7692307692307693,0.23076923076923078
6991,90,81,9,75,15,0.9,0.1,0.8333333333333334,0.16666666666666666,13,0,0,13,10,3,0.0,0.0,1.0,0.7692307692307693,0.23076923076923078
6992,135,119,16,72,63,0.8814814814814815,0.11851851851851852,0.5333333333333333,0.4666666666666667,7,0,0,7,7,0,0.0,0.0,1.0,1.0,0.0
6993,680,619,61,402,278,0.9102941176470588,0.08970588235294118,0.5911764705882353,0.4088235294117647,5,0,0,5,5,0,0.0,0.0,1.0,1.0,0.0
6994,31,17,14,21,10,0.5483870967741935,0.45161290322580644,0.6774193548387096,0.3225806451612903,13,0,0,13,10,3,0.0,0.0,1.0,0.7692307692307693,0.23076923076923078
6995,291,246,45,165,126,0.845360824742268,0.15463917525773196,0.5670103092783505,0.4329896907216495,7,0,0,7,7,0,0.0,0.0,1.0,1.0,0.0
6996,338,295,43,207,131,0.8727810650887574,0.12721893491124261,0.6124260355029586,0.3875739644970414,4,0,0,4,4,0,0.0,0.0,1.0,1.0,0.0
6997,314,284,30,171,143,0.9044585987261147,0.09554140127388536,0.5445859872611465,0.4554140127388535,7,0,0,7,7,0,0.0,0.0,1.0,1.0,0.0
6998,191,112,79,144,47,0.5863874345549738,0.41361256544502617,0.7539267015706806,0.24607329842931938,13,0,0,13,10,3,0.0,0.0,1.0,0.7692307692307693,0.23076923076923078
6999,72,72,0,64,8,1.0,0.0,0.8888888888888888,0.1111111111111111,9,0,1,8,8,1,0.0,0.1111111111111111,0.8888888888888888,0.8888888888888888,0.1111111111111111
7000,73,45,28,51,22,0.6164383561643836,0.3835616438356164,0.6986301369863014,0.3013698630136986,5,0,0,5,5,0,0.0,0.0,1.0,1.0,0.0
7001,1381,1373,8,1115,266,0.9942070963070239,0.005792903692976104,0.8073859522085446,0.19261404779145547,6,0,0,6,6,0,0.0,0.0,1.0,1.0,0.0
7002,429,374,55,271,158,0.8717948717948718,0.1282051282051282,0.6317016317016317,0.3682983682983683,5,0,0,5,5,0,0.0,0.0,1.0,1.0,0.0
7003,1421,1413,8,1168,253,0.9943701618578465,0.005629838142153413,0.8219563687543983,0.17804363124560169,5,0,0,5,5,0,0.0,0.0,1.0,1.0,0.0
7004,389,332,57,228,161,0.8534704370179949,0.14652956298200515,0.5861182519280206,0.4138817480719794,5,0,0,5,5,0,0.0,0.0,1.0,1.0,0.0
7005,25,23,2,16,9,0.92,0.08,0.64,0.36,7,0,0,7,7,0,0.0,0.0,1.0,1.0,0.0
7006,443,392,51,269,174,0.8848758465011287,0.11512415349887133,0.6072234762979684,0.3927765237020316,5,0,0,5,5,0,0.0,0.0,1.0,1.0,0.0
7007,379,320,59,232,147,0.8443271767810027,0.15567282321899736,0.6121372031662269,0.38786279683377306,5,0,0,5,5,0,0.0,0.0,1.0,1.0,0.0
7008,173,172,1,112,61,0.9942196531791907,0.005780346820809248,0.6473988439306358,0.35260115606936415,24,0,0,24,24,0,0.0,0.0,1.0,1.0,0.0
7009,652,648,4,518,134,0.9938650306748467,0.006134969325153374,0.7944785276073619,0.20552147239263804,6,0,1,5,5,1,0.0,0.16666666666666666,0.8333333333333334,0.8333333333333334,0.16666666666666666
7010,1321,1315,6,1060,261,0.9954579863739591,0.004542013626040878,0.8024224072672218,0.1975775927327782,5,0,0,5,5,0,0.0,0.0,1.0,1.0,0.0
7011,348,310,38,195,153,0.8908045977011494,0.10919540229885058,0.5603448275862069,0.4396551724137931,7,0,0,7,7,0,0.0,0.0,1.0,1.0,0.0
7012,61,35,26,44,17,0.5737704918032787,0.4262295081967213,0.7213114754098361,0.2786885245901639,7,0,0,7,7,0,0.0,0.0,1.0,1.0,0.0
7013,450,401,49,273,177,0.8911111111111111,0.10888888888888888,0.6066666666666667,0.3933333333333333,5,0,0,5,5,0,0.0,0.0,1.0,1.0,0.0
7014,1474,1468,6,1210,264,0.9959294436906377,0.004070556309362279,0.8208955223880597,0.1791044776119403,8,0,0,8,8,0,0.0,0.0,1.0,1.0,0.0
7015,1332,1323,9,1091,241,0.9932432432432432,0.006756756756756757,0.8190690690690691,0.18093093093093093,5,0,0,5,5,0,0.0,0.0,1.0,1.0,0.0
7016,40,29,11,39,1,0.725,0.275,0.975,0.025,118,26,64,28,116,2,0.22033898305084745,0.5423728813559322,0.23728813559322035,0.9830508474576272,0.01694915254237288
7017,0,0,0,0,0,0.0,0.0,0.0,0.0,0,0,0,0,0,0,0.0,0.0,0.0,0.0,0.0
7018,201,121,80,135,66,0.6019900497512438,0.39800995024875624,0.6716417910447762,0.3283582089552239,13,0,0,13,10,3,0.0,0.0,1.0,0.7692307692307693,0.23076923076923078
7019,493,435,58,307,186,0.8823529411764706,0.11764705882352941,0.6227180527383367,0.3772819472616633,5,0,0,5,5,0,0.0,0.0,1.0,1.0,0.0
7020,0,0,0,0,0,0.0,0.0,0.0,0.0,0,0,0,0,0,0,0.0,0.0,0.0,0.0,0.0
7021,1289,1282,7,1049,240,0.9945694336695112,0.005430566330488751,0.8138091543832429,0.18619084561675717,5,0,0,5,5,0,0.0,0.0,1.0,1.0,0.0
7022,353,312,41,221,132,0.8838526912181303,0.11614730878186968,0.6260623229461756,0.37393767705382436,4,0,0,4,4,0,0.0,0.0,1.0,1.0,0.0
7023,158,142,16,99,59,0.8987341772151899,0.10126582278481013,0.6265822784810127,0.37341772151898733,7,0,0,7,7,0,0.0,0.0,1.0,1.0,0.0
7024,0,0,0,0,0,0.0,0.0,0.0,0.0,0,0,0,0,0,0,0.0,0.0,0.0,0.0,0.0
7025,327,298,29,187,140,0.9113149847094801,0.08868501529051988,0.5718654434250765,0.42813455657492355,5,0,0,5,5,0,0.0,0.0,1.0,1.0,0.0
7026,416,359,57,242,174,0.8629807692307693,0.13701923076923078,0.5817307692307693,0.4182692307692308,5,0,0,5,5,0,0.0,0.0,1.0,1.0,0.0
7027,1,0,1,1,0,0.0,1.0,1.0,0.0,7,0,0,7,7,0,0.0,0.0,1.0,1.0,0.0
7028,30,16,14,22,8,0.5333333333333333,0.4666666666666667,0.7333333333333333,0.26666666666666666,7,0,0,7,7,0,0.0,0.0,1.0,1.0,0.0
7029,415,305,110,383,32,0.7349397590361446,0.26506024096385544,0.9228915662650602,0.07710843373493977,13,0,0,13,10,3,0.0,0.0,1.0,0.7692307692307693,0.23076923076923078
7030,420,339,81,266,154,0.8071428571428572,0.19285714285714287,0.6333333333333333,0.36666666666666664,6,0,0,6,6,0,0.0,0.0,1.0,1.0,0.0
7031,310,261,49,182,128,0.8419354838709677,0.15806451612903225,0.5870967741935483,0.4129032258064516,5,0,0,5,5,0,0.0,0.0,1.0,1.0,0.0
7032,42,25,17,29,13,0.5952380952380952,0.40476190476190477,0.6904761904761905,0.30952380952380953,13,0,0,13,10,3,0.0,0.0,1.0,0.7692307692307693,0.23076923076923078
7033,633,570,63,379,254,0.9004739336492891,0.0995260663507109,0.5987361769352291,0.40126382306477093,5,0,0,5,5,0,0.0,0.0,1.0,1.0,0.0
7034,97,85,12,57,40,0.8762886597938144,0.12371134020618557,0.5876288659793815,0.41237113402061853,5,0,0,5,5,0,0.0,0.0,1.0,1.0,0.0
7035,89,80,9,75,14,0.898876404494382,0.10112359550561797,0.8426966292134831,0.15730337078651685,13,0,0,13,10,3,0.0,0.0,1.0,0.7692307692307693,0.23076923076923078
7036,241,188,53,157,84,0.7800829875518672,0.21991701244813278,0.6514522821576764,0.34854771784232363,7,0,0,7,7,0,0.0,0.0,1.0,1.0,0.0
7037,137,135,2,88,49,0.9854014598540146,0.014598540145985401,0.6423357664233577,0.35766423357664234,46,0,0,46,44,2,0.0,0.0,1.0,0.9565217391304348,0.043478260869565216
7038,149,89,60,97,52,0.5973154362416108,0.40268456375838924,0.6510067114093959,0.348993288590604,13,0,0,13,10,3,0.0,0.0,1.0,0.7692307692307693,0.23076923076923078
7039,79,45,34,57,22,0.569620253164557,0.43037974683544306,0.7215189873417721,0.27848101265822783,13,0,0,13,10,3,0.0,0.0,1.0,0.7692307692307693,0.23076923076923078
7040,541,482,59,322,219,0.8909426987060998,0.10905730129390019,0.5951940850277264,0.4048059149722736,5,0,0,5,5,0,0.0,0.0,1.0,1.0,0.0
7041,252,206,46,148,104,0.8174603174603174,0.18253968253968253,0.5873015873015873,0.4126984126984127,7,0,0,7,7,0,0.0,0.0,1.0,1.0,0.0
7042,391,341,50,232,159,0.8721227621483376,0.1278772378516624,0.5933503836317136,0.40664961636828645,5,0,0,5,5,0,0.0,0.0,1.0,1.0,0.0
7043,383,334,49,230,153,0.8720626631853786,0.1279373368146214,0.6005221932114883,0.39947780678851175,5,0,0,5,5,0,0.0,0.0,1.0,1.0,0.0
7044,283,252,31,166,117,0.8904593639575972,0.10954063604240283,0.5865724381625441,0.4134275618374558,7,0,0,7,7,0,0.0,0.0,1.0,1.0,0.0
7045,153,130,23,95,58,0.8496732026143791,0.1503267973856209,0.6209150326797386,0.3790849673202614,7,0,0,7,7,0,0.0,0.0,1.0,1.0,0.0
7046,641,562,79,387,254,0.8767550702028081,0.12324492979719189,0.6037441497659907,0.3962558502340094,5,0,0,5,5,0,0.0,0.0,1.0,1.0,0.0
7047,0,0,0,0,0,0.0,0.0,0.0,0.0,0,0,0,0,0,0,0.0,0.0,0.0,0.0,0.0
7048,38,32,6,17,21,0.8421052631578947,0.15789473684210525,0.4473684210526316,0.5526315789473685,7,0,0,7,7,0,0.0,0.0,1.0,1.0,0.0
7049,436,400,36,260,176,0.9174311926605505,0.08256880733944955,0.5963302752293578,0.4036697247706422,5,0,0,5,5,0,0.0,0.0,1.0,1.0,0.0
7050,411,351,60,252,159,0.8540145985401459,0.145985401459854,0.6131386861313869,0.38686131386861317,5,0,0,5,5,0,0.0,0.0,1.0,1.0,0.0
7051,934,927,7,907,27,0.9925053533190579,0.007494646680942184,0.9710920770877944,0.028907922912205567,8,0,0,8,8,0,0.0,0.0,1.0,1.0,0.0
7052,204,121,83,137,67,0.5931372549019608,0.4068627450980392,0.6715686274509803,0.3284313725490196,12,0,0,12,9,3,0.0,0.0,1.0,0.75,0.25
7053,106,62,44,80,26,0.5849056603773585,0.41509433962264153,0.7547169811320755,0.24528301886792453,7,0,0,7,7,0,0.0,0.0,1.0,1.0,0.0
7054,96,87,9,82,14,0.90625,0.09375,0.8541666666666666,0.14583333333333334,13,0,0,13,10,3,0.0,0.0,1.0,0.7692307692307693,0.23076923076923078
7055,71,62,9,57,14,0.8732394366197183,0.1267605633802817,0.8028169014084507,0.19718309859154928,13,0,0,13,10,3,0.0,0.0,1.0,0.7692307692307693,0.23076923076923078
7056,82,47,35,64,18,0.573170731707317,0.4268292682926829,0.7804878048780488,0.21951219512195122,7,0,0,7,7,0,0.0,0.0,1.0,1.0,0.0
7057,211,186,25,115,96,0.8815165876777251,0.11848341232227488,0.5450236966824644,0.4549763033175355,5,0,0,5,5,0,0.0,0.0,1.0,1.0,0.0
7058,86,86,0,77,9,1.0,0.0,0.8953488372093024,0.10465116279069768,5,0,0,5,5,0,0.0,0.0,1.0,1.0,0.0
7059,158,137,21,88,70,0.8670886075949367,0.13291139240506328,0.5569620253164557,0.4430379746835443,7,0,0,7,7,0,0.0,0.0,1.0,1.0,0.0
7060,83,50,33,62,21,0.6024096385542169,0.39759036144578314,0.7469879518072289,0.25301204819277107,7,0,0,7,7,0,0.0,0.0,1.0,1.0,0.0
7061,1355,1348,7,1105,250,0.9948339483394834,0.0051660516605166054,0.8154981549815498,0.18450184501845018,8,0,0,8,8,0,0.0,0.0,1.0,1.0,0.0
7062,1372,1364,8,1102,270,0.9941690962099126,0.0058309037900874635,0.8032069970845481,0.1967930029154519,3,0,0,3,3,0,0.0,0.0,1.0,1.0,0.0
7063,3,2,1,1,2,0.6666666666666666,0.3333333333333333,0.3333333333333333,0.6666666666666666,5,0,0,5,5,0,0.0,0.0,1.0,1.0,0.0
7064,819,811,8,786,33,0.9902319902319903,0.009768009768009768,0.9597069597069597,0.040293040293040296,7,0,0,7,7,0,0.0,0.0,1.0,1.0,0.0
7065,228,205,23,125,103,0.8991228070175439,0.10087719298245613,0.5482456140350878,0.4517543859649123,5,0,0,5,5,0,0.0,0.0,1.0,1.0,0.0
7066,1228,1222,6,988,240,0.995114006514658,0.004885993485342019,0.8045602605863192,0.19543973941368079,5,0,0,5,5,0,0.0,0.0,1.0,1.0,0.0
7067,85,76,9,70,15,0.8941176470588236,0.10588235294117647,0.8235294117647058,0.17647058823529413,13,0,0,13,10,3,0.0,0.0,1.0,0.7692307692307693,0.23076923076923078
7068,358,311,47,211,147,0.8687150837988827,0.13128491620111732,0.5893854748603352,0.4106145251396648,5,0,0,5,5,0,0.0,0.0,1.0,1.0,0.0
7069,366,315,51,226,140,0.860655737704918,0.13934426229508196,0.6174863387978142,0.3825136612021858,5,0,0,5,5,0,0.0,0.0,1.0,1.0,0.0
7070,88,51,37,57,31,0.5795454545454546,0.42045454545454547,0.6477272727272727,0.3522727272727273,13,0,0,13,10,3,0.0,0.0,1.0,0.7692307692307693,0.23076923076923078
7071,81,45,36,57,24,0.5555555555555556,0.4444444444444444,0.7037037037037037,0.2962962962962963,7,0,0,7,7,0,0.0,0.0,1.0,1.0,0.0
7072,116,92,24,82,34,0.7931034482758621,0.20689655172413793,0.7068965517241379,0.29310344827586204,7,0,0,7,7,0,0.0,0.0,1.0,1.0,0.0
7073,1367,1360,7,1123,244,0.9948792977322605,0.005120702267739576,0.8215069495245062,0.17849305047549377,5,0,0,5,5,0,0.0,0.0,1.0,1.0,0.0
7074,38,21,17,25,13,0.5526315789473685,0.4473684210526316,0.6578947368421053,0.34210526315789475,13,0,0,13,10,3,0.0,0.0,1.0,0.7692307692307693,0.23076923076923078
7075,375,332,43,225,150,0.8853333333333333,0.11466666666666667,0.6,0.4,5,0,0,5,5,0,0.0,0.0,1.0,1.0,0.0
7076,115,83,32,74,41,0.7217391304347827,0.2782608695652174,0.6434782608695652,0.3565217391304348,7,0,0,7,7,0,0.0,0.0,1.0,1.0,0.0
7077,232,140,92,156,76,0.603448275862069,0.39655172413793105,0.6724137931034483,0.3275862068965517,13,0,0,13,10,3,0.0,0.0,1.0,0.7692307692307693,0.23076923076923078
7078,70,37,33,48,22,0.5285714285714286,0.4714285714285714,0.6857142857142857,0.3142857142857143,7,0,0,7,7,0,0.0,0.0,1.0,1.0,0.0
7079,119,91,28,79,40,0.7647058823529411,0.23529411764705882,0.6638655462184874,0.33613445378151263,7,0,0,7,7,0,0.0,0.0,1.0,1.0,0.0
7080,1333,1326,7,1092,241,0.994748687171793,0.005251312828207052,0.8192048012003,0.18079519879969994,5,0,0,5,5,0,0.0,0.0,1.0,1.0,0.0
7081,106,94,12,63,43,0.8867924528301887,0.11320754716981132,0.5943396226415094,0.4056603773584906,7,0,0,7,7,0,0.0,0.0,1.0,1.0,0.0
7082,13,7,6,10,3,0.5384615384615384,0.46153846153846156,0.7692307692307693,0.23076923076923078,7,0,0,7,7,0,0.0,0.0,1.0,1.0,0.0
7083,1285,1278,7,1062,223,0.9945525291828794,0.005447470817120622,0.8264591439688715,0.1735408560311284,5,0,0,5,5,0,0.0,0.0,1.0,1.0,0.0
7084,86,65,21,58,28,0.7558139534883721,0.2441860465116279,0.6744186046511628,0.32558139534883723,7,0,0,7,7,0,0.0,0.0,1.0,1.0,0.0
7085,142,142,0,116,26,1.0,0.0,0.8169014084507042,0.18309859154929578,9,1,0,8,9,0,0.1111111111111111,0.0,0.8888888888888888,1.0,0.0
7086,476,422,54,268,208,0.8865546218487395,0.1134453781512605,0.5630252100840336,0.4369747899159664,5,0,0,5,5,0,0.0,0.0,1.0,1.0,0.0
7087,522,464,58,318,204,0.8888888888888888,0.1111111111111111,0.6091954022988506,0.39080459770114945,5,0,0,5,5,0,0.0,0.0,1.0,1.0,0.0
7088,92,77,15,59,33,0.8369565217391305,0.16304347826086957,0.6413043478260869,0.358695652173913,7,0,0,7,7,0,0.0,0.0,1.0,1.0,0.0
7089,540,473,67,332,208,0.8759259259259259,0.12407407407407407,0.6148148148148148,0.3851851851851852,5,0,0,5,5,0,0.0,0.0,1.0,1.0,0.0
7090,500,430,70,301,199,0.86,0.14,0.602,0.398,5,0,0,5,5,0,0.0,0.0,1.0,1.0,0.0
7091,0,0,0,0,0,0.0,0.0,0.0,0.0,0,0,0,0,0,0,0.0,0.0,0.0,0.0,0.0
7092,73,45,28,52,21,0.6164383561643836,0.3835616438356164,0.7123287671232876,0.2876712328767123,7,0,0,7,7,0,0.0,0.0,1.0,1.0,0.0
7093,255,192,63,231,24,0.7529411764705882,0.24705882352941178,0.9058823529411765,0.09411764705882353,13,0,0,13,10,3,0.0,0.0,1.0,0.7692307692307693,0.23076923076923078
7094,347,283,64,205,142,0.8155619596541787,0.1844380403458213,0.590778097982709,0.4092219020172911,5,0,0,5,5,0,0.0,0.0,1.0,1.0,0.0
7095,183,144,39,119,64,0.7868852459016393,0.21311475409836064,0.6502732240437158,0.34972677595628415,7,0,0,7,7,0,0.0,0.0,1.0,1.0,0.0
7096,537,477,60,320,217,0.888268156424581,0.11173184357541899,0.595903165735568,0.40409683426443205,5,0,0,5,5,0,0.0,0.0,1.0,1.0,0.0
7097,90,81,9,76,14,0.9,0.1,0.8444444444444444,0.15555555555555556,13,0,0,13,10,3,0.0,0.0,1.0,0.7692307692307693,0.23076923076923078
7098,342,308,34,212,130,0.9005847953216374,0.09941520467836257,0.6198830409356725,0.38011695906432746,5,0,0,5,5,0,0.0,0.0,1.0,1.0,0.0
7099,410,339,71,248,162,0.8268292682926829,0.17317073170731706,0.6048780487804878,0.3951219512195122,5,0,0,5,5,0,0.0,0.0,1.0,1.0,0.0
7100,33,28,5,32,1,0.8484848484848485,0.15151515151515152,0.9696969696969697,0.030303030303030304,119,24,49,46,117,2,0.20168067226890757,0.4117647058823529,0.3865546218487395,0.9831932773109243,0.01680672268907563
7101,387,339,48,235,152,0.875968992248062,0.12403100775193798,0.6072351421188631,0.39276485788113696,6,0,0,6,6,0,0.0,0.0,1.0,1.0,0.0
7102,432,369,63,269,163,0.8541666666666666,0.14583333333333334,0.6226851851851852,0.3773148148148148,5,0,0,5,5,0,0.0,0.0,1.0,1.0,0.0
7103,395,346,49,223,172,0.8759493670886076,0.1240506329113924,0.5645569620253165,0.43544303797468353,7,0,0,7,7,0,0.0,0.0,1.0,1.0,0.0
7104,330,297,33,187,143,0.9,0.1,0.5666666666666667,0.43333333333333335,7,0,0,7,7,0,0.0,0.0,1.0,1.0,0.0
7105,468,401,67,305,163,0.8568376068376068,0.14316239316239315,0.6517094017094017,0.3482905982905983,6,0,0,6,6,0,0.0,0.0,1.0,1.0,0.0
7106,446,421,25,372,74,0.9439461883408071,0.05605381165919283,0.8340807174887892,0.16591928251121077,43,5,25,13,40,3,0.11627906976744186,0.5813953488372093,0.3023255813953488,0.9302325581395349,0.06976744186046512
7107,1404,1396,8,1145,259,0.9943019943019943,0.005698005698005698,0.8155270655270656,0.18447293447293447,8,0,0,8,8,0,0.0,0.0,1.0,1.0,0.0
7108,159,87,72,111,48,0.5471698113207547,0.4528301886792453,0.6981132075471698,0.3018867924528302,13,0,0,13,10,3,0.0,0.0,1.0,0.7692307692307693,0.23076923076923078
7109,191,104,87,129,62,0.5445026178010471,0.45549738219895286,0.675392670157068,0.32460732984293195,13,0,0,13,10,3,0.0,0.0,1.0,0.7692307692307693,0.23076923076923078
7110,106,97,9,91,15,0.9150943396226415,0.08490566037735849,0.8584905660377359,0.14150943396226415,13,0,0,13,10,3,0.0,0.0,1.0,0.7692307692307693,0.23076923076923078
7111,956,948,8,919,37,0.9916317991631799,0.008368200836820083,0.9612970711297071,0.038702928870292884,8,0,0,8,8,0,0.0,0.0,1.0,1.0,0.0
7112,527,460,67,329,198,0.872865275142315,0.127134724857685,0.6242884250474383,0.3757115749525617,5,0,0,5,5,0,0.0,0.0,1.0,1.0,0.0
7113,1314,1308,6,1034,280,0.9954337899543378,0.0045662100456621,0.786910197869102,0.213089802130898,4,0,0,4,4,0,0.0,0.0,1.0,1.0,0.0
7114,365,310,55,226,139,0.8493150684931506,0.1506849315068493,0.6191780821917808,0.38082191780821917,5,0,0,5,5,0,0.0,0.0,1.0,1.0,0.0
7115,95,86,9,81,14,0.9052631578947369,0.09473684210526316,0.8526315789473684,0.14736842105263157,13,0,0,13,10,3,0.0,0.0,1.0,0.7692307692307693,0.23076923076923078
7116,321,274,47,191,130,0.8535825545171339,0.14641744548286603,0.5950155763239875,0.40498442367601245,5,0,0,5,5,0,0.0,0.0,1.0,1.0,0.0
7117,1108,1099,9,675,433,0.9918772563176895,0.008122743682310469,0.6092057761732852,0.3907942238267148,8,0,0,8,8,0,0.0,0.0,1.0,1.0,0.0
7118,383,330,53,234,149,0.8616187989556136,0.13838120104438642,0.6109660574412533,0.38903394255874674,5,0,0,5,5,0,0.0,0.0,1.0,1.0,0.0
7119,182,161,21,103,79,0.8846153846153846,0.11538461538461539,0.5659340659340659,0.4340659340659341,7,0,0,7,7,0,0.0,0.0,1.0,1.0,0.0
7120,280,244,36,158,122,0.8714285714285714,0.12857142857142856,0.5642857142857143,0.4357142857142857,5,0,0,5,5,0,0.0,0.0,1.0,1.0,0.0
7121,103,94,9,89,14,0.912621359223301,0.08737864077669903,0.8640776699029126,0.13592233009708737,13,0,0,13,10,3,0.0,0.0,1.0,0.7692307692307693,0.23076923076923078
7122,261,227,34,154,107,0.8697318007662835,0.13026819923371646,0.5900383141762452,0.4099616858237548,7,0,0,7,7,0,0.0,0.0,1.0,1.0,0.0
7123,308,279,29,180,128,0.9058441558441559,0.09415584415584416,0.5844155844155844,0.4155844155844156,5,0,0,5,5,0,0.0,0.0,1.0,1.0,0.0
7124,268,222,46,163,105,0.8283582089552238,0.17164179104477612,0.6082089552238806,0.3917910447761194,7,0,0,7,7,0,0.0,0.0,1.0,1.0,0.0
7125,589,517,72,363,226,0.8777589134125636,0.12224108658743633,0.6162988115449916,0.3837011884550085,5,0,0,5,5,0,0.0,0.0,1.0,1.0,0.0
7126,343,294,49,208,135,0.8571428571428571,0.14285714285714285,0.6064139941690962,0.3935860058309038,5,0,0,5,5,0,0.0,0.0,1.0,1.0,0.0
7127,86,77,9,72,14,0.8953488372093024,0.10465116279069768,0.8372093023255814,0.16279069767441862,13,0,0,13,10,3,0.0,0.0,1.0,0.7692307692307693,0.23076923076923078
7128,391,293,98,358,33,0.7493606138107417,0.2506393861892583,0.9156010230179028,0.08439897698209718,13,0,0,13,10,3,0.0,0.0,1.0,0.7692307692307693,0.23076923076923078
7129,363,302,61,203,160,0.8319559228650137,0.16804407713498623,0.559228650137741,0.44077134986225897,5,0,0,5,5,0,0.0,0.0,1.0,1.0,0.0
7130,0,0,0,0,0,0.0,0.0,0.0,0.0,0,0,0,0,0,0,0.0,0.0,0.0,0.0,0.0
7131,580,510,70,346,234,0.8793103448275862,0.1206896551724138,0.596551724137931,0.40344827586206894,5,0,0,5,5,0,0.0,0.0,1.0,1.0,0.0
7132,358,303,55,215,143,0.8463687150837989,0.15363128491620112,0.6005586592178771,0.3994413407821229,5,0,0,5,5,0,0.0,0.0,1.0,1.0,0.0
7133,216,190,26,125,91,0.8796296296296297,0.12037037037037036,0.5787037037037037,0.4212962962962963,7,0,0,7,7,0,0.0,0.0,1.0,1.0,0.0
7134,115,106,9,100,15,0.9217391304347826,0.0782608695652174,0.8695652173913043,0.13043478260869565,13,0,0,13,10,3,0.0,0.0,1.0,0.7692307692307693,0.23076923076923078
7135,1363,1356,7,1103,260,0.9948642699926632,0.005135730007336757,0.8092443140132062,0.19075568598679385,5,0,0,5,5,0,0.0,0.0,1.0,1.0,0.0
7136,96,96,0,76,20,1.0,0.0,0.7916666666666666,0.20833333333333334,11,1,2,8,8,3,0.09090909090909091,0.18181818181818182,0.7272727272727273,0.7272727272727273,0.2727272727272727
7137,355,303,52,229,126,0.8535211267605634,0.14647887323943662,0.6450704225352113,0.35492957746478876,5,0,0,5,5,0,0.0,0.0,1.0,1.0,0.0
7138,569,516,53,322,247,0.9068541300527241,0.09314586994727592,0.5659050966608085,0.43409490333919154,7,0,0,7,7,0,0.0,0.0,1.0,1.0,0.0
7139,280,248,32,151,129,0.8857142857142857,0.11428571428571428,0.5392857142857143,0.4607142857142857,7,0,0,7,7,0,0.0,0.0,1.0,1.0,0.0
7140,393,233,160,279,114,0.5928753180661578,0.4071246819338422,0.7099236641221374,0.2900763358778626,13,0,0,13,10,3,0.0,0.0,1.0,0.7692307692307693,0.23076923076923078
7141,1324,1317,7,1067,257,0.9947129909365559,0.005287009063444109,0.8058912386706949,0.19410876132930513,5,0,0,5,5,0,0.0,0.0,1.0,1.0,0.0
7142,467,411,56,284,183,0.880085653104925,0.11991434689507495,0.6081370449678801,0.39186295503211993,5,0,0,5,5,0,0.0,0.0,1.0,1.0,0.0
7143,80,80,0,62,18,1.0,0.0,0.775,0.225,10,1,1,8,8,2,0.1,0.1,0.8,0.8,0.2
7144,35,20,15,23,12,0.5714285714285714,0.42857142857142855,0.6571428571428571,0.34285714285714286,7,0,0,7,7,0,0.0,0.0,1.0,1.0,0.0
7145,298,182,116,199,99,0.610738255033557,0.38926174496644295,0.6677852348993288,0.33221476510067116,13,0,0,13,10,3,0.0,0.0,1.0,0.7692307692307693,0.23076923076923078
7146,35,30,5,34,1,0.8571428571428571,0.14285714285714285,0.9714285714285714,0.02857142857142857,109,28,50,31,107,2,0.25688073394495414,0.45871559633027525,0.28440366972477066,0.981651376146789,0.01834862385321101
7147,97,88,9,83,14,0.9072164948453608,0.09278350515463918,0.8556701030927835,0.14432989690721648,14,0,0,14,11,3,0.0,0.0,1.0,0.7857142857142857,0.21428571428571427
7148,56,31,25,37,19,0.5535714285714286,0.44642857142857145,0.6607142857142857,0.3392857142857143,7,0,0,7,7,0,0.0,0.0,1.0,1.0,0.0
7149,399,340,59,264,135,0.8521303258145363,0.14786967418546365,0.6616541353383458,0.3383458646616541,5,0,0,5,5,0,0.0,0.0,1.0,1.0,0.0
7150,298,246,52,180,118,0.825503355704698,0.174496644295302,0.6040268456375839,0.3959731543624161,5,0,0,5,5,0,0.0,0.0,1.0,1.0,0.0
7151,0,0,0,0,0,0.0,0.0,0.0,0.0,0,0,0,0,0,0,0.0,0.0,0.0,0.0,0.0
7152,385,347,38,227,158,0.9012987012987013,0.0987012987012987,0.5896103896103896,0.4103896103896104,5,0,0,5,5,0,0.0,0.0,1.0,1.0,0.0
7153,0,0,0,0,0,0.0,0.0,0.0,0.0,0,0,0,0,0,0,0.0,0.0,0.0,0.0,0.0
7154,1314,1307,7,1073,241,0.9946727549467276,0.00532724505327245,0.8165905631659056,0.18340943683409436,8,0,0,8,8,0,0.0,0.0,1.0,1.0,0.0
7155,188,110,78,130,58,0.5851063829787234,0.4148936170212766,0.6914893617021277,0.30851063829787234,13,0,0,13,10,3,0.0,0.0,1.0,0.7692307692307693,0.23076923076923078
7156,502,449,53,301,201,0.8944223107569721,0.10557768924302789,0.599601593625498,0.40039840637450197,5,0,0,5,5,0,0.0,0.0,1.0,1.0,0.0
7157,359,308,51,207,152,0.8579387186629527,0.14206128133704735,0.5766016713091922,0.4233983286908078,5,0,0,5,5,0,0.0,0.0,1.0,1.0,0.0
7158,1330,1323,7,1055,275,0.9947368421052631,0.005263157894736842,0.793233082706767,0.20676691729323307,5,0,0,5,5,0,0.0,0.0,1.0,1.0,0.0
7159,503,446,57,306,197,0.8866799204771372,0.11332007952286283,0.6083499005964215,0.39165009940357853,5,0,0,5,5,0,0.0,0.0,1.0,1.0,0.0
7160,409,340,69,242,167,0.8312958435207825,0.1687041564792176,0.5916870415647921,0.4083129584352078,5,0,0,5,5,0,0.0,0.0,1.0,1.0,0.0
7161,328,280,48,187,141,0.8536585365853658,0.14634146341463414,0.5701219512195121,0.4298780487804878,7,0,0,7,7,0,0.0,0.0,1.0,1.0,0.0
7162,1462,1454,8,1180,282,0.9945280437756497,0.005471956224350205,0.8071135430916553,0.19288645690834474,5,0,0,5,5,0,0.0,0.0,1.0,1.0,0.0
7163,153,118,35,99,54,0.7712418300653595,0.22875816993464052,0.6470588235294118,0.35294117647058826,7,0,0,7,7,0,0.0,0.0,1.0,1.0,0.0
7164,96,87,9,82,14,0.90625,0.09375,0.8541666666666666,0.14583333333333334,13,0,0,13,10,3,0.0,0.0,1.0,0.7692307692307693,0.23076923076923078
7165,420,312,108,382,38,0.7428571428571429,0.2571428571428571,0.9095238095238095,0.09047619047619047,13,0,0,13,10,3,0.0,0.0,1.0,0.7692307692307693,0.23076923076923078
7166,105,62,43,76,29,0.5904761904761905,0.4095238095238095,0.7238095238095238,0.2761904761904762,7,0,0,7,7,0,0.0,0.0,1.0,1.0,0.0
7167,110,64,46,70,40,0.5818181818181818,0.41818181818181815,0.6363636363636364,0.36363636363636365,13,0,0,13,10,3,0.0,0.0,1.0,0.7692307692307693,0.23076923076923078
7168,30,18,12,23,7,0.6,0.4,0.7666666666666667,0.23333333333333334,7,0,0,7,7,0,0.0,0.0,1.0,1.0,0.0
7169,84,48,36,58,26,0.5714285714285714,0.42857142857142855,0.6904761904761905,0.30952380952380953,7,0,0,7,7,0,0.0,0.0,1.0,1.0,0.0
7170,487,416,71,288,199,0.8542094455852156,0.1457905544147844,0.5913757700205339,0.4086242299794661,5,0,0,5,5,0,0.0,0.0,1.0,1.0,0.0
7171,101,92,9,86,15,0.9108910891089109,0.0891089108910891,0.8514851485148515,0.1485148514851485,14,0,0,14,11,3,0.0,0.0,1.0,0.7857142857142857,0.21428571428571427
7172,1450,1443,7,1185,265,0.9951724137931034,0.004827586206896552,0.8172413793103448,0.18275862068965518,5,0,0,5,5,0,0.0,0.0,1.0,1.0,0.0
7173,176,155,21,96,80,0.8806818181818182,0.11931818181818182,0.5454545454545454,0.45454545454545453,7,0,0,7,7,0,0.0,0.0,1.0,1.0,0.0
7174,0,0,0,0,0,0.0,0.0,0.0,0.0,0,0,0,0,0,0,0.0,0.0,0.0,0.0,0.0
7175,76,67,9,60,16,0.881578947368421,0.11842105263157894,0.7894736842105263,0.21052631578947367,13,0,0,13,10,3,0.0,0.0,1.0,0.7692307692307693,0.23076923076923078
7176,1318,1311,7,1086,232,0.9946889226100152,0.005311077389984826,0.8239757207890743,0.17602427921092564,5,0,0,5,5,0,0.0,0.0,1.0,1.0,0.0
7177,516,455,61,304,212,0.8817829457364341,0.1182170542635659,0.5891472868217055,0.4108527131782946,5,0,0,5,5,0,0.0,0.0,1.0,1.0,0.0
7178,163,93,70,115,48,0.5705521472392638,0.4294478527607362,0.7055214723926381,0.294478527607362,7,0,0,7,7,0,0.0,0.0,1.0,1.0,0.0
7179,846,838,8,813,33,0.9905437352245863,0.009456264775413711,0.9609929078014184,0.03900709219858156,8,0,0,8,8,0,0.0,0.0,1.0,1.0,0.0
7180,18,14,4,12,6,0.7777777777777778,0.2222222222222222,0.6666666666666666,0.3333333333333333,7,0,0,7,7,0,0.0,0.0,1.0,1.0,0.0
7181,138,137,1,90,48,0.9927536231884058,0.007246376811594203,0.6521739130434783,0.34782608695652173,46,0,0,46,44,2,0.0,0.0,1.0,0.9565217391304348,0.043478260869565216
7182,663,505,158,620,43,0.7616892911010558,0.2383107088989442,0.9351432880844646,0.06485671191553545,13,0,0,13,10,3,0.0,0.0,1.0,0.7692307692307693,0.23076923076923078
7183,1351,1343,8,1081,270,0.9940784603997039,0.005921539600296077,0.8001480384900074,0.1998519615099926,5,0,0,5,5,0,0.0,0.0,1.0,1.0,0.0
7184,1449,1443,6,1180,269,0.9958592132505176,0.004140786749482402,0.8143547273982057,0.18564527260179434,5,0,0,5,5,0,0.0,0.0,1.0,1.0,0.0
7185,317,277,40,192,125,0.8738170347003155,0.12618296529968454,0.6056782334384858,0.3943217665615142,5,0,0,5,5,0,0.0,0.0,1.0,1.0,0.0
7186,571,500,71,358,213,0.8756567425569177,0.1243432574430823,0.626970227670753,0.37302977232924694,5,0,0,5,5,0,0.0,0.0,1.0,1.0,0.0
7187,97,88,9,83,14,0.9072164948453608,0.09278350515463918,0.8556701030927835,0.14432989690721648,13,0,0,13,10,3,0.0,0.0,1.0,0.7692307692307693,0.23076923076923078
7188,339,290,49,202,137,0.855457227138643,0.14454277286135694,0.5958702064896755,0.40412979351032446,5,0,0,5,5,0,0.0,0.0,1.0,1.0,0.0
7189,376,331,45,226,150,0.8803191489361702,0.1196808510638298,0.601063829787234,0.39893617021276595,5,0,0,5,5,0,0.0,0.0,1.0,1.0,0.0
7190,416,362,54,253,163,0.8701923076923077,0.12980769230769232,0.6081730769230769,0.3918269230769231,5,0,0,5,5,0,0.0,0.0,1.0,1.0,0.0
7191,1402,1396,6,1136,266,0.9957203994293866,0.0042796005706134095,0.8102710413694721,0.18972895863052783,5,0,0,5,5,0,0.0,0.0,1.0,1.0,0.0
7192,436,377,59,260,176,0.8646788990825688,0.1353211009174312,0.5963302752293578,0.4036697247706422,5,0,0,5,5,0,0.0,0.0,1.0,1.0,0.0
7193,85,85,0,75,10,1.0,0.0,0.8823529411764706,0.11764705882352941,10,1,1,8,8,2,0.1,0.1,0.8,0.8,0.2
7194,98,89,9,83,15,0.9081632653061225,0.09183673469387756,0.8469387755102041,0.15306122448979592,13,0,0,13,10,3,0.0,0.0,1.0,0.7692307692307693,0.23076923076923078
7195,597,532,65,359,238,0.8911222780569514,0.10887772194304858,0.6013400335008375,0.39865996649916247,5,0,0,5,5,0,0.0,0.0,1.0,1.0,0.0
7196,377,305,72,220,157,0.8090185676392573,0.1909814323607427,0.583554376657825,0.41644562334217505,5,0,0,5,5,0,0.0,0.0,1.0,1.0,0.0
7197,375,320,55,225,150,0.8533333333333334,0.14666666666666667,0.6,0.4,5,0,0,5,5,0,0.0,0.0,1.0,1.0,0.0
7198,91,57,34,60,31,0.6263736263736264,0.37362637362637363,0.6593406593406593,0.34065934065934067,7,0,0,7,7,0,0.0,0.0,1.0,1.0,0.0
7199,564,501,63,358,206,0.8882978723404256,0.11170212765957446,0.6347517730496454,0.36524822695035464,5,0,0,5,5,0,0.0,0.0,1.0,1.0,0.0
7200,413,348,65,251,162,0.8426150121065376,0.15738498789346247,0.6077481840193705,0.3922518159806295,5,0,0,5,5,0,0.0,0.0,1.0,1.0,0.0
7201,392,352,40,240,152,0.8979591836734694,0.10204081632653061,0.6122448979591837,0.3877551020408163,5,0,0,5,5,0,0.0,0.0,1.0,1.0,0.0
7202,1020,1012,8,625,395,0.9921568627450981,0.00784313725490196,0.6127450980392157,0.3872549019607843,8,0,0,8,8,0,0.0,0.0,1.0,1.0,0.0
7203,320,266,54,193,127,0.83125,0.16875,0.603125,0.396875,5,0,0,5,5,0,0.0,0.0,1.0,1.0,0.0
7204,375,318,57,226,149,0.848,0.152,0.6026666666666667,0.3973333333333333,5,0,0,5,5,0,0.0,0.0,1.0,1.0,0.0
7205,297,253,44,171,126,0.8518518518518519,0.14814814814814814,0.5757575757575758,0.42424242424242425,5,0,0,5,5,0,0.0,0.0,1.0,1.0,0.0
7206,161,86,75,117,44,0.5341614906832298,0.4658385093167702,0.7267080745341615,0.2732919254658385,14,0,0,14,11,3,0.0,0.0,1.0,0.7857142857142857,0.21428571428571427
7207,54,46,8,29,25,0.8518518518518519,0.14814814814814814,0.5370370370370371,0.46296296296296297,7,0,0,7,7,0,0.0,0.0,1.0,1.0,0.0
7208,109,100,9,95,14,0.9174311926605505,0.08256880733944955,0.8715596330275229,0.12844036697247707,13,0,0,13,10,3,0.0,0.0,1.0,0.7692307692307693,0.23076923076923078
7209,394,346,48,243,151,0.8781725888324873,0.1218274111675127,0.616751269035533,0.383248730964467,5,0,0,5,5,0,0.0,0.0,1.0,1.0,0.0
7210,1329,1322,7,1080,249,0.9947328818660647,0.005267118133935289,0.8126410835214447,0.1873589164785553,5,0,0,5,5,0,0.0,0.0,1.0,1.0,0.0
7211,309,277,32,175,134,0.8964401294498382,0.10355987055016182,0.5663430420711975,0.4336569579288026,5,0,0,5,5,0,0.0,0.0,1.0,1.0,0.0
7212,241,210,31,132,109,0.8713692946058091,0.12863070539419086,0.5477178423236515,0.45228215767634855,7,0,0,7,7,0,0.0,0.0,1.0,1.0,0.0
7213,316,262,54,202,114,0.8291139240506329,0.17088607594936708,0.6392405063291139,0.36075949367088606,5,0,0,5,5,0,0.0,0.0,1.0,1.0,0.0
7214,0,0,0,0,0,0.0,0.0,0.0,0.0,0,0,0,0,0,0,0.0,0.0,0.0,0.0,0.0
7215,322,271,51,190,132,0.8416149068322981,0.15838509316770186,0.5900621118012422,0.40993788819875776,5,0,0,5,5,0,0.0,0.0,1.0,1.0,0.0
7216,106,94,12,65,41,0.8867924528301887,0.11320754716981132,0.6132075471698113,0.3867924528301887,5,0,0,5,5,0,0.0,0.0,1.0,1.0,0.0
7217,329,278,51,201,128,0.8449848024316109,0.15501519756838905,0.6109422492401215,0.3890577507598784,5,0,0,5,5,0,0.0,0.0,1.0,1.0,0.0
7218,190,141,49,183,7,0.7421052631578947,0.2578947368421053,0.9631578947368421,0.03684210526315789,13,0,0,13,10,3,0.0,0.0,1.0,0.7692307692307693,0.23076923076923078
7219,449,409,40,266,183,0.910913140311804,0.08908685968819599,0.5924276169265034,0.40757238307349664,5,0,0,5,5,0,0.0,0.0,1.0,1.0,0.0
7220,236,209,27,146,90,0.885593220338983,0.11440677966101695,0.6186440677966102,0.3813559322033898,5,0,0,5,5,0,0.0,0.0,1.0,1.0,0.0
7221,240,143,97,160,80,0.5958333333333333,0.4041666666666667,0.6666666666666666,0.3333333333333333,13,0,0,13,10,3,0.0,0.0,1.0,0.7692307692307693,0.23076923076923078
7222,94,85,9,79,15,0.9042553191489362,0.09574468085106383,0.8404255319148937,0.1595744680851064,13,0,0,13,10,3,0.0,0.0,1.0,0.7692307692307693,0.23076923076923078
7223,84,47,37,62,22,0.5595238095238095,0.44047619047619047,0.7380952380952381,0.2619047619047619,7,0,0,7,7,0,0.0,0.0,1.0,1.0,0.0
7224,131,113,18,76,55,0.8625954198473282,0.13740458015267176,0.5801526717557252,0.4198473282442748,7,0,0,7,7,0,0.0,0.0,1.0,1.0,0.0
7225,172,147,25,106,66,0.8546511627906976,0.14534883720930233,0.6162790697674418,0.38372093023255816,7,0,0,7,7,0,0.0,0.0,1.0,1.0,0.0
7226,1440,1434,6,1181,259,0.9958333333333333,0.004166666666666667,0.8201388888888889,0.1798611111111111,5,0,0,5,5,0,0.0,0.0,1.0,1.0,0.0
7227,144,89,55,96,48,0.6180555555555556,0.3819444444444444,0.6666666666666666,0.3333333333333333,13,0,0,13,10,3,0.0,0.0,1.0,0.7692307692307693,0.23076923076923078
7228,404,354,50,241,163,0.8762376237623762,0.12376237623762376,0.5965346534653465,0.4034653465346535,5,0,0,5,5,0,0.0,0.0,1.0,1.0,0.0
7229,68,42,26,39,29,0.6176470588235294,0.38235294117647056,0.5735294117647058,0.4264705882352941,7,0,0,7,7,0,0.0,0.0,1.0,1.0,0.0
7230,315,257,58,189,126,0.8158730158730159,0.18412698412698414,0.6,0.4,5,0,0,5,5,0,0.0,0.0,1.0,1.0,0.0
7231,89,80,9,75,14,0.898876404494382,0.10112359550561797,0.8426966292134831,0.15730337078651685,13,0,0,13,10,3,0.0,0.0,1.0,0.7692307692307693,0.23076923076923078
7232,1317,1310,7,1068,249,0.9946848899012908,0.005315110098709187,0.8109339407744874,0.18906605922551253,5,0,0,5,5,0,0.0,0.0,1.0,1.0,0.0
7233,31,29,2,17,14,0.9354838709677419,0.06451612903225806,0.5483870967741935,0.45161290322580644,50,0,0,50,47,3,0.0,0.0,1.0,0.94,0.06
7234,43,32,11,42,1,0.7441860465116279,0.2558139534883721,0.9767441860465116,0.023255813953488372,104,28,48,28,102,2,0.2692307692307692,0.46153846153846156,0.2692307692307692,0.9807692307692307,0.019230769230769232
7235,472,345,127,427,45,0.7309322033898306,0.2690677966101695,0.9046610169491526,0.09533898305084745,13,0,0,13,10,3,0.0,0.0,1.0,0.7692307692307693,0.23076923076923078
7236,423,372,51,262,161,0.8794326241134752,0.12056737588652482,0.6193853427895981,0.3806146572104019,5,0,0,5,5,0,0.0,0.0,1.0,1.0,0.0
7237,258,226,32,143,115,0.875968992248062,0.12403100775193798,0.5542635658914729,0.44573643410852715,7,0,0,7,7,0,0.0,0.0,1.0,1.0,0.0
7238,107,98,9,91,16,0.9158878504672897,0.08411214953271028,0.8504672897196262,0.14953271028037382,13,0,0,13,10,3,0.0,0.0,1.0,0.7692307692307693,0.23076923076923078
7239,22,12,10,17,5,0.5454545454545454,0.45454545454545453,0.7727272727272727,0.22727272727272727,7,0,0,7,7,0,0.0,0.0,1.0,1.0,0.0
7240,268,235,33,148,120,0.8768656716417911,0.12313432835820895,0.5522388059701493,0.44776119402985076,5,0,0,5,5,0,0.0,0.0,1.0,1.0,0.0
7241,182,139,43,120,62,0.7637362637362637,0.23626373626373626,0.6593406593406593,0.34065934065934067,7,0,0,7,7,0,0.0,0.0,1.0,1.0,0.0
7242,337,278,59,207,130,0.8249258160237388,0.17507418397626112,0.6142433234421365,0.3857566765578635,5,0,0,5,5,0,0.0,0.0,1.0,1.0,0.0
7243,214,182,32,130,84,0.8504672897196262,0.14953271028037382,0.6074766355140186,0.3925233644859813,7,0,0,7,7,0,0.0,0.0,1.0,1.0,0.0
7244,0,0,0,0,0,0.0,0.0,0.0,0.0,0,0,0,0,0,0,0.0,0.0,0.0,0.0,0.0
7245,323,257,66,187,136,0.7956656346749226,0.2043343653250774,0.5789473684210527,0.42105263157894735,7,0,0,7,7,0,0.0,0.0,1.0,1.0,0.0
7246,1323,1315,8,1077,246,0.9939531368102796,0.006046863189720333,0.8140589569160998,0.18594104308390022,5,0,0,5,5,0,0.0,0.0,1.0,1.0,0.0
7247,352,303,49,207,145,0.8607954545454546,0.13920454545454544,0.5880681818181818,0.4119318181818182,5,0,0,5,5,0,0.0,0.0,1.0,1.0,0.0
7248,379,330,49,226,153,0.8707124010554089,0.12928759894459102,0.5963060686015831,0.40369393139841686,5,0,0,5,5,0,0.0,0.0,1.0,1.0,0.0
7249,433,377,56,262,171,0.8706697459584296,0.12933025404157045,0.605080831408776,0.394919168591224,5,0,0,5,5,0,0.0,0.0,1.0,1.0,0.0
7250,449,411,38,277,172,0.9153674832962138,0.08463251670378619,0.6169265033407573,0.3830734966592428,5,0,0,5,5,0,0.0,0.0,1.0,1.0,0.0
7251,1506,1499,7,1202,304,0.9953519256308101,0.004648074369189907,0.798140770252324,0.20185922974767595,5,0,0,5,5,0,0.0,0.0,1.0,1.0,0.0
7252,0,0,0,0,0,0.0,0.0,0.0,0.0,0,0,0,0,0,0,0.0,0.0,0.0,0.0,0.0
7253,1259,1251,8,1042,217,0.9936457505957109,0.006354249404289118,0.8276409849086577,0.17235901509134233,5,0,0,5,5,0,0.0,0.0,1.0,1.0,0.0
7254,606,536,70,365,241,0.8844884488448845,0.11551155115511551,0.6023102310231023,0.3976897689768977,5,0,0,5,5,0,0.0,0.0,1.0,1.0,0.0
7255,1340,1333,7,1082,258,0.994776119402985,0.0052238805970149255,0.8074626865671641,0.1925373134328358,8,0,0,8,8,0,0.0,0.0,1.0,1.0,0.0
7256,58,35,23,37,21,0.603448275862069,0.39655172413793105,0.6379310344827587,0.3620689655172414,7,0,0,7,7,0,0.0,0.0,1.0,1.0,0.0
7257,474,415,59,284,190,0.8755274261603375,0.12447257383966245,0.5991561181434599,0.4008438818565401,5,0,0,5,5,0,0.0,0.0,1.0,1.0,0.0
7258,103,94,9,89,14,0.912621359223301,0.08737864077669903,0.8640776699029126,0.13592233009708737,13,0,0,13,10,3,0.0,0.0,1.0,0.7692307692307693,0.23076923076923078
7259,81,72,9,67,14,0.8888888888888888,0.1111111111111111,0.8271604938271605,0.1728395061728395,13,0,0,13,10,3,0.0,0.0,1.0,0.7692307692307693,0.23076923076923078
7260,1465,1457,8,1186,279,0.9945392491467577,0.005460750853242321,0.8095563139931741,0.19044368600682593,4,0,0,4,4,0,0.0,0.0,1.0,1.0,0.0
7261,433,370,63,258,175,0.8545034642032333,0.14549653579676675,0.5958429561200924,0.40415704387990764,5,0,0,5,5,0,0.0,0.0,1.0,1.0,0.0
7262,433,373,60,262,171,0.8614318706697459,0.13856812933025403,0.605080831408776,0.394919168591224,5,0,0,5,5,0,0.0,0.0,1.0,1.0,0.0
7263,1400,1392,8,1102,298,0.9942857142857143,0.005714285714285714,0.7871428571428571,0.21285714285714286,5,0,0,5,5,0,0.0,0.0,1.0,1.0,0.0
7264,87,49,38,57,30,0.5632183908045977,0.4367816091954023,0.6551724137931034,0.3448275862068966,13,0,0,13,10,3,0.0,0.0,1.0,0.7692307692307693,0.23076923076923078
7265,1456,1449,7,1171,285,0.9951923076923077,0.004807692307692308,0.8042582417582418,0.19574175824175824,8,0,0,8,8,0,0.0,0.0,1.0,1.0,0.0
7266,426,363,63,266,160,0.852112676056338,0.14788732394366197,0.6244131455399061,0.3755868544600939,5,0,0,5,5,0,0.0,0.0,1.0,1.0,0.0
7267,1395,1388,7,1138,257,0.9949820788530466,0.005017921146953405,0.8157706093189964,0.18422939068100358,8,0,0,8,8,0,0.0,0.0,1.0,1.0,0.0
7268,1440,1432,8,1184,256,0.9944444444444445,0.005555555555555556,0.8222222222222222,0.17777777777777778,5,0,0,5,5,0,0.0,0.0,1.0,1.0,0.0
7269,88,79,9,74,14,0.8977272727272727,0.10227272727272728,0.8409090909090909,0.1590909090909091,13,0,0,13,10,3,0.0,0.0,1.0,0.7692307692307693,0.23076923076923078
7270,113,66,47,79,34,0.584070796460177,0.415929203539823,0.6991150442477876,0.3008849557522124,13,0,0,13,10,3,0.0,0.0,1.0,0.7692307692307693,0.23076923076923078
7271,436,366,70,267,169,0.8394495412844036,0.16055045871559634,0.6123853211009175,0.3876146788990826,5,0,0,5,5,0,0.0,0.0,1.0,1.0,0.0
7272,231,189,42,153,78,0.8181818181818182,0.18181818181818182,0.6623376623376623,0.33766233766233766,7,0,0,7,7,0,0.0,0.0,1.0,1.0,0.0
7273,323,281,42,199,124,0.8699690402476781,0.13003095975232198,0.6160990712074303,0.38390092879256965,5,0,0,5,5,0,0.0,0.0,1.0,1.0,0.0
7274,95,75,20,61,34,0.7894736842105263,0.21052631578947367,0.6421052631578947,0.35789473684210527,7,0,0,7,7,0,0.0,0.0,1.0,1.0,0.0
7275,27,16,11,17,10,0.5925925925925926,0.4074074074074074,0.6296296296296297,0.37037037037037035,7,0,0,7,7,0,0.0,0.0,1.0,1.0,0.0
7276,1345,1338,7,1082,263,0.9947955390334573,0.0052044609665427505,0.8044609665427509,0.19553903345724907,8,0,0,8,8,0,0.0,0.0,1.0,1.0,0.0
7277,194,108,86,129,65,0.5567010309278351,0.44329896907216493,0.6649484536082474,0.33505154639175255,13,0,0,13,10,3,0.0,0.0,1.0,0.7692307692307693,0.23076923076923078
7278,13,8,5,10,3,0.6153846153846154,0.38461538461538464,0.7692307692307693,0.23076923076923078,7,0,0,7,7,0,0.0,0.0,1.0,1.0,0.0
7279,1491,1484,7,1183,308,0.9953051643192489,0.004694835680751174,0.7934272300469484,0.20657276995305165,8,0,0,8,8,0,0.0,0.0,1.0,1.0,0.0
7280,1379,1373,6,1102,277,0.9956490210297317,0.00435097897026831,0.7991298042059464,0.20087019579405366,5,0,0,5,5,0,0.0,0.0,1.0,1.0,0.0
7281,1314,1308,6,1034,280,0.9954337899543378,0.0045662100456621,0.786910197869102,0.213089802130898,5,0,0,5,5,0,0.0,0.0,1.0,1.0,0.0
7282,431,378,53,264,167,0.877030162412993,0.12296983758700696,0.6125290023201856,0.3874709976798144,5,0,0,5,5,0,0.0,0.0,1.0,1.0,0.0
7283,133,108,25,72,61,0.8120300751879699,0.18796992481203006,0.5413533834586466,0.45864661654135336,7,0,0,7,7,0,0.0,0.0,1.0,1.0,0.0
7284,1351,1344,7,1083,268,0.9948186528497409,0.0051813471502590676,0.8016284233900814,0.19837157660991858,5,0,0,5,5,0,0.0,0.0,1.0,1.0,0.0
7285,422,375,47,249,173,0.8886255924170616,0.11137440758293839,0.590047393364929,0.4099526066350711,5,0,0,5,5,0,0.0,0.0,1.0,1.0,0.0
7286,215,181,34,134,81,0.8418604651162791,0.15813953488372093,0.6232558139534884,0.3767441860465116,7,0,0,7,7,0,0.0,0.0,1.0,1.0,0.0
7287,336,303,33,189,147,0.9017857142857143,0.09821428571428571,0.5625,0.4375,7,0,0,7,7,0,0.0,0.0,1.0,1.0,0.0
7288,68,39,29,47,21,0.5735294117647058,0.4264705882352941,0.6911764705882353,0.3088235294117647,13,0,0,13,10,3,0.0,0.0,1.0,0.7692307692307693,0.23076923076923078
7289,389,329,60,243,146,0.8457583547557841,0.15424164524421594,0.6246786632390745,0.37532133676092544,5,0,0,5,5,0,0.0,0.0,1.0,1.0,0.0
7290,300,257,43,168,132,0.8566666666666667,0.14333333333333334,0.56,0.44,7,0,0,7,7,0,0.0,0.0,1.0,1.0,0.0
7291,97,88,9,83,14,0.9072164948453608,0.09278350515463918,0.8556701030927835,0.14432989690721648,13,0,0,13,10,3,0.0,0.0,1.0,0.7692307692307693,0.23076923076923078
7292,4,2,2,4,0,0.5,0.5,1.0,0.0,7,0,0,7,7,0,0.0,0.0,1.0,1.0,0.0
7293,107,65,42,76,31,0.6074766355140186,0.3925233644859813,0.7102803738317757,0.2897196261682243,13,0,0,13,10,3,0.0,0.0,1.0,0.7692307692307693,0.23076923076923078
7294,0,0,0,0,0,0.0,0.0,0.0,0.0,0,0,0,0,0,0,0.0,0.0,0.0,0.0,0.0
7295,245,178,67,221,24,0.726530612244898,0.27346938775510204,0.9020408163265307,0.09795918367346938,13,0,0,13,10,3,0.0,0.0,1.0,0.7692307692307693,0.23076923076923078
7296,291,252,39,177,114,0.865979381443299,0.13402061855670103,0.6082474226804123,0.3917525773195876,5,0,0,5,5,0,0.0,0.0,1.0,1.0,0.0
7297,390,338,52,238,152,0.8666666666666667,0.13333333333333333,0.6102564102564103,0.38974358974358975,5,0,0,5,5,0,0.0,0.0,1.0,1.0,0.0
7298,455,389,66,269,186,0.8549450549450549,0.14505494505494507,0.5912087912087912,0.4087912087912088,5,0,0,5,5,0,0.0,0.0,1.0,1.0,0.0
7299,154,94,60,102,52,0.6103896103896104,0.38961038961038963,0.6623376623376623,0.33766233766233766,13,0,0,13,10,3,0.0,0.0,1.0,0.7692307692307693,0.23076923076923078
7300,82,73,9,68,14,0.8902439024390244,0.10975609756097561,0.8292682926829268,0.17073170731707318,13,0,0,13,10,3,0.0,0.0,1.0,0.7692307692307693,0.23076923076923078
7301,1421,1412,9,1163,258,0.9936664320900774,0.0063335679099225895,0.8184377199155525,0.18156228008444758,5,0,0,5,5,0,0.0,0.0,1.0,1.0,0.0
7302,1358,1350,8,1095,263,0.9941089837997055,0.005891016200294551,0.8063328424153167,0.19366715758468336,5,0,0,5,5,0,0.0,0.0,1.0,1.0,0.0
7303,6,3,3,4,2,0.5,0.5,0.6666666666666666,0.3333333333333333,13,0,0,13,10,3,0.0,0.0,1.0,0.7692307692307693,0.23076923076923078
7304,150,86,64,102,48,0.5733333333333334,0.4266666666666667,0.68,0.32,7,0,0,7,7,0,0.0,0.0,1.0,1.0,0.0
7305,156,132,24,82,74,0.8461538461538461,0.15384615384615385,0.5256410256410257,0.47435897435897434,7,0,0,7,7,0,0.0,0.0,1.0,1.0,0.0
7306,74,46,28,53,21,0.6216216216216216,0.3783783783783784,0.7162162162162162,0.28378378378378377,7,0,0,7,7,0,0.0,0.0,1.0,1.0,0.0
7307,346,308,38,205,141,0.8901734104046243,0.10982658959537572,0.5924855491329479,0.407514450867052,5,0,0,5,5,0,0.0,0.0,1.0,1.0,0.0
7308,51,28,23,35,16,0.5490196078431373,0.45098039215686275,0.6862745098039216,0.3137254901960784,13,0,0,13,10,3,0.0,0.0,1.0,0.7692307692307693,0.23076923076923078
7309,171,147,24,100,71,0.8596491228070176,0.14035087719298245,0.5847953216374269,0.4152046783625731,5,0,0,5,5,0,0.0,0.0,1.0,1.0,0.0
7310,102,93,9,87,15,0.9117647058823529,0.08823529411764706,0.8529411764705882,0.14705882352941177,13,0,0,13,10,3,0.0,0.0,1.0,0.7692307692307693,0.23076923076923078
7311,105,96,9,91,14,0.9142857142857143,0.08571428571428572,0.8666666666666667,0.13333333333333333,13,0,0,13,10,3,0.0,0.0,1.0,0.7692307692307693,0.23076923076923078
7312,494,436,58,297,197,0.8825910931174089,0.11740890688259109,0.6012145748987854,0.39878542510121456,5,0,0,5,5,0,0.0,0.0,1.0,1.0,0.0
7313,163,96,67,120,43,0.588957055214724,0.4110429447852761,0.7361963190184049,0.26380368098159507,13,0,0,13,10,3,0.0,0.0,1.0,0.7692307692307693,0.23076923076923078
7314,397,295,102,369,28,0.743073047858942,0.25692695214105793,0.929471032745592,0.07052896725440806,13,0,0,13,10,3,0.0,0.0,1.0,0.7692307692307693,0.23076923076923078
7315,285,250,35,163,122,0.8771929824561403,0.12280701754385964,0.5719298245614035,0.4280701754385965,7,0,0,7,7,0,0.0,0.0,1.0,1.0,0.0
7316,305,265,40,175,130,0.8688524590163934,0.13114754098360656,0.5737704918032787,0.4262295081967213,7,0,0,7,7,0,0.0,0.0,1.0,1.0,0.0
7317,468,402,66,279,189,0.8589743589743589,0.14102564102564102,0.5961538461538461,0.40384615384615385,5,0,0,5,5,0,0.0,0.0,1.0,1.0,0.0
7318,293,241,52,175,118,0.8225255972696246,0.17747440273037543,0.5972696245733788,0.40273037542662116,5,0,0,5,5,0,0.0,0.0,1.0,1.0,0.0
7319,349,303,46,220,129,0.8681948424068768,0.1318051575931232,0.6303724928366762,0.36962750716332377,5,0,0,5,5,0,0.0,0.0,1.0,1.0,0.0
7320,93,84,9,79,14,0.9032258064516129,0.0967741935483871,0.8494623655913979,0.15053763440860216,13,0,0,13,10,3,0.0,0.0,1.0,0.7692307692307693,0.23076923076923078
7321,337,287,50,200,137,0.8516320474777448,0.14836795252225518,0.5934718100890207,0.4065281899109792,5,0,0,5,5,0,0.0,0.0,1.0,1.0,0.0
7322,89,80,9,73,16,0.898876404494382,0.10112359550561797,0.8202247191011236,0.1797752808988764,13,0,0,13,10,3,0.0,0.0,1.0,0.7692307692307693,0.23076923076923078
7323,1064,1058,6,648,416,0.9943609022556391,0.005639097744360902,0.6090225563909775,0.39097744360902253,8,0,0,8,8,0,0.0,0.0,1.0,1.0,0.0
7324,1073,1064,9,660,413,0.9916123019571296,0.008387698042870456,0.6150978564771669,0.3849021435228332,8,0,0,8,8,0,0.0,0.0,1.0,1.0,0.0
7325,384,340,44,233,151,0.8854166666666666,0.11458333333333333,0.6067708333333334,0.3932291666666667,5,0,0,5,5,0,0.0,0.0,1.0,1.0,0.0
7326,1533,1525,8,1222,311,0.994781474233529,0.005218525766470972,0.7971298108284409,0.20287018917155902,8,0,0,8,8,0,0.0,0.0,1.0,1.0,0.0
7327,251,223,28,150,101,0.8884462151394422,0.11155378486055777,0.5976095617529881,0.40239043824701193,5,0,0,5,5,0,0.0,0.0,1.0,1.0,0.0
7328,0,0,0,0,0,0.0,0.0,0.0,0.0,0,0,0,0,0,0,0.0,0.0,0.0,0.0,0.0
7329,1443,1436,7,1161,282,0.9951489951489951,0.004851004851004851,0.8045738045738046,0.19542619542619544,8,0,0,8,8,0,0.0,0.0,1.0,1.0,0.0
7330,135,78,57,88,47,0.5777777777777777,0.4222222222222222,0.6518518518518519,0.34814814814814815,7,0,0,7,7,0,0.0,0.0,1.0,1.0,0.0
7331,423,386,37,247,176,0.9125295508274232,0.08747044917257683,0.5839243498817966,0.4160756501182033,5,0,0,5,5,0,0.0,0.0,1.0,1.0,0.0
7332,1389,1382,7,1096,293,0.9949604031677466,0.005039596832253419,0.7890568754499641,0.210943124550036,8,0,0,8,8,0,0.0,0.0,1.0,1.0,0.0
7333,435,412,23,360,75,0.9471264367816092,0.052873563218390804,0.8275862068965517,0.1724137931034483,43,5,26,12,40,3,0.11627906976744186,0.6046511627906976,0.27906976744186046,0.9302325581395349,0.06976744186046512
7334,1432,1424,8,1187,245,0.994413407821229,0.00558659217877095,0.8289106145251397,0.17108938547486033,8,0,0,8,8,0,0.0,0.0,1.0,1.0,0.0
7335,574,515,59,333,241,0.8972125435540069,0.10278745644599303,0.5801393728222997,0.41986062717770034,5,0,0,5,5,0,0.0,0.0,1.0,1.0,0.0
7336,446,410,36,259,187,0.9192825112107623,0.08071748878923767,0.5807174887892377,0.4192825112107623,5,0,0,5,5,0,0.0,0.0,1.0,1.0,0.0
7337,74,74,0,61,13,1.0,0.0,0.8243243243243243,0.17567567567567569,10,0,2,8,8,2,0.0,0.2,0.8,0.8,0.2
7338,100,91,9,86,14,0.91,0.09,0.86,0.14,13,0,0,13,10,3,0.0,0.0,1.0,0.7692307692307693,0.23076923076923078
7339,139,121,18,82,57,0.8705035971223022,0.12949640287769784,0.5899280575539568,0.41007194244604317,7,0,0,7,7,0,0.0,0.0,1.0,1.0,0.0
7340,1328,1321,7,1065,263,0.9947289156626506,0.005271084337349397,0.8019578313253012,0.1980421686746988,5,0,0,5,5,0,0.0,0.0,1.0,1.0,0.0
7341,267,159,108,186,81,0.5955056179775281,0.4044943820224719,0.6966292134831461,0.30337078651685395,13,0,0,13,10,3,0.0,0.0,1.0,0.7692307692307693,0.23076923076923078
7342,81,47,34,58,23,0.5802469135802469,0.41975308641975306,0.7160493827160493,0.2839506172839506,7,0,0,7,7,0,0.0,0.0,1.0,1.0,0.0
7343,1324,1317,7,1053,271,0.9947129909365559,0.005287009063444109,0.7953172205438066,0.20468277945619334,5,0,0,5,5,0,0.0,0.0,1.0,1.0,0.0
7344,365,265,100,330,35,0.726027397260274,0.273972602739726,0.9041095890410958,0.0958904109589041,13,0,0,13,10,3,0.0,0.0,1.0,0.7692307692307693,0.23076923076923078
7345,1518,1510,8,1242,276,0.994729907773386,0.005270092226613966,0.8181818181818182,0.18181818181818182,5,0,0,5,5,0,0.0,0.0,1.0,1.0,0.0
7346,80,71,9,65,15,0.8875,0.1125,0.8125,0.1875,13,0,0,13,10,3,0.0,0.0,1.0,0.7692307692307693,0.23076923076923078
7347,277,253,24,154,123,0.9133574007220217,0.08664259927797834,0.555956678700361,0.44404332129963897,5,0,0,5,5,0,0.0,0.0,1.0,1.0,0.0
7348,0,0,0,0,0,0.0,0.0,0.0,0.0,0,0,0,0,0,0,0.0,0.0,0.0,0.0,0.0
7349,386,329,57,229,157,0.8523316062176166,0.14766839378238342,0.5932642487046632,0.4067357512953368,5,0,0,5,5,0,0.0,0.0,1.0,1.0,0.0
7350,371,327,44,228,143,0.8814016172506739,0.11859838274932614,0.6145552560646901,0.38544474393531,5,0,0,5,5,0,0.0,0.0,1.0,1.0,0.0
7351,327,286,41,192,135,0.8746177370030581,0.12538226299694188,0.5871559633027523,0.41284403669724773,5,0,0,5,5,0,0.0,0.0,1.0,1.0,0.0
7352,271,242,29,160,111,0.8929889298892989,0.1070110701107011,0.5904059040590406,0.4095940959409594,5,0,0,5,5,0,0.0,0.0,1.0,1.0,0.0
7353,1380,1372,8,1122,258,0.9942028985507246,0.005797101449275362,0.8130434782608695,0.18695652173913044,5,0,0,5,5,0,0.0,0.0,1.0,1.0,0.0
7354,289,266,23,218,71,0.9204152249134948,0.07958477508650519,0.754325259515571,0.24567474048442905,88,3,37,48,88,0,0.03409090909090909,0.42045454545454547,0.5454545454545454,1.0,0.0
7355,574,495,79,339,235,0.8623693379790941,0.13763066202090593,0.5905923344947736,0.4094076655052265,4,0,0,4,4,0,0.0,0.0,1.0,1.0,0.0
7356,300,257,43,175,125,0.8566666666666667,0.14333333333333334,0.5833333333333334,0.4166666666666667,5,0,0,5,5,0,0.0,0.0,1.0,1.0,0.0
7357,106,97,9,91,15,0.9150943396226415,0.08490566037735849,0.8584905660377359,0.14150943396226415,13,0,0,13,10,3,0.0,0.0,1.0,0.7692307692307693,0.23076923076923078
7358,208,184,24,112,96,0.8846153846153846,0.11538461538461539,0.5384615384615384,0.46153846153846156,7,0,0,7,7,0,0.0,0.0,1.0,1.0,0.0
7359,409,354,55,241,168,0.8655256723716381,0.13447432762836187,0.589242053789731,0.41075794621026895,5,0,0,5,5,0,0.0,0.0,1.0,1.0,0.0
7360,0,0,0,0,0,0.0,0.0,0.0,0.0,0,0,0,0,0,0,0.0,0.0,0.0,0.0,0.0
7361,1403,1396,7,1147,256,0.9950106913756237,0.004989308624376337,0.8175338560228083,0.18246614397719174,5,0,0,5,5,0,0.0,0.0,1.0,1.0,0.0
7362,36,29,7,18,18,0.8055555555555556,0.19444444444444445,0.5,0.5,7,0,0,7,7,0,0.0,0.0,1.0,1.0,0.0
7363,441,326,115,394,47,0.7392290249433107,0.26077097505668934,0.8934240362811792,0.10657596371882086,13,0,0,13,10,3,0.0,0.0,1.0,0.7692307692307693,0.23076923076923078
7364,406,356,50,244,162,0.8768472906403941,0.12315270935960591,0.6009852216748769,0.39901477832512317,5,0,0,5,5,0,0.0,0.0,1.0,1.0,0.0
7365,520,450,70,322,198,0.8653846153846154,0.1346153846153846,0.6192307692307693,0.38076923076923075,5,0,0,5,5,0,0.0,0.0,1.0,1.0,0.0
7366,586,519,67,358,228,0.8856655290102389,0.11433447098976109,0.6109215017064846,0.3890784982935154,5,0,0,5,5,0,0.0,0.0,1.0,1.0,0.0
7367,249,219,30,142,107,0.8795180722891566,0.12048192771084337,0.570281124497992,0.42971887550200805,7,0,0,7,7,0,0.0,0.0,1.0,1.0,0.0
7368,350,311,39,190,160,0.8885714285714286,0.11142857142857143,0.5428571428571428,0.45714285714285713,5,0,0,5,5,0,0.0,0.0,1.0,1.0,0.0
7369,138,81,57,94,44,0.5869565217391305,0.41304347826086957,0.6811594202898551,0.3188405797101449,13,0,0,13,10,3,0.0,0.0,1.0,0.7692307692307693,0.23076923076923078
7370,1291,1284,7,1051,240,0.994577846630519,0.005422153369481022,0.8140975987606507,0.18590240123934934,5,0,0,5,5,0,0.0,0.0,1.0,1.0,0.0
7371,230,191,39,137,93,0.8304347826086956,0.16956521739130434,0.5956521739130435,0.4043478260869565,7,0,0,7,7,0,0.0,0.0,1.0,1.0,0.0
7372,0,0,0,0,0,0.0,0.0,0.0,0.0,0,0,0,0,0,0,0.0,0.0,0.0,0.0,0.0
7373,284,238,46,179,105,0.8380281690140845,0.1619718309859155,0.6302816901408451,0.36971830985915494,5,0,0,5,5,0,0.0,0.0,1.0,1.0,0.0
7374,376,321,55,235,141,0.8537234042553191,0.14627659574468085,0.625,0.375,5,0,0,5,5,0,0.0,0.0,1.0,1.0,0.0
7375,367,297,70,226,141,0.8092643051771117,0.1907356948228883,0.6158038147138964,0.38419618528610355,5,0,0,5,5,0,0.0,0.0,1.0,1.0,0.0
7376,87,76,11,49,38,0.8735632183908046,0.12643678160919541,0.5632183908045977,0.4367816091954023,7,0,0,7,7,0,0.0,0.0,1.0,1.0,0.0
7377,104,95,9,90,14,0.9134615384615384,0.08653846153846154,0.8653846153846154,0.1346153846153846,13,0,0,13,10,3,0.0,0.0,1.0,0.7692307692307693,0.23076923076923078
7378,61,35,26,46,15,0.5737704918032787,0.4262295081967213,0.7540983606557377,0.2459016393442623,7,0,0,7,7,0,0.0,0.0,1.0,1.0,0.0
7379,626,571,55,386,240,0.9121405750798722,0.0878594249201278,0.6166134185303515,0.38338658146964855,5,0,0,5,5,0,0.0,0.0,1.0,1.0,0.0
7380,402,345,57,250,152,0.8582089552238806,0.1417910447761194,0.6218905472636815,0.3781094527363184,5,0,0,5,5,0,0.0,0.0,1.0,1.0,0.0
7381,1468,1461,7,1185,283,0.9952316076294278,0.004768392370572207,0.8072207084468664,0.1927792915531335,8,0,0,8,8,0,0.0,0.0,1.0,1.0,0.0
7382,77,68,9,63,14,0.8831168831168831,0.11688311688311688,0.8181818181818182,0.18181818181818182,13,0,0,13,10,3,0.0,0.0,1.0,0.7692307692307693,0.23076923076923078
7383,252,222,30,154,98,0.8809523809523809,0.11904761904761904,0.6111111111111112,0.3888888888888889,5,0,0,5,5,0,0.0,0.0,1.0,1.0,0.0
7384,222,176,46,139,83,0.7927927927927928,0.2072072072072072,0.6261261261261262,0.3738738738738739,7,0,0,7,7,0,0.0,0.0,1.0,1.0,0.0
7385,411,364,47,238,173,0.8856447688564477,0.11435523114355231,0.5790754257907542,0.4209245742092457,5,0,0,5,5,0,0.0,0.0,1.0,1.0,0.0
7386,30,16,14,21,9,0.5333333333333333,0.4666666666666667,0.7,0.3,7,0,0,7,7,0,0.0,0.0,1.0,1.0,0.0
7387,148,91,57,93,55,0.6148648648648649,0.38513513513513514,0.6283783783783784,0.3716216216216216,13,0,0,13,10,3,0.0,0.0,1.0,0.7692307692307693,0.23076923076923078
7388,0,0,0,0,0,0.0,0.0,0.0,0.0,0,0,0,0,0,0,0.0,0.0,0.0,0.0,0.0
7389,350,302,48,210,140,0.8628571428571429,0.13714285714285715,0.6,0.4,5,0,0,5,5,0,0.0,0.0,1.0,1.0,0.0
7390,1321,1313,8,1083,238,0.9939439818319455,0.006056018168054504,0.8198334595003784,0.1801665404996215,5,0,0,5,5,0,0.0,0.0,1.0,1.0,0.0
7391,432,371,61,256,176,0.8587962962962963,0.1412037037037037,0.5925925925925926,0.4074074074074074,5,0,0,5,5,0,0.0,0.0,1.0,1.0,0.0
7392,102,93,9,88,14,0.9117647058823529,0.08823529411764706,0.8627450980392157,0.13725490196078433,13,0,0,13,10,3,0.0,0.0,1.0,0.7692307692307693,0.23076923076923078
7393,479,10,469,278,201,0.020876826722338204,0.9791231732776617,0.5803757828810021,0.4196242171189979,470,0,7,463,469,1,0.0,0.014893617021276596,0.9851063829787234,0.997872340425532,0.002127659574468085
7394,482,418,64,293,189,0.8672199170124482,0.13278008298755187,0.6078838174273858,0.3921161825726141,5,0,0,5,5,0,0.0,0.0,1.0,1.0,0.0
7395,487,434,53,274,213,0.891170431211499,0.10882956878850103,0.5626283367556468,0.43737166324435317,5,0,0,5,5,0,0.0,0.0,1.0,1.0,0.0
7396,280,228,52,171,109,0.8142857142857143,0.18571428571428572,0.6107142857142858,0.3892857142857143,5,0,0,5,5,0,0.0,0.0,1.0,1.0,0.0
7397,318,280,38,197,121,0.8805031446540881,0.11949685534591195,0.6194968553459119,0.3805031446540881,5,0,0,5,5,0,0.0,0.0,1.0,1.0,0.0
7398,94,85,9,78,16,0.9042553191489362,0.09574468085106383,0.8297872340425532,0.1702127659574468,13,0,0,13,10,3,0.0,0.0,1.0,0.7692307692307693,0.23076923076923078
7399,25,24,1,15,10,0.96,0.04,0.6,0.4,14,3,3,8,11,3,0.21428571428571427,0.21428571428571427,0.5714285714285714,0.7857142857142857,0.21428571428571427
7400,285,254,31,173,112,0.8912280701754386,0.10877192982456141,0.6070175438596491,0.3929824561403509,5,0,0,5,5,0,0.0,0.0,1.0,1.0,0.0
7401,179,138,41,163,16,0.770949720670391,0.22905027932960895,0.9106145251396648,0.0893854748603352,13,0,0,13,10,3,0.0,0.0,1.0,0.7692307692307693,0.23076923076923078
7402,142,95,47,94,48,0.6690140845070423,0.33098591549295775,0.6619718309859155,0.3380281690140845,13,0,0,13,10,3,0.0,0.0,1.0,0.7692307692307693,0.23076923076923078
7403,917,910,7,886,31,0.9923664122137404,0.007633587786259542,0.9661941112322792,0.03380588876772083,8,0,0,8,8,0,0.0,0.0,1.0,1.0,0.0
7404,291,251,40,167,124,0.8625429553264605,0.13745704467353953,0.5738831615120275,0.4261168384879725,7,0,0,7,7,0,0.0,0.0,1.0,1.0,0.0
7405,76,50,26,49,27,0.6578947368421053,0.34210526315789475,0.6447368421052632,0.35526315789473684,7,0,0,7,7,0,0.0,0.0,1.0,1.0,0.0
7406,269,203,66,174,95,0.7546468401486989,0.24535315985130113,0.6468401486988847,0.35315985130111527,7,0,0,7,7,0,0.0,0.0,1.0,1.0,0.0
7407,310,278,32,193,117,0.896774193548387,0.1032258064516129,0.6225806451612903,0.3774193548387097,5,0,0,5,5,0,0.0,0.0,1.0,1.0,0.0
7408,1382,1375,7,1115,267,0.9949348769898697,0.005065123010130246,0.8068017366136034,0.19319826338639653,5,0,0,5,5,0,0.0,0.0,1.0,1.0,0.0
7409,195,156,39,124,71,0.8,0.2,0.6358974358974359,0.3641025641025641,7,0,0,7,7,0,0.0,0.0,1.0,1.0,0.0
7410,1342,1334,8,1086,256,0.9940387481371088,0.005961251862891207,0.8092399403874814,0.19076005961251863,5,0,0,5,5,0,0.0,0.0,1.0,1.0,0.0
7411,1405,1398,7,1105,300,0.9950177935943061,0.00498220640569395,0.7864768683274022,0.21352313167259787,5,0,0,5,5,0,0.0,0.0,1.0,1.0,0.0
7412,548,465,83,321,227,0.8485401459854015,0.15145985401459855,0.5857664233576643,0.4142335766423358,5,0,0,5,5,0,0.0,0.0,1.0,1.0,0.0
7413,94,85,9,79,15,0.9042553191489362,0.09574468085106383,0.8404255319148937,0.1595744680851064,14,0,0,14,11,3,0.0,0.0,1.0,0.7857142857142857,0.21428571428571427
7414,423,377,46,264,159,0.8912529550827423,0.10874704491725769,0.624113475177305,0.375886524822695,5,0,0,5,5,0,0.0,0.0,1.0,1.0,0.0
7415,0,0,0,0,0,0.0,0.0,0.0,0.0,0,0,0,0,0,0,0.0,0.0,0.0,0.0,0.0
7416,43,27,16,28,15,0.627906976744186,0.37209302325581395,0.6511627906976745,0.3488372093023256,13,0,0,13,10,3,0.0,0.0,1.0,0.7692307692307693,0.23076923076923078
7417,399,351,48,240,159,0.8796992481203008,0.12030075187969924,0.6015037593984962,0.39849624060150374,5,0,0,5,5,0,0.0,0.0,1.0,1.0,0.0
7418,105,96,9,89,16,0.9142857142857143,0.08571428571428572,0.8476190476190476,0.1523809523809524,13,0,0,13,10,3,0.0,0.0,1.0,0.7692307692307693,0.23076923076923078
7419,72,72,0,61,11,1.0,0.0,0.8472222222222222,0.1527777777777778,9,0,1,8,8,1,0.0,0.1111111111111111,0.8888888888888888,0.8888888888888888,0.1111111111111111
7420,0,0,0,0,0,0.0,0.0,0.0,0.0,0,0,0,0,0,0,0.0,0.0,0.0,0.0,0.0
7421,368,302,66,225,143,0.8206521739130435,0.1793478260869565,0.6114130434782609,0.38858695652173914,5,0,0,5,5,0,0.0,0.0,1.0,1.0,0.0
7422,332,331,1,277,55,0.9969879518072289,0.0030120481927710845,0.8343373493975904,0.16566265060240964,6,0,1,5,5,1,0.0,0.16666666666666666,0.8333333333333334,0.8333333333333334,0.16666666666666666
7423,523,457,66,314,209,0.8738049713193117,0.12619502868068833,0.6003824091778203,0.39961759082217974,4,0,0,4,4,0,0.0,0.0,1.0,1.0,0.0
7424,1,0,1,1,0,0.0,1.0,1.0,0.0,7,0,0,7,7,0,0.0,0.0,1.0,1.0,0.0
7425,236,146,90,147,89,0.6186440677966102,0.3813559322033898,0.6228813559322034,0.3771186440677966,13,0,0,13,10,3,0.0,0.0,1.0,0.7692307692307693,0.23076923076923078
7426,102,93,9,87,15,0.9117647058823529,0.08823529411764706,0.8529411764705882,0.14705882352941177,13,0,0,13,10,3,0.0,0.0,1.0,0.7692307692307693,0.23076923076923078
7427,175,142,33,110,65,0.8114285714285714,0.18857142857142858,0.6285714285714286,0.37142857142857144,3,0,0,3,3,0,0.0,0.0,1.0,1.0,0.0
7428,205,178,27,113,92,0.8682926829268293,0.13170731707317074,0.551219512195122,0.44878048780487806,5,0,0,5,5,0,0.0,0.0,1.0,1.0,0.0
7429,584,524,60,357,227,0.8972602739726028,0.10273972602739725,0.6113013698630136,0.3886986301369863,5,0,0,5,5,0,0.0,0.0,1.0,1.0,0.0
7430,201,118,83,139,62,0.5870646766169154,0.4129353233830846,0.6915422885572139,0.30845771144278605,13,0,0,13,10,3,0.0,0.0,1.0,0.7692307692307693,0.23076923076923078
7431,581,508,73,341,240,0.8743545611015491,0.12564543889845095,0.5869191049913941,0.41308089500860584,5,0,0,5,5,0,0.0,0.0,1.0,1.0,0.0
7432,220,195,25,134,86,0.8863636363636364,0.11363636363636363,0.6090909090909091,0.39090909090909093,5,0,0,5,5,0,0.0,0.0,1.0,1.0,0.0
7433,1451,1444,7,1179,272,0.9951757408683667,0.004824259131633356,0.8125430737422468,0.1874569262577533,5,0,0,5,5,0,0.0,0.0,1.0,1.0,0.0
7434,1380,1373,7,1094,286,0.994927536231884,0.005072463768115942,0.7927536231884058,0.2072463768115942,5,0,0,5,5,0,0.0,0.0,1.0,1.0,0.0
7435,124,66,58,73,51,0.532258064516129,0.46774193548387094,0.5887096774193549,0.4112903225806452,504,236,94,174,498,6,0.46825396825396826,0.1865079365079365,0.34523809523809523,0.9880952380952381,0.011904761904761904
7436,69,32,37,13,56,0.463768115942029,0.5362318840579711,0.18840579710144928,0.8115942028985508,347,179,96,72,343,4,0.515850144092219,0.276657060518732,0.207492795389049,0.9884726224783862,0.011527377521613832
7437,87,31,56,81,6,0.3563218390804598,0.6436781609195402,0.9310344827586207,0.06896551724137931,528,277,61,190,521,7,0.5246212121212122,0.11553030303030302,0.35984848484848486,0.9867424242424242,0.013257575757575758
7438,105,50,55,46,59,0.47619047619047616,0.5238095238095238,0.4380952380952381,0.5619047619047619,580,258,123,199,573,7,0.44482758620689655,0.2120689655172414,0.3431034482758621,0.9879310344827587,0.01206896551724138
7439,491,400,91,434,57,0.814663951120163,0.18533604887983707,0.8839103869653768,0.11608961303462322,1027,325,89,613,1002,25,0.31645569620253167,0.0866601752677702,0.5968841285296982,0.9756572541382668,0.024342745861733205
7440,96,50,46,48,48,0.5208333333333334,0.4791666666666667,0.5,0.5,543,238,110,195,537,6,0.43830570902394106,0.20257826887661143,0.35911602209944754,0.988950276243094,0.011049723756906077
7441,106,53,53,101,5,0.5,0.5,0.9528301886792453,0.04716981132075472,655,484,62,109,648,7,0.7389312977099237,0.09465648854961832,0.166412213740458,0.9893129770992366,0.010687022900763359
7442,98,45,53,92,6,0.45918367346938777,0.5408163265306123,0.9387755102040817,0.061224489795918366,501,291,74,136,494,7,0.5808383233532934,0.14770459081836326,0.2714570858283433,0.9860279441117764,0.013972055888223553
7443,69,32,37,20,49,0.463768115942029,0.5362318840579711,0.2898550724637681,0.7101449275362319,286,165,75,46,285,1,0.5769230769230769,0.26223776223776224,0.16083916083916083,0.9965034965034965,0.0034965034965034965
7444,144,62,82,133,11,0.4305555555555556,0.5694444444444444,0.9236111111111112,0.0763888888888889,345,40,83,222,341,4,0.11594202898550725,0.24057971014492754,0.6434782608695652,0.9884057971014493,0.011594202898550725
7445,75,36,39,23,52,0.48,0.52,0.30666666666666664,0.6933333333333334,571,214,129,228,561,10,0.37478108581436076,0.22591943957968477,0.39929947460595444,0.9824868651488616,0.017513134851138354
7446,121,69,52,68,53,0.5702479338842975,0.4297520661157025,0.5619834710743802,0.4380165289256198,461,216,84,161,454,7,0.4685466377440347,0.1822125813449024,0.3492407809110629,0.9848156182212582,0.015184381778741865
7447,91,41,50,85,6,0.45054945054945056,0.5494505494505495,0.9340659340659341,0.06593406593406594,438,243,47,148,429,9,0.5547945205479452,0.10730593607305935,0.3378995433789954,0.9794520547945206,0.02054794520547945
7448,633,487,146,521,112,0.7693522906793049,0.23064770932069512,0.8230647709320695,0.1769352290679305,482,88,176,218,465,17,0.1825726141078838,0.3651452282157676,0.45228215767634855,0.9647302904564315,0.035269709543568464
7449,234,67,167,180,54,0.2863247863247863,0.7136752136752137,0.7692307692307693,0.23076923076923078,564,223,196,145,564,0,0.3953900709219858,0.3475177304964539,0.2570921985815603,1.0,0.0
7450,195,108,87,168,27,0.5538461538461539,0.4461538461538462,0.8615384615384616,0.13846153846153847,344,51,92,201,341,3,0.14825581395348839,0.26744186046511625,0.5843023255813954,0.9912790697674418,0.00872093023255814
7451,90,63,27,38,52,0.7,0.3,0.4222222222222222,0.5777777777777777,393,211,105,77,389,4,0.5368956743002544,0.26717557251908397,0.19592875318066158,0.989821882951654,0.010178117048346057
7452,167,137,30,122,45,0.8203592814371258,0.17964071856287425,0.7305389221556886,0.2694610778443114,419,256,72,91,417,2,0.6109785202863962,0.1718377088305489,0.2171837708830549,0.9952267303102625,0.00477326968973747
7453,842,699,143,690,152,0.830166270783848,0.16983372921615203,0.8194774346793349,0.18052256532066507,533,88,177,268,464,69,0.1651031894934334,0.3320825515947467,0.5028142589118199,0.8705440900562852,0.1294559099437148
7454,297,60,237,243,54,0.20202020202020202,0.797979797979798,0.8181818181818182,0.18181818181818182,649,166,250,233,648,1,0.25577812018489987,0.3852080123266564,0.35901386748844377,0.9984591679506933,0.0015408320493066256
7455,81,52,29,44,37,0.6419753086419753,0.35802469135802467,0.5432098765432098,0.4567901234567901,443,180,65,198,432,11,0.40632054176072235,0.14672686230248308,0.4469525959367946,0.9751693002257337,0.024830699774266364
7456,613,432,181,541,72,0.7047308319738989,0.29526916802610115,0.8825448613376835,0.11745513866231648,734,325,147,262,718,16,0.4427792915531335,0.20027247956403268,0.3569482288828338,0.9782016348773842,0.021798365122615803
7457,119,57,62,59,60,0.4789915966386555,0.5210084033613446,0.4957983193277311,0.5042016806722689,560,288,99,173,555,5,0.5142857142857142,0.1767857142857143,0.30892857142857144,0.9910714285714286,0.008928571428571428
7458,227,132,95,201,26,0.5814977973568282,0.4185022026431718,0.8854625550660793,0.1145374449339207,344,55,92,197,340,4,0.15988372093023256,0.26744186046511625,0.5726744186046512,0.9883720930232558,0.011627906976744186
7459,84,42,42,41,43,0.5,0.5,0.4880952380952381,0.5119047619047619,467,218,89,160,462,5,0.4668094218415418,0.1905781584582441,0.3426124197002141,0.9892933618843683,0.010706638115631691
7460,101,56,45,50,51,0.5544554455445545,0.44554455445544555,0.49504950495049505,0.504950495049505,421,260,80,81,417,4,0.6175771971496437,0.19002375296912113,0.19239904988123516,0.9904988123515439,0.009501187648456057
7461,247,57,190,198,49,0.23076923076923078,0.7692307692307693,0.8016194331983806,0.19838056680161945,552,181,184,187,551,1,0.3278985507246377,0.3333333333333333,0.338768115942029,0.9981884057971014,0.0018115942028985507
7462,239,58,181,189,50,0.24267782426778242,0.7573221757322176,0.7907949790794979,0.20920502092050208,481,136,163,182,479,2,0.28274428274428276,0.3388773388773389,0.3783783783783784,0.9958419958419958,0.004158004158004158
7463,99,55,44,43,56,0.5555555555555556,0.4444444444444444,0.43434343434343436,0.5656565656565656,435,214,96,125,432,3,0.49195402298850577,0.2206896551724138,0.28735632183908044,0.993103448275862,0.006896551724137931
7464,73,36,37,17,56,0.4931506849315068,0.5068493150684932,0.2328767123287671,0.7671232876712328,320,173,92,55,318,2,0.540625,0.2875,0.171875,0.99375,0.00625
7465,111,70,41,72,39,0.6306306306306306,0.36936936936936937,0.6486486486486487,0.35135135135135137,431,185,90,156,427,4,0.42923433874709976,0.2088167053364269,0.3619489559164733,0.9907192575406032,0.009280742459396751
7466,149,66,83,138,11,0.4429530201342282,0.5570469798657718,0.9261744966442953,0.0738255033557047,343,40,83,220,340,3,0.11661807580174927,0.24198250728862974,0.641399416909621,0.9912536443148688,0.008746355685131196
7467,184,119,65,125,59,0.6467391304347826,0.3532608695652174,0.6793478260869565,0.32065217391304346,672,324,92,256,667,5,0.48214285714285715,0.13690476190476192,0.38095238095238093,0.9925595238095238,0.00744047619047619
7468,69,41,28,27,42,0.5942028985507246,0.4057971014492754,0.391304347826087,0.6086956521739131,459,177,94,188,448,11,0.38562091503267976,0.2047930283224401,0.4095860566448802,0.9760348583877996,0.023965141612200435
7469,106,40,66,102,4,0.37735849056603776,0.6226415094339622,0.9622641509433962,0.03773584905660377,530,269,66,195,524,6,0.5075471698113208,0.12452830188679245,0.36792452830188677,0.9886792452830189,0.011320754716981131
7470,109,53,56,58,51,0.48623853211009177,0.5137614678899083,0.5321100917431193,0.46788990825688076,593,222,101,270,587,6,0.37436762225969644,0.1703204047217538,0.45531197301854975,0.9898819561551433,0.01011804384485666
7471,60,30,30,12,48,0.5,0.5,0.2,0.8,395,224,117,54,392,3,0.5670886075949367,0.29620253164556964,0.13670886075949368,0.9924050632911392,0.007594936708860759
7472,130,69,61,71,59,0.5307692307692308,0.46923076923076923,0.5461538461538461,0.45384615384615384,495,247,92,156,486,9,0.498989898989899,0.18585858585858586,0.3151515151515151,0.9818181818181818,0.01818181818181818
7473,591,410,181,530,61,0.6937394247038917,0.3062605752961083,0.8967851099830795,0.10321489001692047,734,325,147,262,718,16,0.4427792915531335,0.20027247956403268,0.3569482288828338,0.9782016348773842,0.021798365122615803
7474,116,95,21,79,37,0.8189655172413793,0.1810344827586207,0.6810344827586207,0.31896551724137934,611,64,208,339,530,81,0.10474631751227496,0.3404255319148936,0.5548281505728314,0.867430441898527,0.132569558101473
7475,129,66,63,75,54,0.5116279069767442,0.4883720930232558,0.5813953488372093,0.4186046511627907,525,221,97,207,522,3,0.42095238095238097,0.18476190476190477,0.3942857142857143,0.9942857142857143,0.005714285714285714
7476,190,104,86,163,27,0.5473684210526316,0.45263157894736844,0.8578947368421053,0.14210526315789473,346,51,92,203,342,4,0.14739884393063585,0.2658959537572254,0.5867052023121387,0.9884393063583815,0.011560693641618497
7477,45,43,2,23,22,0.9555555555555556,0.044444444444444446,0.5111111111111111,0.4888888888888889,25,0,0,25,23,2,0.0,0.0,1.0,0.92,0.08
7478,143,111,32,109,34,0.7762237762237763,0.22377622377622378,0.7622377622377622,0.23776223776223776,17,0,0,17,13,4,0.0,0.0,1.0,0.7647058823529411,0.23529411764705882
7479,132,111,21,83,49,0.8409090909090909,0.1590909090909091,0.6287878787878788,0.3712121212121212,13,0,0,13,10,3,0.0,0.0,1.0,0.7692307692307693,0.23076923076923078
7480,202,177,25,162,40,0.8762376237623762,0.12376237623762376,0.801980198019802,0.19801980198019803,183,0,0,183,132,51,0.0,0.0,1.0,0.7213114754098361,0.2786885245901639
7481,3299,2658,641,2663,636,0.8056986965747196,0.19430130342528038,0.8072143073658684,0.19278569263413156,132,1,41,90,132,0,0.007575757575757576,0.3106060606060606,0.6818181818181818,1.0,0.0
7482,860,443,417,423,437,0.5151162790697674,0.4848837209302326,0.49186046511627907,0.5081395348837209,324,2,30,292,319,5,0.006172839506172839,0.09259259259259259,0.9012345679012346,0.9845679012345679,0.015432098765432098
7483,154,138,16,122,32,0.8961038961038961,0.1038961038961039,0.7922077922077922,0.2077922077922078,130,1,87,42,128,2,0.007692307692307693,0.6692307692307692,0.3230769230769231,0.9846153846153847,0.015384615384615385
7484,92,75,17,66,26,0.8152173913043478,0.18478260869565216,0.717391304347826,0.2826086956521739,8,0,0,8,7,1,0.0,0.0,1.0,0.875,0.125
7485,247,195,52,182,65,0.7894736842105263,0.21052631578947367,0.7368421052631579,0.2631578947368421,63,4,9,50,59,4,0.06349206349206349,0.14285714285714285,0.7936507936507936,0.9365079365079365,0.06349206349206349
7486,202,119,83,176,26,0.5891089108910891,0.41089108910891087,0.8712871287128713,0.12871287128712872,147,1,42,104,146,1,0.006802721088435374,0.2857142857142857,0.7074829931972789,0.9931972789115646,0.006802721088435374
7487,125,101,24,85,40,0.808,0.192,0.68,0.32,334,2,3,329,248,86,0.005988023952095809,0.008982035928143712,0.9850299401197605,0.7425149700598802,0.25748502994011974
7488,184,106,78,158,26,0.5760869565217391,0.42391304347826086,0.8586956521739131,0.14130434782608695,139,0,43,96,139,0,0.0,0.30935251798561153,0.6906474820143885,1.0,0.0
7489,158,123,35,121,37,0.7784810126582279,0.22151898734177214,0.7658227848101266,0.23417721518987342,12,0,0,12,11,1,0.0,0.0,1.0,0.9166666666666666,0.08333333333333333
7490,744,547,197,549,195,0.7352150537634409,0.2647849462365591,0.7379032258064516,0.2620967741935484,578,0,109,469,244,334,0.0,0.18858131487889274,0.8114186851211073,0.42214532871972316,0.5778546712802768
7491,144,123,21,87,57,0.8541666666666666,0.14583333333333334,0.6041666666666666,0.3958333333333333,16,0,0,16,12,4,0.0,0.0,1.0,0.75,0.25
7492,139,123,16,112,27,0.8848920863309353,0.11510791366906475,0.8057553956834532,0.19424460431654678,122,1,85,36,121,1,0.00819672131147541,0.6967213114754098,0.29508196721311475,0.9918032786885246,0.00819672131147541
7493,53,5,48,49,4,0.09433962264150944,0.9056603773584906,0.9245283018867925,0.07547169811320754,536,0,0,536,536,0,0.0,0.0,1.0,1.0,0.0
7494,175,144,31,130,45,0.8228571428571428,0.17714285714285713,0.7428571428571429,0.2571428571428571,115,0,1,114,85,30,0.0,0.008695652173913044,0.991304347826087,0.7391304347826086,0.2608695652173913
7495,122,103,19,82,40,0.8442622950819673,0.1557377049180328,0.6721311475409836,0.32786885245901637,330,0,4,326,218,112,0.0,0.012121212121212121,0.9878787878787879,0.6606060606060606,0.3393939393939394
7496,279,235,44,234,45,0.8422939068100358,0.15770609318996415,0.8387096774193549,0.16129032258064516,19,0,0,19,15,4,0.0,0.0,1.0,0.7894736842105263,0.21052631578947367
7497,1881,1231,650,945,936,0.6544391281233386,0.34556087187666135,0.5023923444976076,0.49760765550239233,240,0,33,207,238,2,0.0,0.1375,0.8625,0.9916666666666667,0.008333333333333333
7498,474,289,185,401,73,0.609704641350211,0.39029535864978904,0.8459915611814346,0.1540084388185654,284,11,65,208,273,11,0.03873239436619718,0.22887323943661972,0.7323943661971831,0.9612676056338029,0.03873239436619718
7499,80,60,20,54,26,0.75,0.25,0.675,0.325,8,0,0,8,7,1,0.0,0.0,1.0,0.875,0.125
7500,3299,2658,641,2663,636,0.8056986965747196,0.19430130342528038,0.8072143073658684,0.19278569263413156,132,1,41,90,132,0,0.007575757575757576,0.3106060606060606,0.6818181818181818,1.0,0.0
7501,132,108,24,78,54,0.8181818181818182,0.18181818181818182,0.5909090909090909,0.4090909090909091,9,0,0,9,7,2,0.0,0.0,1.0,0.7777777777777778,0.2222222222222222
7502,1801,1189,612,878,923,0.6601887840088839,0.339811215991116,0.4875069405885619,0.5124930594114381,242,0,27,215,241,1,0.0,0.1115702479338843,0.8884297520661157,0.9958677685950413,0.004132231404958678
7503,168,135,33,132,36,0.8035714285714286,0.19642857142857142,0.7857142857142857,0.21428571428571427,11,0,0,11,10,1,0.0,0.0,1.0,0.9090909090909091,0.09090909090909091
7504,100,85,15,58,42,0.85,0.15,0.58,0.42,9,0,0,9,8,1,0.0,0.0,1.0,0.8888888888888888,0.1111111111111111
7505,124,97,27,90,34,0.782258064516129,0.21774193548387097,0.7258064516129032,0.27419354838709675,98,0,1,97,74,24,0.0,0.01020408163265306,0.9897959183673469,0.7551020408163265,0.24489795918367346
7506,110,93,17,72,38,0.8454545454545455,0.15454545454545454,0.6545454545454545,0.34545454545454546,8,0,0,8,7,1,0.0,0.0,1.0,0.875,0.125
7507,115,96,19,70,45,0.8347826086956521,0.16521739130434782,0.6086956521739131,0.391304347826087,19,0,0,19,14,5,0.0,0.0,1.0,0.7368421052631579,0.2631578947368421
7508,138,113,25,87,51,0.8188405797101449,0.18115942028985507,0.6304347826086957,0.3695652173913043,12,0,0,12,10,2,0.0,0.0,1.0,0.8333333333333334,0.16666666666666666
7509,135,120,15,86,49,0.8888888888888888,0.1111111111111111,0.6370370370370371,0.362962962962963,252,2,3,247,175,77,0.007936507936507936,0.011904761904761904,0.9801587301587301,0.6944444444444444,0.3055555555555556
7510,3299,2658,641,2663,636,0.8056986965747196,0.19430130342528038,0.8072143073658684,0.19278569263413156,132,1,41,90,132,0,0.007575757575757576,0.3106060606060606,0.6818181818181818,1.0,0.0
7511,142,118,24,102,40,0.8309859154929577,0.16901408450704225,0.7183098591549296,0.28169014084507044,331,0,3,328,234,97,0.0,0.00906344410876133,0.9909365558912386,0.7069486404833837,0.2930513595166163
7512,127,106,21,67,60,0.8346456692913385,0.16535433070866143,0.5275590551181102,0.47244094488188976,13,0,0,13,9,4,0.0,0.0,1.0,0.6923076923076923,0.3076923076923077
7513,120,107,13,76,44,0.8916666666666667,0.10833333333333334,0.6333333333333333,0.36666666666666664,14,0,0,14,9,5,0.0,0.0,1.0,0.6428571428571429,0.35714285714285715
7514,101,83,18,55,46,0.8217821782178217,0.1782178217821782,0.5445544554455446,0.45544554455445546,11,0,0,11,9,2,0.0,0.0,1.0,0.8181818181818182,0.18181818181818182
7515,115,100,15,77,38,0.8695652173913043,0.13043478260869565,0.6695652173913044,0.33043478260869563,328,0,2,326,222,106,0.0,0.006097560975609756,0.9939024390243902,0.676829268292683,0.3231707317073171
7516,862,427,435,430,432,0.4953596287703016,0.5046403712296984,0.4988399071925754,0.5011600928074246,349,2,50,297,347,2,0.0057306590257879654,0.14326647564469913,0.8510028653295129,0.994269340974212,0.0057306590257879654
7517,132,110,22,81,51,0.8333333333333334,0.16666666666666666,0.6136363636363636,0.38636363636363635,12,0,0,12,10,2,0.0,0.0,1.0,0.8333333333333334,0.16666666666666666
7518,1920,1270,650,954,966,0.6614583333333334,0.3385416666666667,0.496875,0.503125,248,0,33,215,245,3,0.0,0.13306451612903225,0.8669354838709677,0.9879032258064516,0.012096774193548387
7519,1956,1343,613,1006,950,0.6866053169734151,0.31339468302658485,0.5143149284253579,0.48568507157464214,217,0,25,192,217,0,0.0,0.1152073732718894,0.8847926267281107,1.0,0.0
7520,346,271,75,269,77,0.7832369942196532,0.21676300578034682,0.7774566473988439,0.22254335260115607,57,1,1,55,52,5,0.017543859649122806,0.017543859649122806,0.9649122807017544,0.9122807017543859,0.08771929824561403
7521,187,109,78,161,26,0.5828877005347594,0.41711229946524064,0.8609625668449198,0.13903743315508021,140,0,43,97,140,0,0.0,0.30714285714285716,0.6928571428571428,1.0,0.0
7522,53,7,46,47,6,0.1320754716981132,0.8679245283018868,0.8867924528301887,0.11320754716981132,578,0,0,578,578,0,0.0,0.0,1.0,1.0,0.0
7523,474,289,185,401,73,0.609704641350211,0.39029535864978904,0.8459915611814346,0.1540084388185654,284,11,65,208,273,11,0.03873239436619718,0.22887323943661972,0.7323943661971831,0.9612676056338029,0.03873239436619718
7524,1278,936,342,1124,154,0.7323943661971831,0.2676056338028169,0.8794992175273866,0.12050078247261346,636,66,183,387,533,103,0.10377358490566038,0.28773584905660377,0.6084905660377359,0.8380503144654088,0.1619496855345912
7525,45,43,2,23,22,0.9555555555555556,0.044444444444444446,0.5111111111111111,0.4888888888888889,24,0,0,24,22,2,0.0,0.0,1.0,0.9166666666666666,0.08333333333333333
7526,91,76,15,56,35,0.8351648351648352,0.16483516483516483,0.6153846153846154,0.38461538461538464,8,0,0,8,7,1,0.0,0.0,1.0,0.875,0.125
7527,292,244,48,238,54,0.8356164383561644,0.1643835616438356,0.815068493150685,0.18493150684931506,57,1,2,54,53,4,0.017543859649122806,0.03508771929824561,0.9473684210526315,0.9298245614035088,0.07017543859649122
7528,317,236,81,248,69,0.7444794952681388,0.2555205047318612,0.7823343848580442,0.21766561514195584,40,1,1,38,35,5,0.025,0.025,0.95,0.875,0.125
7529,99,80,19,69,30,0.8080808080808081,0.1919191919191919,0.696969696969697,0.30303030303030304,7,0,0,7,7,0,0.0,0.0,1.0,1.0,0.0
7530,1781,1181,600,889,892,0.6631106120157215,0.3368893879842785,0.4991577765300393,0.5008422234699607,241,0,24,217,239,2,0.0,0.0995850622406639,0.9004149377593361,0.991701244813278,0.008298755186721992
7531,187,109,78,161,26,0.5828877005347594,0.41711229946524064,0.8609625668449198,0.13903743315508021,140,0,43,97,140,0,0.0,0.30714285714285716,0.6928571428571428,1.0,0.0
7532,203,120,83,177,26,0.5911330049261084,0.4088669950738916,0.8719211822660099,0.12807881773399016,146,1,42,103,145,1,0.00684931506849315,0.2876712328767123,0.7054794520547946,0.9931506849315068,0.00684931506849315
7533,184,106,78,158,26,0.5760869565217391,0.42391304347826086,0.8586956521739131,0.14130434782608695,139,0,43,96,139,0,0.0,0.30935251798561153,0.6906474820143885,1.0,0.0
7534,90,71,19,55,35,0.7888888888888889,0.2111111111111111,0.6111111111111112,0.3888888888888889,10,0,0,10,8,2,0.0,0.0,1.0,0.8,0.2
7535,208,124,84,181,27,0.5961538461538461,0.40384615384615385,0.8701923076923077,0.12980769230769232,145,1,44,100,144,1,0.006896551724137931,0.30344827586206896,0.6896551724137931,0.993103448275862,0.006896551724137931
7536,101,80,21,63,38,0.7920792079207921,0.2079207920792079,0.6237623762376238,0.37623762376237624,9,0,0,9,8,1,0.0,0.0,1.0,0.8888888888888888,0.1111111111111111
7537,356,261,95,261,95,0.7331460674157303,0.26685393258426965,0.7331460674157303,0.26685393258426965,75,0,1,74,70,5,0.0,0.013333333333333334,0.9866666666666667,0.9333333333333333,0.06666666666666667
7538,3299,2658,641,2663,636,0.8056986965747196,0.19430130342528038,0.8072143073658684,0.19278569263413156,75,1,41,33,75,0,0.013333333333333334,0.5466666666666666,0.44,1.0,0.0
7539,203,120,83,177,26,0.5911330049261084,0.4088669950738916,0.8719211822660099,0.12807881773399016,146,1,42,103,145,1,0.00684931506849315,0.2876712328767123,0.7054794520547946,0.9931506849315068,0.00684931506849315
7540,247,203,44,192,55,0.8218623481781376,0.17813765182186234,0.7773279352226721,0.22267206477732793,57,0,0,57,43,14,0.0,0.0,1.0,0.7543859649122807,0.24561403508771928
7541,84,68,16,50,34,0.8095238095238095,0.19047619047619047,0.5952380952380952,0.40476190476190477,8,0,0,8,7,1,0.0,0.0,1.0,0.875,0.125
7542,207,123,84,180,27,0.5942028985507246,0.4057971014492754,0.8695652173913043,0.13043478260869565,145,1,44,100,144,1,0.006896551724137931,0.30344827586206896,0.6896551724137931,0.993103448275862,0.006896551724137931
7543,1711,1103,608,858,853,0.6446522501461134,0.3553477498538866,0.5014611338398597,0.49853886616014026,282,0,21,261,281,1,0.0,0.07446808510638298,0.925531914893617,0.9964539007092199,0.0035460992907801418
7544,81,61,20,54,27,0.7530864197530864,0.24691358024691357,0.6666666666666666,0.3333333333333333,9,0,0,9,8,1,0.0,0.0,1.0,0.8888888888888888,0.1111111111111111
7545,232,190,42,183,49,0.8189655172413793,0.1810344827586207,0.7887931034482759,0.21120689655172414,20,0,0,20,16,4,0.0,0.0,1.0,0.8,0.2
7546,288,228,60,218,70,0.7916666666666666,0.20833333333333334,0.7569444444444444,0.24305555555555555,59,4,8,47,53,6,0.06779661016949153,0.13559322033898305,0.7966101694915254,0.8983050847457628,0.1016949152542373
7547,118,99,19,62,56,0.8389830508474576,0.16101694915254236,0.5254237288135594,0.4745762711864407,13,0,0,13,10,3,0.0,0.0,1.0,0.7692307692307693,0.23076923076923078
7548,338,277,61,267,71,0.8195266272189349,0.1804733727810651,0.7899408284023669,0.21005917159763313,275,10,168,97,262,13,0.03636363636363636,0.610909090909091,0.3527272727272727,0.9527272727272728,0.04727272727272727
7549,894,444,450,398,496,0.4966442953020134,0.5033557046979866,0.4451901565995526,0.5548098434004475,147,2,11,134,146,1,0.013605442176870748,0.07482993197278912,0.9115646258503401,0.9931972789115646,0.006802721088435374
7550,136,103,33,99,37,0.7573529411764706,0.2426470588235294,0.7279411764705882,0.27205882352941174,15,0,0,15,14,1,0.0,0.0,1.0,0.9333333333333333,0.06666666666666667
7551,118,102,16,70,48,0.864406779661017,0.13559322033898305,0.5932203389830508,0.4067796610169492,28,0,0,28,26,2,0.0,0.0,1.0,0.9285714285714286,0.07142857142857142
7552,187,109,78,161,26,0.5828877005347594,0.41711229946524064,0.8609625668449198,0.13903743315508021,140,0,43,97,140,0,0.0,0.30714285714285716,0.6928571428571428,1.0,0.0
7553,99,87,12,57,42,0.8787878787878788,0.12121212121212122,0.5757575757575758,0.42424242424242425,12,0,0,12,9,3,0.0,0.0,1.0,0.75,0.25
7554,444,352,92,291,153,0.7927927927927928,0.2072072072072072,0.6554054054054054,0.34459459459459457,88,11,21,56,83,5,0.125,0.23863636363636365,0.6363636363636364,0.9431818181818182,0.056818181818181816
7555,187,109,78,161,26,0.5828877005347594,0.41711229946524064,0.8609625668449198,0.13903743315508021,84,0,43,41,84,0,0.0,0.5119047619047619,0.4880952380952381,1.0,0.0
7556,168,146,22,114,54,0.8690476190476191,0.13095238095238096,0.6785714285714286,0.32142857142857145,217,0,1,216,137,80,0.0,0.004608294930875576,0.9953917050691244,0.631336405529954,0.3686635944700461
7557,130,109,21,75,55,0.8384615384615385,0.16153846153846155,0.5769230769230769,0.4230769230769231,12,0,0,12,11,1,0.0,0.0,1.0,0.9166666666666666,0.08333333333333333
7558,1740,1162,578,824,916,0.667816091954023,0.332183908045977,0.4735632183908046,0.5264367816091954,242,0,31,211,241,1,0.0,0.128099173553719,0.871900826446281,0.9958677685950413,0.004132231404958678
7559,383,206,177,321,62,0.5378590078328982,0.4621409921671018,0.8381201044386423,0.1618798955613577,710,91,156,463,505,205,0.12816901408450704,0.21971830985915494,0.652112676056338,0.7112676056338029,0.2887323943661972
7560,98,84,14,54,44,0.8571428571428571,0.14285714285714285,0.5510204081632653,0.4489795918367347,15,0,0,15,12,3,0.0,0.0,1.0,0.8,0.2
7561,105,89,16,64,41,0.8476190476190476,0.1523809523809524,0.6095238095238096,0.3904761904761905,28,0,0,28,26,2,0.0,0.0,1.0,0.9285714285714286,0.07142857142857142
7562,324,236,88,238,86,0.7283950617283951,0.2716049382716049,0.7345679012345679,0.2654320987654321,47,1,1,45,43,4,0.02127659574468085,0.02127659574468085,0.9574468085106383,0.9148936170212766,0.0851063829787234
7563,184,106,78,158,26,0.5760869565217391,0.42391304347826086,0.8586956521739131,0.14130434782608695,139,0,43,96,139,0,0.0,0.30935251798561153,0.6906474820143885,1.0,0.0
7564,427,339,88,287,140,0.7939110070257611,0.20608899297423888,0.6721311475409836,0.32786885245901637,88,11,21,56,82,6,0.125,0.23863636363636365,0.6363636363636364,0.9318181818181818,0.06818181818181818
7565,56,9,47,49,7,0.16071428571428573,0.8392857142857143,0.875,0.125,570,0,0,570,570,0,0.0,0.0,1.0,1.0,0.0
7566,122,99,23,78,44,0.8114754098360656,0.1885245901639344,0.639344262295082,0.36065573770491804,12,0,0,12,9,3,0.0,0.0,1.0,0.75,0.25
7567,144,116,28,110,34,0.8055555555555556,0.19444444444444445,0.7638888888888888,0.2361111111111111,67,0,0,67,50,17,0.0,0.0,1.0,0.746268656716418,0.2537313432835821
7568,187,109,78,161,26,0.5828877005347594,0.41711229946524064,0.8609625668449198,0.13903743315508021,140,0,43,97,140,0,0.0,0.30714285714285716,0.6928571428571428,1.0,0.0
7569,100,86,14,68,32,0.86,0.14,0.68,0.32,272,1,1,270,197,75,0.003676470588235294,0.003676470588235294,0.9926470588235294,0.7242647058823529,0.2757352941176471
7570,184,106,78,158,26,0.5760869565217391,0.42391304347826086,0.8586956521739131,0.14130434782608695,139,0,43,96,139,0,0.0,0.30935251798561153,0.6906474820143885,1.0,0.0
7571,220,151,69,161,59,0.6863636363636364,0.31363636363636366,0.7318181818181818,0.2681818181818182,13,0,0,13,12,1,0.0,0.0,1.0,0.9230769230769231,0.07692307692307693
7572,1787,1152,635,848,939,0.6446558477895915,0.3553441522104085,0.4745383324006715,0.5254616675993284,251,0,27,224,248,3,0.0,0.10756972111553785,0.8924302788844621,0.9880478087649402,0.01195219123505976
7573,1889,1243,646,934,955,0.6580201164637375,0.3419798835362626,0.49444150344097404,0.505558496559026,219,0,28,191,218,1,0.0,0.1278538812785388,0.8721461187214612,0.9954337899543378,0.0045662100456621
7574,1744,1132,612,843,901,0.6490825688073395,0.35091743119266056,0.4833715596330275,0.5166284403669725,208,0,24,184,206,2,0.0,0.11538461538461539,0.8846153846153846,0.9903846153846154,0.009615384615384616
7575,84,27,57,65,19,0.32142857142857145,0.6785714285714286,0.7738095238095238,0.2261904761904762,561,0,0,561,561,0,0.0,0.0,1.0,1.0,0.0
7576,901,457,444,425,476,0.5072142064372919,0.49278579356270813,0.4716981132075472,0.5283018867924528,362,2,49,311,358,4,0.0055248618784530384,0.13535911602209943,0.8591160220994475,0.988950276243094,0.011049723756906077
7577,220,171,49,162,58,0.7772727272727272,0.22272727272727272,0.7363636363636363,0.2636363636363636,50,4,8,38,45,5,0.08,0.16,0.76,0.9,0.1
7578,94,76,18,66,28,0.8085106382978723,0.19148936170212766,0.7021276595744681,0.2978723404255319,179,0,2,177,128,51,0.0,0.0111731843575419,0.9888268156424581,0.7150837988826816,0.2849162011173184
7579,184,106,78,158,26,0.5760869565217391,0.42391304347826086,0.8586956521739131,0.14130434782608695,139,0,43,96,139,0,0.0,0.30935251798561153,0.6906474820143885,1.0,0.0
7580,187,109,78,161,26,0.5828877005347594,0.41711229946524064,0.8609625668449198,0.13903743315508021,140,0,43,97,140,0,0.0,0.30714285714285716,0.6928571428571428,1.0,0.0
7581,226,197,29,193,33,0.8716814159292036,0.12831858407079647,0.8539823008849557,0.14601769911504425,38,0,0,38,34,4,0.0,0.0,1.0,0.8947368421052632,0.10526315789473684
7582,203,120,83,177,26,0.5911330049261084,0.4088669950738916,0.8719211822660099,0.12807881773399016,148,1,42,105,147,1,0.006756756756756757,0.28378378378378377,0.7094594594594594,0.9932432432432432,0.006756756756756757
7583,203,120,83,177,26,0.5911330049261084,0.4088669950738916,0.8719211822660099,0.12807881773399016,146,1,42,103,145,1,0.00684931506849315,0.2876712328767123,0.7054794520547946,0.9931506849315068,0.00684931506849315
7584,145,131,14,96,49,0.903448275862069,0.09655172413793103,0.6620689655172414,0.33793103448275863,9,0,0,9,8,1,0.0,0.0,1.0,0.8888888888888888,0.1111111111111111
7585,584,459,125,400,184,0.785958904109589,0.21404109589041095,0.684931506849315,0.3150684931506849,46,0,0,46,40,6,0.0,0.0,1.0,0.8695652173913043,0.13043478260869565
7586,118,99,19,71,47,0.8389830508474576,0.16101694915254236,0.6016949152542372,0.3983050847457627,13,0,0,13,11,2,0.0,0.0,1.0,0.8461538461538461,0.15384615384615385
7587,1724,1120,604,845,879,0.6496519721577726,0.3503480278422274,0.49013921113689096,0.509860788863109,209,0,22,187,209,0,0.0,0.10526315789473684,0.8947368421052632,1.0,0.0
7588,153,133,20,92,61,0.869281045751634,0.13071895424836602,0.6013071895424836,0.39869281045751637,12,0,0,12,9,3,0.0,0.0,1.0,0.75,0.25
7589,119,103,16,78,41,0.865546218487395,0.13445378151260504,0.6554621848739496,0.3445378151260504,13,0,0,13,11,2,0.0,0.0,1.0,0.8461538461538461,0.15384615384615385
7590,187,109,78,161,26,0.5828877005347594,0.41711229946524064,0.8609625668449198,0.13903743315508021,140,0,43,97,140,0,0.0,0.30714285714285716,0.6928571428571428,1.0,0.0
7591,223,186,37,183,40,0.8340807174887892,0.16591928251121077,0.820627802690583,0.17937219730941703,51,1,1,49,46,5,0.0196078431372549,0.0196078431372549,0.9607843137254902,0.9019607843137255,0.09803921568627451
7592,830,583,247,585,245,0.7024096385542169,0.29759036144578316,0.7048192771084337,0.29518072289156627,704,0,117,587,303,401,0.0,0.16619318181818182,0.8338068181818182,0.4303977272727273,0.5696022727272727
7593,175,141,34,129,46,0.8057142857142857,0.19428571428571428,0.7371428571428571,0.26285714285714284,163,0,1,162,125,38,0.0,0.006134969325153374,0.9938650306748467,0.7668711656441718,0.2331288343558282
7594,3299,2658,641,2663,636,0.8056986965747196,0.19430130342528038,0.8072143073658684,0.19278569263413156,132,1,41,90,132,0,0.007575757575757576,0.3106060606060606,0.6818181818181818,1.0,0.0
7595,203,120,83,177,26,0.5911330049261084,0.4088669950738916,0.8719211822660099,0.12807881773399016,146,1,42,103,145,1,0.00684931506849315,0.2876712328767123,0.7054794520547946,0.9931506849315068,0.00684931506849315
7596,1701,1120,581,849,852,0.6584362139917695,0.34156378600823045,0.4991181657848324,0.5008818342151675,185,0,22,163,185,0,0.0,0.11891891891891893,0.8810810810810811,1.0,0.0
7597,105,88,17,61,44,0.8380952380952381,0.1619047619047619,0.580952380952381,0.41904761904761906,12,0,0,12,10,2,0.0,0.0,1.0,0.8333333333333334,0.16666666666666666
7598,196,163,33,146,50,0.8316326530612245,0.1683673469387755,0.7448979591836735,0.25510204081632654,266,1,2,263,174,92,0.0037593984962406013,0.007518796992481203,0.9887218045112782,0.6541353383458647,0.3458646616541353
7599,187,109,78,161,26,0.5828877005347594,0.41711229946524064,0.8609625668449198,0.13903743315508021,140,0,43,97,140,0,0.0,0.30714285714285716,0.6928571428571428,1.0,0.0
7600,165,148,17,106,59,0.896969696969697,0.10303030303030303,0.6424242424242425,0.3575757575757576,10,0,0,10,9,1,0.0,0.0,1.0,0.9,0.1
7601,3299,2658,641,2663,636,0.8056986965747196,0.19430130342528038,0.8072143073658684,0.19278569263413156,132,1,41,90,132,0,0.007575757575757576,0.3106060606060606,0.6818181818181818,1.0,0.0
7602,138,120,18,84,54,0.8695652173913043,0.13043478260869565,0.6086956521739131,0.391304347826087,36,0,0,36,32,4,0.0,0.0,1.0,0.8888888888888888,0.1111111111111111
7603,146,115,31,113,33,0.7876712328767124,0.21232876712328766,0.773972602739726,0.22602739726027396,20,0,0,20,16,4,0.0,0.0,1.0,0.8,0.2
7604,1850,1234,616,928,922,0.667027027027027,0.33297297297297296,0.5016216216216216,0.4983783783783784,211,0,20,191,209,2,0.0,0.0947867298578199,0.9052132701421801,0.990521327014218,0.009478672985781991
7605,165,131,34,131,34,0.793939393939394,0.20606060606060606,0.793939393939394,0.20606060606060606,12,0,0,12,10,2,0.0,0.0,1.0,0.8333333333333334,0.16666666666666666
7606,938,444,494,427,511,0.47334754797441364,0.5266524520255863,0.4552238805970149,0.5447761194029851,142,2,16,124,140,2,0.014084507042253521,0.11267605633802817,0.8732394366197183,0.9859154929577465,0.014084507042253521
7607,121,106,15,79,42,0.8760330578512396,0.12396694214876033,0.6528925619834711,0.34710743801652894,163,2,2,159,140,23,0.012269938650306749,0.012269938650306749,0.9754601226993865,0.8588957055214724,0.1411042944785276
7608,258,214,44,206,52,0.8294573643410853,0.17054263565891473,0.7984496124031008,0.20155038759689922,62,1,3,58,57,5,0.016129032258064516,0.04838709677419355,0.9354838709677419,0.9193548387096774,0.08064516129032258
7609,287,234,53,223,64,0.8153310104529616,0.18466898954703834,0.7770034843205574,0.2229965156794425,52,4,8,40,47,5,0.07692307692307693,0.15384615384615385,0.7692307692307693,0.9038461538461539,0.09615384615384616
7610,194,161,33,143,51,0.8298969072164949,0.17010309278350516,0.7371134020618557,0.26288659793814434,263,1,2,260,176,87,0.0038022813688212928,0.0076045627376425855,0.9885931558935361,0.6692015209125475,0.33079847908745247
7611,262,205,57,197,65,0.7824427480916031,0.21755725190839695,0.7519083969465649,0.2480916030534351,50,2,1,47,46,4,0.04,0.02,0.94,0.92,0.08
7612,474,289,185,401,73,0.609704641350211,0.39029535864978904,0.8459915611814346,0.1540084388185654,283,11,65,207,272,11,0.038869257950530034,0.22968197879858657,0.7314487632508834,0.9611307420494699,0.038869257950530034
7613,246,201,45,196,50,0.8170731707317073,0.18292682926829268,0.7967479674796748,0.2032520325203252,54,1,1,52,48,6,0.018518518518518517,0.018518518518518517,0.9629629629629629,0.8888888888888888,0.1111111111111111
7614,128,108,20,74,54,0.84375,0.15625,0.578125,0.421875,10,0,0,10,8,2,0.0,0.0,1.0,0.8,0.2
7615,3299,2658,641,2663,636,0.8056986965747196,0.19430130342528038,0.8072143073658684,0.19278569263413156,75,1,41,33,75,0,0.013333333333333334,0.5466666666666666,0.44,1.0,0.0
7616,89,71,18,36,53,0.797752808988764,0.20224719101123595,0.4044943820224719,0.5955056179775281,12,0,0,12,10,2,0.0,0.0,1.0,0.8333333333333334,0.16666666666666666
7617,1951,1313,638,1001,950,0.6729882111737571,0.32701178882624293,0.513070220399795,0.486929779600205,258,0,23,235,256,2,0.0,0.08914728682170543,0.9108527131782945,0.9922480620155039,0.007751937984496124
7618,4235,3499,736,3395,840,0.8262101534828807,0.17378984651711923,0.8016528925619835,0.19834710743801653,113,1,82,30,113,0,0.008849557522123894,0.7256637168141593,0.26548672566371684,1.0,0.0
7619,890,437,453,419,471,0.4910112359550562,0.5089887640449439,0.4707865168539326,0.5292134831460674,336,2,33,301,330,6,0.005952380952380952,0.09821428571428571,0.8958333333333334,0.9821428571428571,0.017857142857142856
7620,1711,1091,620,860,851,0.6376388077147866,0.36236119228521335,0.5026300409117476,0.4973699590882525,180,0,23,157,179,1,0.0,0.12777777777777777,0.8722222222222222,0.9944444444444445,0.005555555555555556
7621,1815,1197,618,882,933,0.6595041322314049,0.34049586776859503,0.4859504132231405,0.5140495867768595,199,0,15,184,198,1,0.0,0.07537688442211055,0.9246231155778895,0.9949748743718593,0.005025125628140704
7622,3457,2792,665,2804,653,0.8076366792016199,0.1923633207983801,0.8111078970205381,0.18889210297946196,132,1,41,90,132,0,0.007575757575757576,0.3106060606060606,0.6818181818181818,1.0,0.0
7623,109,92,17,67,42,0.8440366972477065,0.1559633027522936,0.6146788990825688,0.3853211009174312,13,0,0,13,11,2,0.0,0.0,1.0,0.8461538461538461,0.15384615384615385
7624,515,217,298,315,200,0.42135922330097086,0.5786407766990291,0.6116504854368932,0.3883495145631068,260,2,15,243,256,4,0.007692307692307693,0.057692307692307696,0.9346153846153846,0.9846153846153847,0.015384615384615385
7625,66,19,47,58,8,0.2878787878787879,0.7121212121212122,0.8787878787878788,0.12121212121212122,611,0,0,611,611,0,0.0,0.0,1.0,1.0,0.0
7626,117,95,22,73,44,0.811965811965812,0.18803418803418803,0.6239316239316239,0.37606837606837606,11,0,0,11,10,1,0.0,0.0,1.0,0.9090909090909091,0.09090909090909091
7627,215,180,35,177,38,0.8372093023255814,0.16279069767441862,0.8232558139534883,0.17674418604651163,29,0,0,29,24,5,0.0,0.0,1.0,0.8275862068965517,0.1724137931034483
7628,134,110,24,94,40,0.8208955223880597,0.1791044776119403,0.7014925373134329,0.29850746268656714,194,0,3,191,134,60,0.0,0.015463917525773196,0.9845360824742269,0.6907216494845361,0.30927835051546393
7629,121,99,22,73,48,0.8181818181818182,0.18181818181818182,0.6033057851239669,0.39669421487603307,9,0,0,9,8,1,0.0,0.0,1.0,0.8888888888888888,0.1111111111111111
7630,54,6,48,49,5,0.1111111111111111,0.8888888888888888,0.9074074074074074,0.09259259259259259,642,0,0,642,642,0,0.0,0.0,1.0,1.0,0.0
7631,184,106,78,158,26,0.5760869565217391,0.42391304347826086,0.8586956521739131,0.14130434782608695,139,0,43,96,139,0,0.0,0.30935251798561153,0.6906474820143885,1.0,0.0
7632,211,106,105,158,53,0.5023696682464455,0.4976303317535545,0.7488151658767772,0.25118483412322273,75,0,22,53,56,19,0.0,0.29333333333333333,0.7066666666666667,0.7466666666666667,0.25333333333333335
7633,77,60,17,40,37,0.7792207792207793,0.22077922077922077,0.5194805194805194,0.4805194805194805,9,0,0,9,7,2,0.0,0.0,1.0,0.7777777777777778,0.2222222222222222
7634,1767,1173,594,896,871,0.6638370118845501,0.3361629881154499,0.5070741369552915,0.49292586304470853,239,0,19,220,238,1,0.0,0.0794979079497908,0.9205020920502092,0.99581589958159,0.0041841004184100415
7635,173,140,33,131,42,0.8092485549132948,0.1907514450867052,0.7572254335260116,0.24277456647398843,106,0,1,105,73,33,0.0,0.009433962264150943,0.9905660377358491,0.6886792452830188,0.3113207547169811
7636,257,206,51,197,60,0.8015564202334631,0.19844357976653695,0.7665369649805448,0.23346303501945526,35,2,0,33,31,4,0.05714285714285714,0.0,0.9428571428571428,0.8857142857142857,0.11428571428571428
7637,1686,1114,572,860,826,0.66073546856465,0.33926453143534996,0.5100830367734283,0.48991696322657174,241,0,27,214,241,0,0.0,0.11203319502074689,0.8879668049792531,1.0,0.0
7638,112,91,21,70,42,0.8125,0.1875,0.625,0.375,14,0,0,14,11,3,0.0,0.0,1.0,0.7857142857142857,0.21428571428571427
7639,153,137,16,120,33,0.8954248366013072,0.10457516339869281,0.7843137254901961,0.21568627450980393,128,1,85,42,126,2,0.0078125,0.6640625,0.328125,0.984375,0.015625
7640,53,6,47,48,5,0.11320754716981132,0.8867924528301887,0.9056603773584906,0.09433962264150944,502,0,0,502,502,0,0.0,0.0,1.0,1.0,0.0
7641,140,124,16,113,27,0.8857142857142857,0.11428571428571428,0.8071428571428572,0.19285714285714287,122,1,85,36,121,1,0.00819672131147541,0.6967213114754098,0.29508196721311475,0.9918032786885246,0.00819672131147541
7642,180,158,22,111,69,0.8777777777777778,0.12222222222222222,0.6166666666666667,0.38333333333333336,258,2,3,253,166,92,0.007751937984496124,0.011627906976744186,0.9806201550387597,0.6434108527131783,0.35658914728682173
7643,48,36,12,34,14,0.75,0.25,0.7083333333333334,0.2916666666666667,8,0,0,8,7,1,0.0,0.0,1.0,0.875,0.125
7644,125,102,23,80,45,0.816,0.184,0.64,0.36,10,0,0,10,9,1,0.0,0.0,1.0,0.9,0.1
7645,207,123,84,180,27,0.5942028985507246,0.4057971014492754,0.8695652173913043,0.13043478260869565,145,1,44,100,144,1,0.006896551724137931,0.30344827586206896,0.6896551724137931,0.993103448275862,0.006896551724137931
7646,277,225,52,218,59,0.8122743682310469,0.18772563176895307,0.7870036101083032,0.21299638989169675,50,1,1,48,45,5,0.02,0.02,0.96,0.9,0.1
7647,1996,1333,663,998,998,0.6678356713426854,0.33216432865731466,0.5,0.5,229,0,31,198,225,4,0.0,0.13537117903930132,0.8646288209606987,0.982532751091703,0.017467248908296942
7648,253,156,97,222,31,0.616600790513834,0.383399209486166,0.8774703557312253,0.1225296442687747,182,1,48,133,181,1,0.005494505494505495,0.26373626373626374,0.7307692307692307,0.9945054945054945,0.005494505494505495
7649,296,245,51,237,59,0.8277027027027027,0.17229729729729729,0.8006756756756757,0.19932432432432431,49,1,1,47,44,5,0.02040816326530612,0.02040816326530612,0.9591836734693877,0.8979591836734694,0.10204081632653061
7650,99,89,10,59,40,0.898989898989899,0.10101010101010101,0.5959595959595959,0.40404040404040403,13,0,0,13,11,2,0.0,0.0,1.0,0.8461538461538461,0.15384615384615385
7651,87,70,17,59,28,0.8045977011494253,0.19540229885057472,0.6781609195402298,0.3218390804597701,11,0,0,11,10,1,0.0,0.0,1.0,0.9090909090909091,0.09090909090909091
7652,277,237,40,232,45,0.855595667870036,0.1444043321299639,0.8375451263537906,0.1624548736462094,28,1,1,26,24,4,0.03571428571428571,0.03571428571428571,0.9285714285714286,0.8571428571428571,0.14285714285714285
7653,173,143,30,138,35,0.8265895953757225,0.17341040462427745,0.7976878612716763,0.2023121387283237,17,0,0,17,12,5,0.0,0.0,1.0,0.7058823529411765,0.29411764705882354
7654,184,106,78,158,26,0.5760869565217391,0.42391304347826086,0.8586956521739131,0.14130434782608695,139,0,43,96,139,0,0.0,0.30935251798561153,0.6906474820143885,1.0,0.0
7655,184,106,78,158,26,0.5760869565217391,0.42391304347826086,0.8586956521739131,0.14130434782608695,139,0,43,96,139,0,0.0,0.30935251798561153,0.6906474820143885,1.0,0.0
7656,279,176,103,242,37,0.6308243727598566,0.36917562724014336,0.8673835125448028,0.13261648745519714,148,1,43,104,139,9,0.006756756756756757,0.2905405405405405,0.7027027027027027,0.9391891891891891,0.060810810810810814
7657,81,66,15,44,37,0.8148148148148148,0.18518518518518517,0.5432098765432098,0.4567901234567901,11,0,0,11,10,1,0.0,0.0,1.0,0.9090909090909091,0.09090909090909091
7658,91,74,17,58,33,0.8131868131868132,0.18681318681318682,0.6373626373626373,0.3626373626373626,64,0,1,63,53,11,0.0,0.015625,0.984375,0.828125,0.171875
7659,265,219,46,218,47,0.8264150943396227,0.17358490566037735,0.8226415094339623,0.17735849056603772,20,0,1,19,16,4,0.0,0.05,0.95,0.8,0.2
7660,183,106,77,157,26,0.5792349726775956,0.4207650273224044,0.8579234972677595,0.14207650273224043,140,0,42,98,140,0,0.0,0.3,0.7,1.0,0.0
7661,111,93,18,63,48,0.8378378378378378,0.16216216216216217,0.5675675675675675,0.43243243243243246,13,0,0,13,9,4,0.0,0.0,1.0,0.6923076923076923,0.3076923076923077
7662,138,119,19,81,57,0.8623188405797102,0.13768115942028986,0.5869565217391305,0.41304347826086957,8,0,0,8,7,1,0.0,0.0,1.0,0.875,0.125
7663,152,136,16,120,32,0.8947368421052632,0.10526315789473684,0.7894736842105263,0.21052631578947367,126,1,85,40,124,2,0.007936507936507936,0.6746031746031746,0.31746031746031744,0.9841269841269841,0.015873015873015872
7664,1771,1159,612,867,904,0.6544325239977414,0.3455674760022586,0.48955392433653305,0.510446075663467,269,0,29,240,269,0,0.0,0.10780669144981413,0.8921933085501859,1.0,0.0
7665,125,100,25,81,44,0.8,0.2,0.648,0.352,262,0,3,259,168,94,0.0,0.011450381679389313,0.9885496183206107,0.6412213740458015,0.35877862595419846
7666,141,123,18,69,72,0.8723404255319149,0.1276595744680851,0.48936170212765956,0.5106382978723404,12,0,0,12,11,1,0.0,0.0,1.0,0.9166666666666666,0.08333333333333333
7667,115,99,16,70,45,0.8608695652173913,0.1391304347826087,0.6086956521739131,0.391304347826087,12,0,0,12,9,3,0.0,0.0,1.0,0.75,0.25
7668,267,176,91,189,78,0.6591760299625468,0.3408239700374532,0.7078651685393258,0.29213483146067415,14,0,0,14,12,2,0.0,0.0,1.0,0.8571428571428571,0.14285714285714285
7669,96,54,42,80,16,0.5625,0.4375,0.8333333333333334,0.16666666666666666,178,3,92,83,170,8,0.016853932584269662,0.5168539325842697,0.46629213483146065,0.9550561797752809,0.0449438202247191
7670,203,120,83,177,26,0.5911330049261084,0.4088669950738916,0.8719211822660099,0.12807881773399016,148,1,42,105,147,1,0.006756756756756757,0.28378378378378377,0.7094594594594594,0.9932432432432432,0.006756756756756757
7671,1836,1225,611,934,902,0.6672113289760349,0.33278867102396514,0.5087145969498911,0.4912854030501089,216,0,21,195,216,0,0.0,0.09722222222222222,0.9027777777777778,1.0,0.0
7672,894,444,450,398,496,0.4966442953020134,0.5033557046979866,0.4451901565995526,0.5548098434004475,172,2,11,159,150,22,0.011627906976744186,0.06395348837209303,0.9244186046511628,0.872093023255814,0.12790697674418605
7673,162,131,31,123,39,0.808641975308642,0.19135802469135801,0.7592592592592593,0.24074074074074073,72,0,0,72,67,5,0.0,0.0,1.0,0.9305555555555556,0.06944444444444445
7674,152,132,20,94,58,0.868421052631579,0.13157894736842105,0.618421052631579,0.3815789473684211,8,0,0,8,7,1,0.0,0.0,1.0,0.875,0.125
7675,138,119,19,86,52,0.8623188405797102,0.13768115942028986,0.6231884057971014,0.37681159420289856,14,0,0,14,12,2,0.0,0.0,1.0,0.8571428571428571,0.14285714285714285
7676,1755,1153,602,829,926,0.656980056980057,0.34301994301994304,0.4723646723646724,0.5276353276353276,242,0,20,222,239,3,0.0,0.08264462809917356,0.9173553719008265,0.987603305785124,0.012396694214876033
7677,1835,1227,608,920,915,0.6686648501362398,0.3313351498637602,0.5013623978201635,0.4986376021798365,239,0,20,219,236,3,0.0,0.08368200836820083,0.9163179916317992,0.9874476987447699,0.012552301255230125
7678,3299,2658,641,2663,636,0.8056986965747196,0.19430130342528038,0.8072143073658684,0.19278569263413156,75,1,41,33,75,0,0.013333333333333334,0.5466666666666666,0.44,1.0,0.0
7679,425,335,90,280,145,0.788235294117647,0.21176470588235294,0.6588235294117647,0.3411764705882353,85,11,21,53,80,5,0.12941176470588237,0.24705882352941178,0.6235294117647059,0.9411764705882353,0.058823529411764705
7680,110,92,18,66,44,0.8363636363636363,0.16363636363636364,0.6,0.4,10,0,0,10,9,1,0.0,0.0,1.0,0.9,0.1
7681,125,100,25,94,31,0.8,0.2,0.752,0.248,19,0,0,19,15,4,0.0,0.0,1.0,0.7894736842105263,0.21052631578947367
7682,207,123,84,180,27,0.5942028985507246,0.4057971014492754,0.8695652173913043,0.13043478260869565,145,1,44,100,144,1,0.006896551724137931,0.30344827586206896,0.6896551724137931,0.993103448275862,0.006896551724137931
7683,203,120,83,177,26,0.5911330049261084,0.4088669950738916,0.8719211822660099,0.12807881773399016,148,1,42,105,147,1,0.006756756756756757,0.28378378378378377,0.7094594594594594,0.9932432432432432,0.006756756756756757
7684,3410,2752,658,2766,644,0.8070381231671554,0.19296187683284458,0.8111436950146628,0.18885630498533723,132,1,41,90,132,0,0.007575757575757576,0.3106060606060606,0.6818181818181818,1.0,0.0
7685,75,59,16,31,44,0.7866666666666666,0.21333333333333335,0.41333333333333333,0.5866666666666667,15,0,0,15,13,2,0.0,0.0,1.0,0.8666666666666667,0.13333333333333333
7686,125,110,15,86,39,0.88,0.12,0.688,0.312,12,0,0,12,10,2,0.0,0.0,1.0,0.8333333333333334,0.16666666666666666
7687,172,149,23,99,73,0.8662790697674418,0.13372093023255813,0.5755813953488372,0.42441860465116277,11,0,0,11,8,3,0.0,0.0,1.0,0.7272727272727273,0.2727272727272727
7688,50,3,47,47,3,0.06,0.94,0.94,0.06,551,0,0,551,551,0,0.0,0.0,1.0,1.0,0.0
7689,184,106,78,158,26,0.5760869565217391,0.42391304347826086,0.8586956521739131,0.14130434782608695,139,0,43,96,139,0,0.0,0.30935251798561153,0.6906474820143885,1.0,0.0
7690,121,97,24,73,48,0.8016528925619835,0.19834710743801653,0.6033057851239669,0.39669421487603307,9,0,0,9,7,2,0.0,0.0,1.0,0.7777777777777778,0.2222222222222222
7691,187,109,78,161,26,0.5828877005347594,0.41711229946524064,0.8609625668449198,0.13903743315508021,140,0,43,97,140,0,0.0,0.30714285714285716,0.6928571428571428,1.0,0.0
7692,1795,1195,600,882,913,0.6657381615598886,0.3342618384401114,0.4913649025069638,0.5086350974930363,286,0,24,262,281,5,0.0,0.08391608391608392,0.916083916083916,0.9825174825174825,0.017482517482517484
7693,271,223,48,218,53,0.8228782287822878,0.17712177121771217,0.8044280442804428,0.19557195571955718,73,0,0,73,67,6,0.0,0.0,1.0,0.9178082191780822,0.0821917808219178
7694,476,291,185,402,74,0.6113445378151261,0.38865546218487396,0.8445378151260504,0.15546218487394958,286,11,65,210,275,11,0.038461538461538464,0.22727272727272727,0.7342657342657343,0.9615384615384616,0.038461538461538464
7695,1863,1261,602,907,956,0.6768652710681696,0.3231347289318304,0.4868491680085883,0.5131508319914116,235,0,27,208,234,1,0.0,0.1148936170212766,0.8851063829787233,0.9957446808510638,0.00425531914893617
7696,149,127,22,93,56,0.8523489932885906,0.1476510067114094,0.6241610738255033,0.37583892617449666,11,0,0,11,8,3,0.0,0.0,1.0,0.7272727272727273,0.2727272727272727
7697,103,84,19,77,26,0.8155339805825242,0.18446601941747573,0.7475728155339806,0.2524271844660194,7,0,0,7,6,1,0.0,0.0,1.0,0.8571428571428571,0.14285714285714285
7698,4126,3352,774,3279,847,0.812409112942317,0.18759088705768298,0.7947164323800291,0.2052835676199709,134,2,41,91,131,3,0.014925373134328358,0.30597014925373134,0.6791044776119403,0.9776119402985075,0.022388059701492536
7699,94,75,19,63,31,0.7978723404255319,0.20212765957446807,0.6702127659574468,0.32978723404255317,8,0,0,8,7,1,0.0,0.0,1.0,0.875,0.125
7700,1786,1176,610,858,928,0.658454647256439,0.341545352743561,0.48040313549832026,0.5195968645016797,268,0,27,241,264,4,0.0,0.10074626865671642,0.8992537313432836,0.9850746268656716,0.014925373134328358
7701,129,108,21,81,48,0.8372093023255814,0.16279069767441862,0.627906976744186,0.37209302325581395,10,0,0,10,7,3,0.0,0.0,1.0,0.7,0.3
7702,143,121,22,77,66,0.8461538461538461,0.15384615384615385,0.5384615384615384,0.46153846153846156,13,0,0,13,8,5,0.0,0.0,1.0,0.6153846153846154,0.38461538461538464
7703,82,68,14,56,26,0.8292682926829268,0.17073170731707318,0.6829268292682927,0.3170731707317073,12,0,0,12,9,3,0.0,0.0,1.0,0.75,0.25
7704,1765,1176,589,822,943,0.6662889518413597,0.3337110481586402,0.46572237960339946,0.5342776203966005,268,0,20,248,267,1,0.0,0.07462686567164178,0.9253731343283582,0.996268656716418,0.0037313432835820895
7705,199,161,38,159,40,0.8090452261306532,0.19095477386934673,0.7989949748743719,0.20100502512562815,10,0,0,10,9,1,0.0,0.0,1.0,0.9,0.1
7706,1793,1188,605,927,866,0.6625766871165644,0.3374233128834356,0.517010596765198,0.482989403234802,267,0,25,242,264,3,0.0,0.09363295880149813,0.9063670411985019,0.9887640449438202,0.011235955056179775
7707,203,120,83,177,26,0.5911330049261084,0.4088669950738916,0.8719211822660099,0.12807881773399016,146,1,42,103,145,1,0.00684931506849315,0.2876712328767123,0.7054794520547946,0.9931506849315068,0.00684931506849315
7708,109,87,22,74,35,0.7981651376146789,0.2018348623853211,0.6788990825688074,0.3211009174311927,123,0,0,123,111,12,0.0,0.0,1.0,0.9024390243902439,0.0975609756097561
7709,97,85,12,60,37,0.8762886597938144,0.12371134020618557,0.6185567010309279,0.38144329896907214,15,0,1,14,13,2,0.0,0.06666666666666667,0.9333333333333333,0.8666666666666667,0.13333333333333333
7710,896,457,439,400,496,0.5100446428571429,0.48995535714285715,0.44642857142857145,0.5535714285714286,235,2,36,197,234,1,0.00851063829787234,0.15319148936170213,0.8382978723404255,0.9957446808510638,0.00425531914893617
7711,117,90,27,88,29,0.7692307692307693,0.23076923076923078,0.7521367521367521,0.24786324786324787,13,0,0,13,11,2,0.0,0.0,1.0,0.8461538461538461,0.15384615384615385
7712,142,120,22,82,60,0.8450704225352113,0.15492957746478872,0.5774647887323944,0.4225352112676056,9,0,0,9,7,2,0.0,0.0,1.0,0.7777777777777778,0.2222222222222222
7713,1757,1144,613,904,853,0.6511098463289698,0.34889015367103016,0.514513375071144,0.485486624928856,160,0,21,139,160,0,0.0,0.13125,0.86875,1.0,0.0
7714,127,107,20,82,45,0.84251968503937,0.15748031496062992,0.6456692913385826,0.3543307086614173,13,0,0,13,10,3,0.0,0.0,1.0,0.7692307692307693,0.23076923076923078
7715,53,5,48,50,3,0.09433962264150944,0.9056603773584906,0.9433962264150944,0.05660377358490566,604,0,0,604,604,0,0.0,0.0,1.0,1.0,0.0
7716,4228,3499,729,3388,840,0.8275780510879849,0.17242194891201515,0.8013245033112583,0.1986754966887417,112,1,82,29,112,0,0.008928571428571428,0.7321428571428571,0.25892857142857145,1.0,0.0
7717,129,110,19,89,40,0.8527131782945736,0.14728682170542637,0.689922480620155,0.31007751937984496,8,0,0,8,7,1,0.0,0.0,1.0,0.875,0.125
7718,111,94,17,59,52,0.8468468468468469,0.15315315315315314,0.5315315315315315,0.46846846846846846,13,0,0,13,11,2,0.0,0.0,1.0,0.8461538461538461,0.15384615384615385
7719,3987,3234,753,3181,806,0.8111361926260346,0.18886380737396538,0.7978429897165789,0.20215701028342112,67,1,36,30,62,5,0.014925373134328358,0.5373134328358209,0.44776119402985076,0.9253731343283582,0.07462686567164178
7720,187,109,78,161,26,0.5828877005347594,0.41711229946524064,0.8609625668449198,0.13903743315508021,84,0,43,41,84,0,0.0,0.5119047619047619,0.4880952380952381,1.0,0.0
7721,833,418,415,392,441,0.5018007202881153,0.49819927971188477,0.47058823529411764,0.5294117647058824,394,2,26,366,390,4,0.005076142131979695,0.06598984771573604,0.9289340101522843,0.9898477157360406,0.01015228426395939
7722,474,289,185,401,73,0.609704641350211,0.39029535864978904,0.8459915611814346,0.1540084388185654,284,11,65,208,273,11,0.03873239436619718,0.22887323943661972,0.7323943661971831,0.9612676056338029,0.03873239436619718
7723,312,244,68,236,76,0.782051282051282,0.21794871794871795,0.7564102564102564,0.24358974358974358,69,6,13,50,65,4,0.08695652173913043,0.18840579710144928,0.7246376811594203,0.9420289855072463,0.057971014492753624
7724,266,216,50,207,59,0.8120300751879699,0.18796992481203006,0.7781954887218046,0.22180451127819548,48,2,0,46,43,5,0.041666666666666664,0.0,0.9583333333333334,0.8958333333333334,0.10416666666666667
7725,103,90,13,62,41,0.8737864077669902,0.1262135922330097,0.6019417475728155,0.39805825242718446,13,0,0,13,9,4,0.0,0.0,1.0,0.6923076923076923,0.3076923076923077
7726,133,115,18,81,52,0.8646616541353384,0.13533834586466165,0.6090225563909775,0.39097744360902253,35,0,0,35,32,3,0.0,0.0,1.0,0.9142857142857143,0.08571428571428572
7727,48,46,2,24,24,0.9583333333333334,0.041666666666666664,0.5,0.5,24,0,0,24,22,2,0.0,0.0,1.0,0.9166666666666666,0.08333333333333333
7728,107,87,20,68,39,0.8130841121495327,0.18691588785046728,0.6355140186915887,0.3644859813084112,12,0,0,12,10,2,0.0,0.0,1.0,0.8333333333333334,0.16666666666666666
7729,877,441,436,428,449,0.5028506271379704,0.49714937286202965,0.4880273660205245,0.5119726339794755,94,2,4,88,89,5,0.02127659574468085,0.0425531914893617,0.9361702127659575,0.9468085106382979,0.05319148936170213
7730,123,102,21,71,52,0.8292682926829268,0.17073170731707318,0.5772357723577236,0.42276422764227645,8,0,0,8,7,1,0.0,0.0,1.0,0.875,0.125
7731,129,120,9,114,15,0.9302325581395349,0.06976744186046512,0.8837209302325582,0.11627906976744186,34,0,1,33,30,4,0.0,0.029411764705882353,0.9705882352941176,0.8823529411764706,0.11764705882352941
7732,129,107,22,77,52,0.8294573643410853,0.17054263565891473,0.5968992248062015,0.40310077519379844,14,0,0,14,11,3,0.0,0.0,1.0,0.7857142857142857,0.21428571428571427
7733,95,75,20,52,43,0.7894736842105263,0.21052631578947367,0.5473684210526316,0.45263157894736844,11,0,0,11,10,1,0.0,0.0,1.0,0.9090909090909091,0.09090909090909091
7734,203,120,83,177,26,0.5911330049261084,0.4088669950738916,0.8719211822660099,0.12807881773399016,148,1,42,105,147,1,0.006756756756756757,0.28378378378378377,0.7094594594594594,0.9932432432432432,0.006756756756756757
7735,84,65,19,50,34,0.7738095238095238,0.2261904761904762,0.5952380952380952,0.40476190476190477,8,0,0,8,7,1,0.0,0.0,1.0,0.875,0.125
7736,1798,1204,594,901,897,0.6696329254727474,0.3303670745272525,0.5011123470522804,0.4988876529477197,256,0,20,236,255,1,0.0,0.078125,0.921875,0.99609375,0.00390625
7737,1701,1135,566,830,871,0.6672545561434451,0.33274544385655497,0.4879482657260435,0.5120517342739564,266,0,40,226,265,1,0.0,0.15037593984962405,0.849624060150376,0.9962406015037594,0.0037593984962406013
7738,1953,1294,659,960,993,0.6625704045058883,0.3374295954941116,0.4915514592933948,0.5084485407066052,219,0,26,193,215,4,0.0,0.1187214611872146,0.8812785388127854,0.9817351598173516,0.0182648401826484
7739,112,90,22,67,45,0.8035714285714286,0.19642857142857142,0.5982142857142857,0.4017857142857143,10,0,0,10,8,2,0.0,0.0,1.0,0.8,0.2
7740,258,205,53,192,66,0.7945736434108527,0.2054263565891473,0.7441860465116279,0.2558139534883721,55,4,8,43,50,5,0.07272727272727272,0.14545454545454545,0.7818181818181819,0.9090909090909091,0.09090909090909091
7741,87,72,15,53,34,0.8275862068965517,0.1724137931034483,0.6091954022988506,0.39080459770114945,13,0,0,13,10,3,0.0,0.0,1.0,0.7692307692307693,0.23076923076923078
7742,255,209,46,207,48,0.8196078431372549,0.1803921568627451,0.8117647058823529,0.18823529411764706,17,0,0,17,13,4,0.0,0.0,1.0,0.7647058823529411,0.23529411764705882
7743,51,4,47,47,4,0.0784313725490196,0.9215686274509803,0.9215686274509803,0.0784313725490196,613,0,0,613,613,0,0.0,0.0,1.0,1.0,0.0
7744,167,131,36,129,38,0.7844311377245509,0.2155688622754491,0.7724550898203593,0.2275449101796407,12,0,0,12,11,1,0.0,0.0,1.0,0.9166666666666666,0.08333333333333333
7745,94,79,15,49,45,0.8404255319148937,0.1595744680851064,0.5212765957446809,0.4787234042553192,18,0,0,18,14,4,0.0,0.0,1.0,0.7777777777777778,0.2222222222222222
7746,187,109,78,161,26,0.5828877005347594,0.41711229946524064,0.8609625668449198,0.13903743315508021,140,0,43,97,140,0,0.0,0.30714285714285716,0.6928571428571428,1.0,0.0
7747,168,145,23,104,64,0.8630952380952381,0.13690476190476192,0.6190476190476191,0.38095238095238093,9,0,0,9,8,1,0.0,0.0,1.0,0.8888888888888888,0.1111111111111111
7748,4228,3499,729,3388,840,0.8275780510879849,0.17242194891201515,0.8013245033112583,0.1986754966887417,112,1,82,29,112,0,0.008928571428571428,0.7321428571428571,0.25892857142857145,1.0,0.0
7749,259,194,65,197,62,0.749034749034749,0.25096525096525096,0.7606177606177607,0.23938223938223938,11,0,0,11,10,1,0.0,0.0,1.0,0.9090909090909091,0.09090909090909091
7750,101,80,21,61,40,0.7920792079207921,0.2079207920792079,0.6039603960396039,0.39603960396039606,8,0,0,8,7,1,0.0,0.0,1.0,0.875,0.125
7751,139,119,20,81,58,0.8561151079136691,0.14388489208633093,0.5827338129496403,0.4172661870503597,15,0,0,15,12,3,0.0,0.0,1.0,0.8,0.2
7752,124,102,22,72,52,0.8225806451612904,0.1774193548387097,0.5806451612903226,0.41935483870967744,9,0,0,9,8,1,0.0,0.0,1.0,0.8888888888888888,0.1111111111111111
7753,902,442,460,422,480,0.49002217294900224,0.5099778270509978,0.4678492239467849,0.532150776053215,327,2,51,274,324,3,0.0061162079510703364,0.1559633027522936,0.8379204892966361,0.9908256880733946,0.009174311926605505
7754,111,98,13,68,43,0.8828828828828829,0.11711711711711711,0.6126126126126126,0.38738738738738737,14,0,0,14,10,4,0.0,0.0,1.0,0.7142857142857143,0.2857142857142857
7755,907,460,447,396,511,0.5071664829106945,0.4928335170893054,0.43660418963616315,0.5633958103638368,424,2,35,387,421,3,0.0047169811320754715,0.08254716981132075,0.9127358490566038,0.9929245283018868,0.007075471698113208
7756,272,219,53,214,58,0.8051470588235294,0.1948529411764706,0.7867647058823529,0.21323529411764705,52,3,2,47,48,4,0.057692307692307696,0.038461538461538464,0.9038461538461539,0.9230769230769231,0.07692307692307693
7757,875,435,440,379,496,0.49714285714285716,0.5028571428571429,0.43314285714285716,0.5668571428571428,237,2,17,218,232,5,0.008438818565400843,0.07172995780590717,0.919831223628692,0.9789029535864979,0.02109704641350211
7758,207,123,84,180,27,0.5942028985507246,0.4057971014492754,0.8695652173913043,0.13043478260869565,145,1,44,100,144,1,0.006896551724137931,0.30344827586206896,0.6896551724137931,0.993103448275862,0.006896551724137931
7759,187,109,78,161,26,0.5828877005347594,0.41711229946524064,0.8609625668449198,0.13903743315508021,140,0,43,97,140,0,0.0,0.30714285714285716,0.6928571428571428,1.0,0.0
7760,195,165,30,156,39,0.8461538461538461,0.15384615384615385,0.8,0.2,33,1,2,30,29,4,0.030303030303030304,0.06060606060606061,0.9090909090909091,0.8787878787878788,0.12121212121212122
7761,110,91,19,76,34,0.8272727272727273,0.17272727272727273,0.6909090909090909,0.3090909090909091,9,0,0,9,8,1,0.0,0.0,1.0,0.8888888888888888,0.1111111111111111
7762,249,197,52,188,61,0.7911646586345381,0.20883534136546184,0.7550200803212851,0.24497991967871485,70,0,0,70,53,17,0.0,0.0,1.0,0.7571428571428571,0.24285714285714285
7763,202,119,83,176,26,0.5891089108910891,0.41089108910891087,0.8712871287128713,0.12871287128712872,147,1,42,104,146,1,0.006802721088435374,0.2857142857142857,0.7074829931972789,0.9931972789115646,0.006802721088435374
7764,432,340,92,285,147,0.7870370370370371,0.21296296296296297,0.6597222222222222,0.3402777777777778,87,11,21,55,82,5,0.12643678160919541,0.2413793103448276,0.632183908045977,0.9425287356321839,0.05747126436781609
7765,76,63,13,44,32,0.8289473684210527,0.17105263157894737,0.5789473684210527,0.42105263157894735,11,0,0,11,9,2,0.0,0.0,1.0,0.8181818181818182,0.18181818181818182
7766,55,8,47,49,6,0.14545454545454545,0.8545454545454545,0.8909090909090909,0.10909090909090909,573,0,0,573,573,0,0.0,0.0,1.0,1.0,0.0
7767,4228,3499,729,3388,840,0.8275780510879849,0.17242194891201515,0.8013245033112583,0.1986754966887417,112,1,82,29,112,0,0.008928571428571428,0.7321428571428571,0.25892857142857145,1.0,0.0
7768,109,91,18,62,47,0.8348623853211009,0.1651376146788991,0.5688073394495413,0.43119266055045874,11,0,0,11,10,1,0.0,0.0,1.0,0.9090909090909091,0.09090909090909091
7769,127,109,18,68,59,0.8582677165354331,0.14173228346456693,0.5354330708661418,0.4645669291338583,12,0,0,12,8,4,0.0,0.0,1.0,0.6666666666666666,0.3333333333333333
7770,99,79,20,56,43,0.797979797979798,0.20202020202020202,0.5656565656565656,0.43434343434343436,10,0,0,10,9,1,0.0,0.0,1.0,0.9,0.1
7771,4180,3430,750,3366,814,0.8205741626794258,0.17942583732057416,0.8052631578947368,0.19473684210526315,1184,96,430,658,1057,127,0.08108108108108109,0.36317567567567566,0.5557432432432432,0.8927364864864865,0.10726351351351351
7772,1782,1169,613,917,865,0.6560044893378226,0.3439955106621773,0.5145903479236813,0.48540965207631875,276,0,33,243,273,3,0.0,0.11956521739130435,0.8804347826086957,0.9891304347826086,0.010869565217391304
7773,103,85,18,63,40,0.8252427184466019,0.17475728155339806,0.6116504854368932,0.3883495145631068,8,0,0,8,7,1,0.0,0.0,1.0,0.875,0.125
7774,152,136,16,120,32,0.8947368421052632,0.10526315789473684,0.7894736842105263,0.21052631578947367,126,1,85,40,124,2,0.007936507936507936,0.6746031746031746,0.31746031746031744,0.9841269841269841,0.015873015873015872
7775,377,299,78,249,128,0.7931034482758621,0.20689655172413793,0.6604774535809018,0.3395225464190981,88,11,21,56,80,8,0.125,0.23863636363636365,0.6363636363636364,0.9090909090909091,0.09090909090909091
7776,178,142,36,139,39,0.797752808988764,0.20224719101123595,0.7808988764044944,0.21910112359550563,12,0,0,12,11,1,0.0,0.0,1.0,0.9166666666666666,0.08333333333333333
7777,88,76,12,54,34,0.8636363636363636,0.13636363636363635,0.6136363636363636,0.38636363636363635,11,0,0,11,10,1,0.0,0.0,1.0,0.9090909090909091,0.09090909090909091
7778,861,414,447,396,465,0.4808362369337979,0.519163763066202,0.45993031358885017,0.5400696864111498,439,2,39,398,433,6,0.004555808656036446,0.0888382687927107,0.9066059225512528,0.9863325740318907,0.01366742596810934
7779,182,161,21,117,65,0.8846153846153846,0.11538461538461539,0.6428571428571429,0.35714285714285715,247,0,2,245,174,73,0.0,0.008097165991902834,0.9919028340080972,0.7044534412955465,0.29554655870445345
7780,93,70,23,56,37,0.7526881720430108,0.24731182795698925,0.6021505376344086,0.3978494623655914,30,0,0,30,28,2,0.0,0.0,1.0,0.9333333333333333,0.06666666666666667
7781,187,109,78,161,26,0.5828877005347594,0.41711229946524064,0.8609625668449198,0.13903743315508021,140,0,43,97,140,0,0.0,0.30714285714285716,0.6928571428571428,1.0,0.0
7782,331,239,92,275,56,0.7220543806646526,0.27794561933534745,0.8308157099697885,0.1691842900302115,264,27,115,122,207,57,0.10227272727272728,0.4356060606060606,0.4621212121212121,0.7840909090909091,0.2159090909090909
7783,1,0,1,1,0,0.0,1.0,1.0,0.0,37,0,10,27,36,1,0.0,0.2702702702702703,0.7297297297297297,0.972972972972973,0.02702702702702703
7784,150,131,19,84,66,0.8733333333333333,0.12666666666666668,0.56,0.44,9,0,0,9,8,1,0.0,0.0,1.0,0.8888888888888888,0.1111111111111111
7785,180,157,23,148,32,0.8722222222222222,0.12777777777777777,0.8222222222222222,0.17777777777777778,166,1,100,65,165,1,0.006024096385542169,0.6024096385542169,0.39156626506024095,0.9939759036144579,0.006024096385542169
7786,254,210,44,195,59,0.8267716535433071,0.1732283464566929,0.7677165354330708,0.23228346456692914,54,2,1,51,50,4,0.037037037037037035,0.018518518518518517,0.9444444444444444,0.9259259259259259,0.07407407407407407
7787,51,3,48,48,3,0.058823529411764705,0.9411764705882353,0.9411764705882353,0.058823529411764705,585,0,0,585,585,0,0.0,0.0,1.0,1.0,0.0
7788,85,70,15,62,23,0.8235294117647058,0.17647058823529413,0.7294117647058823,0.27058823529411763,9,0,0,9,7,2,0.0,0.0,1.0,0.7777777777777778,0.2222222222222222
7789,158,125,33,123,35,0.7911392405063291,0.2088607594936709,0.7784810126582279,0.22151898734177214,17,0,0,17,13,4,0.0,0.0,1.0,0.7647058823529411,0.23529411764705882
7790,152,136,16,120,32,0.8947368421052632,0.10526315789473684,0.7894736842105263,0.21052631578947367,126,1,85,40,124,2,0.007936507936507936,0.6746031746031746,0.31746031746031744,0.9841269841269841,0.015873015873015872
7791,474,289,185,401,73,0.609704641350211,0.39029535864978904,0.8459915611814346,0.1540084388185654,284,11,65,208,273,11,0.03873239436619718,0.22887323943661972,0.7323943661971831,0.9612676056338029,0.03873239436619718
7792,152,131,21,78,74,0.8618421052631579,0.13815789473684212,0.5131578947368421,0.4868421052631579,16,0,0,16,13,3,0.0,0.0,1.0,0.8125,0.1875
7793,130,103,27,98,32,0.7923076923076923,0.2076923076923077,0.7538461538461538,0.24615384615384617,16,0,0,16,12,4,0.0,0.0,1.0,0.75,0.25
7794,133,113,20,85,48,0.849624060150376,0.15037593984962405,0.6390977443609023,0.3609022556390977,24,0,0,24,21,3,0.0,0.0,1.0,0.875,0.125
7795,167,134,33,124,43,0.8023952095808383,0.19760479041916168,0.7425149700598802,0.25748502994011974,51,2,0,49,47,4,0.0392156862745098,0.0,0.9607843137254902,0.9215686274509803,0.0784313725490196
7796,209,168,41,154,55,0.8038277511961722,0.19617224880382775,0.7368421052631579,0.2631578947368421,74,0,0,74,69,5,0.0,0.0,1.0,0.9324324324324325,0.06756756756756757
7797,203,167,36,164,39,0.8226600985221675,0.17733990147783252,0.8078817733990148,0.1921182266009852,44,1,1,42,39,5,0.022727272727272728,0.022727272727272728,0.9545454545454546,0.8863636363636364,0.11363636363636363
7798,316,253,63,242,74,0.8006329113924051,0.19936708860759494,0.7658227848101266,0.23417721518987342,57,4,8,45,52,5,0.07017543859649122,0.14035087719298245,0.7894736842105263,0.9122807017543859,0.08771929824561403
7799,336,275,61,265,71,0.8184523809523809,0.18154761904761904,0.7886904761904762,0.2113095238095238,273,10,168,95,260,13,0.03663003663003663,0.6153846153846154,0.34798534798534797,0.9523809523809523,0.047619047619047616
7800,66,18,48,60,6,0.2727272727272727,0.7272727272727273,0.9090909090909091,0.09090909090909091,455,0,0,455,455,0,0.0,0.0,1.0,1.0,0.0
7801,1743,1095,648,879,864,0.6282271944922547,0.3717728055077453,0.504302925989673,0.49569707401032703,174,0,33,141,174,0,0.0,0.1896551724137931,0.8103448275862069,1.0,0.0
7802,4101,3325,776,3280,821,0.8107778590587662,0.18922214094123385,0.7998049256278956,0.20019507437210438,75,1,42,32,75,0,0.013333333333333334,0.56,0.4266666666666667,1.0,0.0
7803,152,133,19,107,45,0.875,0.125,0.7039473684210527,0.29605263157894735,13,1,0,12,11,2,0.07692307692307693,0.0,0.9230769230769231,0.8461538461538461,0.15384615384615385
7804,1786,1174,612,875,911,0.6573348264277715,0.3426651735722284,0.4899216125419933,0.5100783874580067,198,0,25,173,197,1,0.0,0.12626262626262627,0.8737373737373737,0.9949494949494949,0.005050505050505051
7805,108,92,16,63,45,0.8518518518518519,0.14814814814814814,0.5833333333333334,0.4166666666666667,24,0,0,24,20,4,0.0,0.0,1.0,0.8333333333333334,0.16666666666666666
7806,1841,1207,634,926,915,0.6556219445953286,0.34437805540467137,0.5029875067897882,0.49701249321021185,273,0,28,245,270,3,0.0,0.10256410256410256,0.8974358974358975,0.989010989010989,0.01098901098901099
7807,59,11,48,53,6,0.1864406779661017,0.8135593220338984,0.8983050847457628,0.1016949152542373,648,0,0,648,637,11,0.0,0.0,1.0,0.9830246913580247,0.016975308641975308
7808,1787,1173,614,875,912,0.6564073866815893,0.34359261331841073,0.48964745383324004,0.51035254616676,237,0,25,212,232,5,0.0,0.10548523206751055,0.8945147679324894,0.9789029535864979,0.02109704641350211
7809,3460,2795,665,2807,653,0.8078034682080925,0.19219653179190752,0.8112716763005781,0.18872832369942197,132,1,41,90,132,0,0.007575757575757576,0.3106060606060606,0.6818181818181818,1.0,0.0
7810,139,119,20,85,54,0.8561151079136691,0.14388489208633093,0.6115107913669064,0.38848920863309355,9,0,0,9,7,2,0.0,0.0,1.0,0.7777777777777778,0.2222222222222222
7811,117,97,20,70,47,0.8290598290598291,0.17094017094017094,0.5982905982905983,0.4017094017094017,9,0,0,9,8,1,0.0,0.0,1.0,0.8888888888888888,0.1111111111111111
7812,140,124,16,113,27,0.8857142857142857,0.11428571428571428,0.8071428571428572,0.19285714285714287,122,1,85,36,121,1,0.00819672131147541,0.6967213114754098,0.29508196721311475,0.9918032786885246,0.00819672131147541
7813,184,106,78,158,26,0.5760869565217391,0.42391304347826086,0.8586956521739131,0.14130434782608695,139,0,43,96,139,0,0.0,0.30935251798561153,0.6906474820143885,1.0,0.0
7814,1760,1165,595,908,852,0.6619318181818182,0.3380681818181818,0.5159090909090909,0.48409090909090907,236,0,24,212,236,0,0.0,0.1016949152542373,0.8983050847457628,1.0,0.0
7815,139,123,16,112,27,0.8848920863309353,0.11510791366906475,0.8057553956834532,0.19424460431654678,122,1,86,35,121,1,0.00819672131147541,0.7049180327868853,0.28688524590163933,0.9918032786885246,0.00819672131147541
7816,106,91,15,91,15,0.8584905660377359,0.14150943396226415,0.8584905660377359,0.14150943396226415,137,2,76,59,136,1,0.014598540145985401,0.5547445255474452,0.4306569343065693,0.9927007299270073,0.0072992700729927005
7817,279,234,45,227,52,0.8387096774193549,0.16129032258064516,0.8136200716845878,0.1863799283154122,53,1,1,51,49,4,0.018867924528301886,0.018867924528301886,0.9622641509433962,0.9245283018867925,0.07547169811320754
7818,189,164,25,107,82,0.8677248677248677,0.13227513227513227,0.5661375661375662,0.43386243386243384,15,0,0,15,13,2,0.0,0.0,1.0,0.8666666666666667,0.13333333333333333
7819,1765,1149,616,831,934,0.6509915014164306,0.3490084985835694,0.4708215297450425,0.5291784702549575,227,0,31,196,227,0,0.0,0.13656387665198239,0.8634361233480177,1.0,0.0
7820,187,109,78,161,26,0.5828877005347594,0.41711229946524064,0.8609625668449198,0.13903743315508021,140,0,43,97,140,0,0.0,0.30714285714285716,0.6928571428571428,1.0,0.0
7821,52,4,48,49,3,0.07692307692307693,0.9230769230769231,0.9423076923076923,0.057692307692307696,734,0,0,734,734,0,0.0,0.0,1.0,1.0,0.0
7822,187,109,78,161,26,0.5828877005347594,0.41711229946524064,0.8609625668449198,0.13903743315508021,140,0,43,97,140,0,0.0,0.30714285714285716,0.6928571428571428,1.0,0.0
7823,215,171,44,169,46,0.7953488372093023,0.20465116279069767,0.786046511627907,0.21395348837209302,18,0,1,17,14,4,0.0,0.05555555555555555,0.9444444444444444,0.7777777777777778,0.2222222222222222
7824,4101,3325,776,3280,821,0.8107778590587662,0.18922214094123385,0.7998049256278956,0.20019507437210438,75,1,42,32,75,0,0.013333333333333334,0.56,0.4266666666666667,1.0,0.0
7825,52,5,47,48,4,0.09615384615384616,0.9038461538461539,0.9230769230769231,0.07692307692307693,559,0,0,559,559,0,0.0,0.0,1.0,1.0,0.0
7826,338,277,61,267,71,0.8195266272189349,0.1804733727810651,0.7899408284023669,0.21005917159763313,278,10,168,100,265,13,0.03597122302158273,0.60431654676259,0.3597122302158273,0.9532374100719424,0.046762589928057555
7827,97,82,15,58,39,0.845360824742268,0.15463917525773196,0.5979381443298969,0.4020618556701031,20,0,0,20,16,4,0.0,0.0,1.0,0.8,0.2
7828,857,439,418,393,464,0.5122520420070011,0.48774795799299886,0.45857642940490084,0.5414235705950992,226,2,21,203,225,1,0.008849557522123894,0.09292035398230089,0.8982300884955752,0.995575221238938,0.004424778761061947
7829,115,97,18,63,52,0.8434782608695652,0.1565217391304348,0.5478260869565217,0.45217391304347826,15,0,0,15,9,6,0.0,0.0,1.0,0.6,0.4
7830,165,134,31,120,45,0.8121212121212121,0.18787878787878787,0.7272727272727273,0.2727272727272727,65,0,1,64,55,10,0.0,0.015384615384615385,0.9846153846153847,0.8461538461538461,0.15384615384615385
7831,288,228,60,218,70,0.7916666666666666,0.20833333333333334,0.7569444444444444,0.24305555555555555,59,4,8,47,53,6,0.06779661016949153,0.13559322033898305,0.7966101694915254,0.8983050847457628,0.1016949152542373
7832,296,245,51,239,57,0.8277027027027027,0.17229729729729729,0.8074324324324325,0.19256756756756757,53,1,1,51,48,5,0.018867924528301886,0.018867924528301886,0.9622641509433962,0.9056603773584906,0.09433962264150944
7833,187,109,78,161,26,0.5828877005347594,0.41711229946524064,0.8609625668449198,0.13903743315508021,140,0,43,97,140,0,0.0,0.30714285714285716,0.6928571428571428,1.0,0.0
7834,76,28,48,63,13,0.3684210526315789,0.631578947368421,0.8289473684210527,0.17105263157894737,501,0,0,501,501,0,0.0,0.0,1.0,1.0,0.0
7835,921,429,492,404,517,0.46579804560260585,0.5342019543973942,0.4386536373507057,0.5613463626492943,370,2,51,317,370,0,0.005405405405405406,0.13783783783783785,0.8567567567567568,1.0,0.0
7836,137,116,21,112,25,0.8467153284671532,0.15328467153284672,0.8175182481751825,0.18248175182481752,110,1,2,107,78,32,0.00909090909090909,0.01818181818181818,0.9727272727272728,0.7090909090909091,0.2909090909090909
7837,184,106,78,158,26,0.5760869565217391,0.42391304347826086,0.8586956521739131,0.14130434782608695,139,0,43,96,139,0,0.0,0.30935251798561153,0.6906474820143885,1.0,0.0
7838,119,93,26,83,36,0.7815126050420168,0.2184873949579832,0.6974789915966386,0.3025210084033613,292,1,3,288,204,88,0.003424657534246575,0.010273972602739725,0.9863013698630136,0.6986301369863014,0.3013698630136986
7839,760,376,384,329,431,0.49473684210526314,0.5052631578947369,0.4328947368421053,0.5671052631578948,239,2,23,214,237,2,0.008368200836820083,0.09623430962343096,0.895397489539749,0.9916317991631799,0.008368200836820083
7840,183,141,42,130,53,0.7704918032786885,0.22950819672131148,0.7103825136612022,0.2896174863387978,60,4,8,48,56,4,0.06666666666666667,0.13333333333333333,0.8,0.9333333333333333,0.06666666666666667
7841,651,524,127,425,226,0.804915514592934,0.19508448540706605,0.65284178187404,0.34715821812596004,46,0,0,46,41,5,0.0,0.0,1.0,0.8913043478260869,0.10869565217391304
7842,297,242,55,235,62,0.8148148148148148,0.18518518518518517,0.7912457912457912,0.20875420875420875,44,1,2,41,38,6,0.022727272727272728,0.045454545454545456,0.9318181818181818,0.8636363636363636,0.13636363636363635
7843,1760,1172,588,863,897,0.6659090909090909,0.3340909090909091,0.4903409090909091,0.5096590909090909,168,0,27,141,167,1,0.0,0.16071428571428573,0.8392857142857143,0.9940476190476191,0.005952380952380952
7844,201,162,39,160,41,0.8059701492537313,0.19402985074626866,0.7960199004975125,0.20398009950248755,21,0,1,20,15,6,0.0,0.047619047619047616,0.9523809523809523,0.7142857142857143,0.2857142857142857
7845,60,13,47,53,7,0.21666666666666667,0.7833333333333333,0.8833333333333333,0.11666666666666667,528,0,0,528,528,0,0.0,0.0,1.0,1.0,0.0
7846,122,100,22,60,62,0.819672131147541,0.18032786885245902,0.4918032786885246,0.5081967213114754,12,0,0,12,11,1,0.0,0.0,1.0,0.9166666666666666,0.08333333333333333
7847,278,234,44,229,49,0.841726618705036,0.15827338129496402,0.8237410071942446,0.17625899280575538,44,1,1,42,40,4,0.022727272727272728,0.022727272727272728,0.9545454545454546,0.9090909090909091,0.09090909090909091
7848,184,106,78,158,26,0.5760869565217391,0.42391304347826086,0.8586956521739131,0.14130434782608695,139,0,43,96,139,0,0.0,0.30935251798561153,0.6906474820143885,1.0,0.0
7849,55,8,47,49,6,0.14545454545454545,0.8545454545454545,0.8909090909090909,0.10909090909090909,524,0,0,524,524,0,0.0,0.0,1.0,1.0,0.0
7850,180,164,16,100,80,0.9111111111111111,0.08888888888888889,0.5555555555555556,0.4444444444444444,13,0,0,13,12,1,0.0,0.0,1.0,0.9230769230769231,0.07692307692307693
7851,144,127,17,83,61,0.8819444444444444,0.11805555555555555,0.5763888888888888,0.4236111111111111,9,0,0,9,7,2,0.0,0.0,1.0,0.7777777777777778,0.2222222222222222
7852,140,117,23,82,58,0.8357142857142857,0.16428571428571428,0.5857142857142857,0.4142857142857143,15,0,0,15,11,4,0.0,0.0,1.0,0.7333333333333333,0.26666666666666666
7853,62,14,48,53,9,0.22580645161290322,0.7741935483870968,0.8548387096774194,0.14516129032258066,502,0,0,502,502,0,0.0,0.0,1.0,1.0,0.0
7854,320,226,94,230,90,0.70625,0.29375,0.71875,0.28125,62,6,8,48,56,6,0.0967741935483871,0.12903225806451613,0.7741935483870968,0.9032258064516129,0.0967741935483871
7855,184,106,78,158,26,0.5760869565217391,0.42391304347826086,0.8586956521739131,0.14130434782608695,139,0,43,96,139,0,0.0,0.30935251798561153,0.6906474820143885,1.0,0.0
7856,72,59,13,57,15,0.8194444444444444,0.18055555555555555,0.7916666666666666,0.20833333333333334,8,0,0,8,7,1,0.0,0.0,1.0,0.875,0.125
7857,852,392,460,355,497,0.460093896713615,0.539906103286385,0.4166666666666667,0.5833333333333334,377,2,58,317,367,10,0.005305039787798408,0.15384615384615385,0.8408488063660478,0.9734748010610079,0.026525198938992044
7858,142,123,19,92,50,0.8661971830985915,0.13380281690140844,0.647887323943662,0.352112676056338,13,0,0,13,9,4,0.0,0.0,1.0,0.6923076923076923,0.3076923076923077
7859,196,159,37,150,46,0.8112244897959183,0.18877551020408162,0.7653061224489796,0.23469387755102042,51,1,2,48,46,5,0.0196078431372549,0.0392156862745098,0.9411764705882353,0.9019607843137255,0.09803921568627451
7860,58,43,15,31,27,0.7413793103448276,0.25862068965517243,0.5344827586206896,0.46551724137931033,9,0,0,9,8,1,0.0,0.0,1.0,0.8888888888888888,0.1111111111111111
7861,120,95,25,76,44,0.7916666666666666,0.20833333333333334,0.6333333333333333,0.36666666666666664,106,0,1,105,86,20,0.0,0.009433962264150943,0.9905660377358491,0.8113207547169812,0.18867924528301888
7862,305,238,67,224,81,0.780327868852459,0.21967213114754097,0.7344262295081967,0.26557377049180325,57,4,8,45,52,5,0.07017543859649122,0.14035087719298245,0.7894736842105263,0.9122807017543859,0.08771929824561403
7863,187,109,78,161,26,0.5828877005347594,0.41711229946524064,0.8609625668449198,0.13903743315508021,140,0,43,97,140,0,0.0,0.30714285714285716,0.6928571428571428,1.0,0.0
7864,180,147,33,145,35,0.8166666666666667,0.18333333333333332,0.8055555555555556,0.19444444444444445,12,0,0,12,11,1,0.0,0.0,1.0,0.9166666666666666,0.08333333333333333
7865,108,92,16,69,39,0.8518518518518519,0.14814814814814814,0.6388888888888888,0.3611111111111111,11,0,0,11,9,2,0.0,0.0,1.0,0.8181818181818182,0.18181818181818182
7866,203,120,83,177,26,0.5911330049261084,0.4088669950738916,0.8719211822660099,0.12807881773399016,146,1,42,103,145,1,0.00684931506849315,0.2876712328767123,0.7054794520547946,0.9931506849315068,0.00684931506849315
7867,1716,1125,591,872,844,0.6555944055944056,0.34440559440559443,0.5081585081585082,0.49184149184149184,258,0,23,235,257,1,0.0,0.08914728682170543,0.9108527131782945,0.9961240310077519,0.003875968992248062
7868,95,79,16,48,47,0.8315789473684211,0.16842105263157894,0.5052631578947369,0.49473684210526314,13,0,0,13,11,2,0.0,0.0,1.0,0.8461538461538461,0.15384615384615385
7869,636,508,128,421,215,0.7987421383647799,0.20125786163522014,0.6619496855345912,0.3380503144654088,48,0,0,48,42,6,0.0,0.0,1.0,0.875,0.125
7870,122,94,28,84,38,0.7704918032786885,0.22950819672131148,0.6885245901639344,0.3114754098360656,117,0,0,117,83,34,0.0,0.0,1.0,0.7094017094017094,0.2905982905982906
7871,88,74,14,51,37,0.8409090909090909,0.1590909090909091,0.5795454545454546,0.42045454545454547,10,0,0,10,8,2,0.0,0.0,1.0,0.8,0.2
7872,131,113,18,80,51,0.8625954198473282,0.13740458015267176,0.6106870229007634,0.3893129770992366,35,0,0,35,32,3,0.0,0.0,1.0,0.9142857142857143,0.08571428571428572
7873,68,56,12,40,28,0.8235294117647058,0.17647058823529413,0.5882352941176471,0.4117647058823529,10,0,0,10,9,1,0.0,0.0,1.0,0.9,0.1
7874,1891,1261,630,919,972,0.6668429402432575,0.3331570597567425,0.4859862506610259,0.514013749338974,247,0,34,213,247,0,0.0,0.13765182186234817,0.8623481781376519,1.0,0.0
7875,93,76,17,40,53,0.8172043010752689,0.1827956989247312,0.43010752688172044,0.5698924731182796,13,0,1,12,10,3,0.0,0.07692307692307693,0.9230769230769231,0.7692307692307693,0.23076923076923078
7876,1735,1143,592,837,898,0.6587896253602306,0.34121037463976944,0.48242074927953893,0.5175792507204611,243,0,22,221,241,2,0.0,0.09053497942386832,0.9094650205761317,0.9917695473251029,0.00823045267489712
7877,126,107,19,79,47,0.8492063492063492,0.15079365079365079,0.626984126984127,0.373015873015873,9,0,0,9,8,1,0.0,0.0,1.0,0.8888888888888888,0.1111111111111111
7878,105,90,15,68,37,0.8571428571428571,0.14285714285714285,0.6476190476190476,0.3523809523809524,9,0,0,9,8,1,0.0,0.0,1.0,0.8888888888888888,0.1111111111111111
7879,188,176,12,172,16,0.9361702127659575,0.06382978723404255,0.9148936170212766,0.0851063829787234,33,0,1,32,29,4,0.0,0.030303030303030304,0.9696969696969697,0.8787878787878788,0.12121212121212122
7880,184,106,78,158,26,0.5760869565217391,0.42391304347826086,0.8586956521739131,0.14130434782608695,139,0,43,96,139,0,0.0,0.30935251798561153,0.6906474820143885,1.0,0.0
7881,449,361,88,281,168,0.8040089086859689,0.19599109131403117,0.6258351893095768,0.3741648106904232,83,11,21,51,79,4,0.13253012048192772,0.25301204819277107,0.6144578313253012,0.9518072289156626,0.04819277108433735
7882,82,67,15,61,21,0.8170731707317073,0.18292682926829268,0.7439024390243902,0.25609756097560976,8,0,0,8,7,1,0.0,0.0,1.0,0.875,0.125
7883,100,81,19,68,32,0.81,0.19,0.68,0.32,8,0,0,8,7,1,0.0,0.0,1.0,0.875,0.125
7884,187,109,78,161,26,0.5828877005347594,0.41711229946524064,0.8609625668449198,0.13903743315508021,84,0,43,41,84,0,0.0,0.5119047619047619,0.4880952380952381,1.0,0.0
7885,3351,2703,648,2688,663,0.8066248880931065,0.19337511190689347,0.8021486123545211,0.19785138764547897,135,1,41,93,135,0,0.007407407407407408,0.3037037037037037,0.6888888888888889,1.0,0.0
7886,184,106,78,158,26,0.5760869565217391,0.42391304347826086,0.8586956521739131,0.14130434782608695,139,0,43,96,139,0,0.0,0.30935251798561153,0.6906474820143885,1.0,0.0
7887,153,129,24,116,37,0.8431372549019608,0.1568627450980392,0.7581699346405228,0.24183006535947713,123,1,0,122,89,34,0.008130081300813009,0.0,0.991869918699187,0.7235772357723578,0.2764227642276423
7888,112,98,14,68,44,0.875,0.125,0.6071428571428571,0.39285714285714285,10,0,0,10,8,2,0.0,0.0,1.0,0.8,0.2
7889,95,75,20,67,28,0.7894736842105263,0.21052631578947367,0.7052631578947368,0.29473684210526313,8,0,0,8,7,1,0.0,0.0,1.0,0.875,0.125
7890,822,389,433,348,474,0.4732360097323601,0.5267639902676399,0.4233576642335766,0.5766423357664233,367,2,33,332,363,4,0.005449591280653951,0.08991825613079019,0.9046321525885559,0.989100817438692,0.010899182561307902
7891,474,289,185,401,73,0.609704641350211,0.39029535864978904,0.8459915611814346,0.1540084388185654,284,11,65,208,273,11,0.03873239436619718,0.22887323943661972,0.7323943661971831,0.9612676056338029,0.03873239436619718
7892,184,106,78,158,26,0.5760869565217391,0.42391304347826086,0.8586956521739131,0.14130434782608695,83,0,43,40,83,0,0.0,0.5180722891566265,0.4819277108433735,1.0,0.0
7893,1826,1183,643,899,927,0.6478641840087623,0.35213581599123767,0.4923329682365827,0.5076670317634173,249,0,20,229,249,0,0.0,0.08032128514056225,0.9196787148594378,1.0,0.0
7894,184,106,78,158,26,0.5760869565217391,0.42391304347826086,0.8586956521739131,0.14130434782608695,83,0,43,40,83,0,0.0,0.5180722891566265,0.4819277108433735,1.0,0.0
7895,141,116,25,94,47,0.8226950354609929,0.1773049645390071,0.6666666666666666,0.3333333333333333,273,0,0,273,185,88,0.0,0.0,1.0,0.6776556776556777,0.32234432234432236
7896,103,83,20,63,40,0.8058252427184466,0.1941747572815534,0.6116504854368932,0.3883495145631068,11,0,0,11,8,3,0.0,0.0,1.0,0.7272727272727273,0.2727272727272727
7897,93,80,13,54,39,0.8602150537634409,0.13978494623655913,0.5806451612903226,0.41935483870967744,11,0,0,11,9,2,0.0,0.0,1.0,0.8181818181818182,0.18181818181818182
7898,150,135,15,122,28,0.9,0.1,0.8133333333333334,0.18666666666666668,141,0,82,59,141,0,0.0,0.5815602836879432,0.41843971631205673,1.0,0.0
7899,144,124,20,85,59,0.8611111111111112,0.1388888888888889,0.5902777777777778,0.4097222222222222,14,0,0,14,11,3,0.0,0.0,1.0,0.7857142857142857,0.21428571428571427
7900,203,120,83,177,26,0.5911330049261084,0.4088669950738916,0.8719211822660099,0.12807881773399016,148,1,42,105,147,1,0.006756756756756757,0.28378378378378377,0.7094594594594594,0.9932432432432432,0.006756756756756757
7901,125,102,23,80,45,0.816,0.184,0.64,0.36,10,0,0,10,9,1,0.0,0.0,1.0,0.9,0.1
7902,1768,1202,566,901,867,0.6798642533936652,0.3201357466063348,0.5096153846153846,0.49038461538461536,271,0,27,244,270,1,0.0,0.0996309963099631,0.9003690036900369,0.996309963099631,0.0036900369003690036
7903,136,117,19,89,47,0.8602941176470589,0.13970588235294118,0.6544117647058824,0.34558823529411764,13,0,0,13,8,5,0.0,0.0,1.0,0.6153846153846154,0.38461538461538464
7904,1755,1169,586,870,885,0.6660968660968661,0.3339031339031339,0.49572649572649574,0.5042735042735043,183,0,19,164,183,0,0.0,0.10382513661202186,0.8961748633879781,1.0,0.0
7905,53,6,47,48,5,0.11320754716981132,0.8867924528301887,0.9056603773584906,0.09433962264150944,416,0,0,416,416,0,0.0,0.0,1.0,1.0,0.0
7906,187,155,32,148,39,0.8288770053475936,0.1711229946524064,0.7914438502673797,0.20855614973262032,46,0,0,46,41,5,0.0,0.0,1.0,0.8913043478260869,0.10869565217391304
7907,137,120,17,81,56,0.8759124087591241,0.12408759124087591,0.5912408759124088,0.40875912408759124,34,0,0,34,31,3,0.0,0.0,1.0,0.9117647058823529,0.08823529411764706
7908,90,75,15,51,39,0.8333333333333334,0.16666666666666666,0.5666666666666667,0.43333333333333335,12,0,0,12,8,4,0.0,0.0,1.0,0.6666666666666666,0.3333333333333333
7909,64,49,15,41,23,0.765625,0.234375,0.640625,0.359375,8,0,0,8,7,1,0.0,0.0,1.0,0.875,0.125
7910,184,106,78,158,26,0.5760869565217391,0.42391304347826086,0.8586956521739131,0.14130434782608695,139,0,43,96,139,0,0.0,0.30935251798561153,0.6906474820143885,1.0,0.0
7911,171,140,31,135,36,0.8187134502923976,0.18128654970760233,0.7894736842105263,0.21052631578947367,37,0,0,37,32,5,0.0,0.0,1.0,0.8648648648648649,0.13513513513513514
7912,1866,1236,630,939,927,0.662379421221865,0.33762057877813506,0.5032154340836013,0.4967845659163987,290,0,33,257,288,2,0.0,0.11379310344827587,0.8862068965517241,0.993103448275862,0.006896551724137931
7913,200,159,41,148,52,0.795,0.205,0.74,0.26,56,4,9,43,52,4,0.07142857142857142,0.16071428571428573,0.7678571428571429,0.9285714285714286,0.07142857142857142
7914,249,190,59,184,65,0.7630522088353414,0.23694779116465864,0.7389558232931727,0.26104417670682734,37,0,1,36,32,5,0.0,0.02702702702702703,0.972972972972973,0.8648648648648649,0.13513513513513514
7915,187,109,78,161,26,0.5828877005347594,0.41711229946524064,0.8609625668449198,0.13903743315508021,140,0,43,97,140,0,0.0,0.30714285714285716,0.6928571428571428,1.0,0.0
7916,77,67,10,44,33,0.8701298701298701,0.12987012987012986,0.5714285714285714,0.42857142857142855,10,0,0,10,9,1,0.0,0.0,1.0,0.9,0.1
7917,180,157,23,148,32,0.8722222222222222,0.12777777777777777,0.8222222222222222,0.17777777777777778,167,1,100,66,166,1,0.005988023952095809,0.5988023952095808,0.39520958083832336,0.9940119760479041,0.005988023952095809
7918,185,153,32,150,35,0.827027027027027,0.17297297297297298,0.8108108108108109,0.1891891891891892,19,0,0,19,15,4,0.0,0.0,1.0,0.7894736842105263,0.21052631578947367
7919,449,357,92,292,157,0.7951002227171492,0.20489977728285078,0.6503340757238307,0.34966592427616927,86,11,21,54,81,5,0.12790697674418605,0.2441860465116279,0.627906976744186,0.9418604651162791,0.05813953488372093
7920,97,83,14,72,25,0.8556701030927835,0.14432989690721648,0.7422680412371134,0.25773195876288657,111,0,2,109,81,30,0.0,0.018018018018018018,0.9819819819819819,0.7297297297297297,0.2702702702702703
7921,139,123,16,112,27,0.8848920863309353,0.11510791366906475,0.8057553956834532,0.19424460431654678,108,0,78,30,107,1,0.0,0.7222222222222222,0.2777777777777778,0.9907407407407407,0.009259259259259259
7922,184,106,78,158,26,0.5760869565217391,0.42391304347826086,0.8586956521739131,0.14130434782608695,139,0,43,96,139,0,0.0,0.30935251798561153,0.6906474820143885,1.0,0.0
7923,139,123,16,82,57,0.8848920863309353,0.11510791366906475,0.5899280575539568,0.41007194244604317,15,0,0,15,11,4,0.0,0.0,1.0,0.7333333333333333,0.26666666666666666
7924,130,110,20,72,58,0.8461538461538461,0.15384615384615385,0.5538461538461539,0.4461538461538462,22,0,0,22,21,1,0.0,0.0,1.0,0.9545454545454546,0.045454545454545456
7925,120,99,21,92,28,0.825,0.175,0.7666666666666667,0.23333333333333334,100,0,0,100,61,39,0.0,0.0,1.0,0.61,0.39
7926,862,427,435,430,432,0.4953596287703016,0.5046403712296984,0.4988399071925754,0.5011600928074246,349,2,50,297,347,2,0.0057306590257879654,0.14326647564469913,0.8510028653295129,0.994269340974212,0.0057306590257879654
7927,57,10,47,50,7,0.17543859649122806,0.8245614035087719,0.8771929824561403,0.12280701754385964,530,0,0,530,530,0,0.0,0.0,1.0,1.0,0.0
7928,187,109,78,161,26,0.5828877005347594,0.41711229946524064,0.8609625668449198,0.13903743315508021,140,0,43,97,140,0,0.0,0.30714285714285716,0.6928571428571428,1.0,0.0
7929,243,198,45,196,47,0.8148148148148148,0.18518518518518517,0.8065843621399177,0.1934156378600823,41,1,1,39,37,4,0.024390243902439025,0.024390243902439025,0.9512195121951219,0.9024390243902439,0.0975609756097561
7930,141,119,22,77,64,0.8439716312056738,0.15602836879432624,0.5460992907801419,0.45390070921985815,14,0,0,14,10,4,0.0,0.0,1.0,0.7142857142857143,0.2857142857142857
7931,474,289,185,401,73,0.609704641350211,0.39029535864978904,0.8459915611814346,0.1540084388185654,284,11,65,208,273,11,0.03873239436619718,0.22887323943661972,0.7323943661971831,0.9612676056338029,0.03873239436619718
7932,4070,3298,772,3255,815,0.8103194103194103,0.18968058968058968,0.7997542997542998,0.20024570024570024,75,1,42,32,75,0,0.013333333333333334,0.56,0.4266666666666667,1.0,0.0
7933,146,125,21,95,51,0.8561643835616438,0.14383561643835616,0.6506849315068494,0.3493150684931507,243,0,2,241,177,66,0.0,0.00823045267489712,0.9917695473251029,0.7283950617283951,0.2716049382716049
7934,237,191,46,189,48,0.8059071729957806,0.1940928270042194,0.7974683544303798,0.20253164556962025,45,0,0,45,38,7,0.0,0.0,1.0,0.8444444444444444,0.15555555555555556
7935,268,216,52,209,59,0.8059701492537313,0.19402985074626866,0.7798507462686567,0.22014925373134328,17,0,1,16,13,4,0.0,0.058823529411764705,0.9411764705882353,0.7647058823529411,0.23529411764705882
7936,139,123,16,112,27,0.8848920863309353,0.11510791366906475,0.8057553956834532,0.19424460431654678,122,1,85,36,121,1,0.00819672131147541,0.6967213114754098,0.29508196721311475,0.9918032786885246,0.00819672131147541
7937,118,97,21,58,60,0.8220338983050848,0.17796610169491525,0.4915254237288136,0.5084745762711864,10,0,0,10,9,1,0.0,0.0,1.0,0.9,0.1
7938,96,78,18,69,27,0.8125,0.1875,0.71875,0.28125,114,0,2,112,79,35,0.0,0.017543859649122806,0.9824561403508771,0.6929824561403509,0.30701754385964913
7939,139,123,16,112,27,0.8848920863309353,0.11510791366906475,0.8057553956834532,0.19424460431654678,122,1,85,36,121,1,0.00819672131147541,0.6967213114754098,0.29508196721311475,0.9918032786885246,0.00819672131147541
7940,106,85,21,58,48,0.8018867924528302,0.19811320754716982,0.5471698113207547,0.4528301886792453,11,0,0,11,9,2,0.0,0.0,1.0,0.8181818181818182,0.18181818181818182
7941,952,487,465,418,534,0.5115546218487395,0.4884453781512605,0.43907563025210083,0.5609243697478992,200,2,23,175,196,4,0.01,0.115,0.875,0.98,0.02
7942,187,109,78,161,26,0.5828877005347594,0.41711229946524064,0.8609625668449198,0.13903743315508021,140,0,43,97,140,0,0.0,0.30714285714285716,0.6928571428571428,1.0,0.0
7943,138,111,27,102,36,0.8043478260869565,0.1956521739130435,0.7391304347826086,0.2608695652173913,130,0,2,128,99,31,0.0,0.015384615384615385,0.9846153846153847,0.7615384615384615,0.23846153846153847
7944,97,78,19,53,44,0.8041237113402062,0.1958762886597938,0.5463917525773195,0.4536082474226804,16,0,0,16,13,3,0.0,0.0,1.0,0.8125,0.1875
7945,133,118,15,109,24,0.8872180451127819,0.11278195488721804,0.8195488721804511,0.18045112781954886,136,0,79,57,136,0,0.0,0.5808823529411765,0.41911764705882354,1.0,0.0
7946,153,122,31,104,49,0.7973856209150327,0.20261437908496732,0.6797385620915033,0.3202614379084967,301,1,3,297,200,101,0.0033222591362126247,0.009966777408637873,0.9867109634551495,0.6644518272425249,0.33554817275747506
7947,130,105,25,87,43,0.8076923076923077,0.19230769230769232,0.6692307692307692,0.33076923076923076,270,1,1,268,176,94,0.003703703703703704,0.003703703703703704,0.9925925925925926,0.6518518518518519,0.34814814814814815
7948,126,106,20,81,45,0.8412698412698413,0.15873015873015872,0.6428571428571429,0.35714285714285715,13,0,0,13,10,3,0.0,0.0,1.0,0.7692307692307693,0.23076923076923078
7949,184,106,78,158,26,0.5760869565217391,0.42391304347826086,0.8586956521739131,0.14130434782608695,139,0,43,96,139,0,0.0,0.30935251798561153,0.6906474820143885,1.0,0.0
7950,93,71,22,63,30,0.7634408602150538,0.23655913978494625,0.6774193548387096,0.3225806451612903,11,0,0,11,9,2,0.0,0.0,1.0,0.8181818181818182,0.18181818181818182
7951,97,83,14,69,28,0.8556701030927835,0.14432989690721648,0.711340206185567,0.28865979381443296,8,0,0,8,7,1,0.0,0.0,1.0,0.875,0.125
7952,115,96,19,79,36,0.8347826086956521,0.16521739130434782,0.6869565217391305,0.3130434782608696,9,0,0,9,8,1,0.0,0.0,1.0,0.8888888888888888,0.1111111111111111
7953,135,120,15,109,26,0.8888888888888888,0.1111111111111111,0.8074074074074075,0.1925925925925926,123,1,83,39,122,1,0.008130081300813009,0.6747967479674797,0.3170731707317073,0.991869918699187,0.008130081300813009
7954,93,77,16,59,34,0.8279569892473119,0.17204301075268819,0.6344086021505376,0.3655913978494624,24,0,0,24,23,1,0.0,0.0,1.0,0.9583333333333334,0.041666666666666664
7955,269,226,43,223,46,0.8401486988847584,0.15985130111524162,0.828996282527881,0.17100371747211895,47,1,1,45,43,4,0.02127659574468085,0.02127659574468085,0.9574468085106383,0.9148936170212766,0.0851063829787234
7956,133,120,13,73,60,0.9022556390977443,0.09774436090225563,0.5488721804511278,0.45112781954887216,20,0,0,20,18,2,0.0,0.0,1.0,0.9,0.1
7957,1278,936,342,1124,154,0.7323943661971831,0.2676056338028169,0.8794992175273866,0.12050078247261346,636,66,183,387,533,103,0.10377358490566038,0.28773584905660377,0.6084905660377359,0.8380503144654088,0.1619496855345912
7958,1731,1113,618,859,872,0.6429809358752167,0.35701906412478335,0.49624494511842865,0.5037550548815714,187,1,28,158,185,2,0.0053475935828877,0.1497326203208556,0.8449197860962567,0.9893048128342246,0.0106951871657754
7959,52,4,48,49,3,0.07692307692307693,0.9230769230769231,0.9423076923076923,0.057692307692307696,714,0,0,714,714,0,0.0,0.0,1.0,1.0,0.0
7960,1802,1190,612,927,875,0.660377358490566,0.33962264150943394,0.5144284128745837,0.4855715871254162,208,0,22,186,208,0,0.0,0.10576923076923077,0.8942307692307693,1.0,0.0
7961,438,351,87,277,161,0.8013698630136986,0.19863013698630136,0.632420091324201,0.3675799086757991,89,11,21,57,84,5,0.12359550561797752,0.23595505617977527,0.6404494382022472,0.9438202247191011,0.056179775280898875
7962,1807,1196,611,855,952,0.6618705035971223,0.3381294964028777,0.47315993359158826,0.5268400664084117,235,0,23,212,232,3,0.0,0.09787234042553192,0.902127659574468,0.9872340425531915,0.01276595744680851
7963,52,6,46,48,4,0.11538461538461539,0.8846153846153846,0.9230769230769231,0.07692307692307693,643,0,0,643,643,0,0.0,0.0,1.0,1.0,0.0
7964,139,110,29,96,43,0.7913669064748201,0.20863309352517986,0.6906474820143885,0.30935251798561153,291,2,2,287,199,92,0.006872852233676976,0.006872852233676976,0.9862542955326461,0.6838487972508591,0.3161512027491409
7965,174,141,33,128,46,0.8103448275862069,0.1896551724137931,0.735632183908046,0.26436781609195403,170,1,1,168,127,43,0.0058823529411764705,0.0058823529411764705,0.9882352941176471,0.7470588235294118,0.2529411764705882
7966,166,133,33,130,36,0.8012048192771084,0.19879518072289157,0.7831325301204819,0.21686746987951808,17,0,0,17,13,4,0.0,0.0,1.0,0.7647058823529411,0.23529411764705882
7967,1780,1186,594,831,949,0.6662921348314607,0.33370786516853934,0.46685393258426966,0.5331460674157303,227,0,24,203,226,1,0.0,0.10572687224669604,0.8942731277533039,0.9955947136563876,0.004405286343612335
7968,146,119,27,106,40,0.815068493150685,0.18493150684931506,0.726027397260274,0.273972602739726,320,0,0,320,221,99,0.0,0.0,1.0,0.690625,0.309375
7969,84,66,18,44,40,0.7857142857142857,0.21428571428571427,0.5238095238095238,0.47619047619047616,10,0,0,10,8,2,0.0,0.0,1.0,0.8,0.2
7970,183,163,20,90,93,0.8907103825136612,0.1092896174863388,0.4918032786885246,0.5081967213114754,12,0,0,12,10,2,0.0,0.0,1.0,0.8333333333333334,0.16666666666666666
7971,130,115,15,83,47,0.8846153846153846,0.11538461538461539,0.6384615384615384,0.36153846153846153,218,2,1,215,151,67,0.009174311926605505,0.0045871559633027525,0.9862385321100917,0.6926605504587156,0.3073394495412844
7972,100,81,19,61,39,0.81,0.19,0.61,0.39,11,0,0,11,8,3,0.0,0.0,1.0,0.7272727272727273,0.2727272727272727
7973,61,14,47,50,11,0.22950819672131148,0.7704918032786885,0.819672131147541,0.18032786885245902,540,0,0,540,540,0,0.0,0.0,1.0,1.0,0.0
7974,201,163,38,149,52,0.8109452736318408,0.1890547263681592,0.7412935323383084,0.25870646766169153,50,2,0,48,45,5,0.04,0.0,0.96,0.9,0.1
7975,64,50,14,39,25,0.78125,0.21875,0.609375,0.390625,8,0,0,8,7,1,0.0,0.0,1.0,0.875,0.125
7976,597,473,124,398,199,0.7922948073701842,0.20770519262981574,0.6666666666666666,0.3333333333333333,45,0,0,45,42,3,0.0,0.0,1.0,0.9333333333333333,0.06666666666666667
7977,244,210,34,206,38,0.860655737704918,0.13934426229508196,0.8442622950819673,0.1557377049180328,21,1,2,18,17,4,0.047619047619047616,0.09523809523809523,0.8571428571428571,0.8095238095238095,0.19047619047619047
7978,184,106,78,158,26,0.5760869565217391,0.42391304347826086,0.8586956521739131,0.14130434782608695,139,0,43,96,139,0,0.0,0.30935251798561153,0.6906474820143885,1.0,0.0
7979,1703,1113,590,840,863,0.6535525543159131,0.3464474456840869,0.4932472108044627,0.5067527891955372,232,0,27,205,230,2,0.0,0.11637931034482758,0.8836206896551724,0.9913793103448276,0.008620689655172414
7980,164,136,28,117,47,0.8292682926829268,0.17073170731707318,0.7134146341463414,0.2865853658536585,289,1,1,287,193,96,0.0034602076124567475,0.0034602076124567475,0.9930795847750865,0.6678200692041523,0.33217993079584773
7981,203,120,83,177,26,0.5911330049261084,0.4088669950738916,0.8719211822660099,0.12807881773399016,148,1,42,105,147,1,0.006756756756756757,0.28378378378378377,0.7094594594594594,0.9932432432432432,0.006756756756756757
7982,139,123,16,112,27,0.8848920863309353,0.11510791366906475,0.8057553956834532,0.19424460431654678,122,1,85,36,121,1,0.00819672131147541,0.6967213114754098,0.29508196721311475,0.9918032786885246,0.00819672131147541
7983,82,64,18,55,27,0.7804878048780488,0.21951219512195122,0.6707317073170732,0.32926829268292684,9,0,0,9,7,2,0.0,0.0,1.0,0.7777777777777778,0.2222222222222222
7984,137,113,24,74,63,0.8248175182481752,0.17518248175182483,0.5401459854014599,0.45985401459854014,14,0,1,13,11,3,0.0,0.07142857142857142,0.9285714285714286,0.7857142857142857,0.21428571428571427
7985,139,123,16,112,27,0.8848920863309353,0.11510791366906475,0.8057553956834532,0.19424460431654678,122,1,85,36,121,1,0.00819672131147541,0.6967213114754098,0.29508196721311475,0.9918032786885246,0.00819672131147541
7986,338,277,61,267,71,0.8195266272189349,0.1804733727810651,0.7899408284023669,0.21005917159763313,278,10,168,100,265,13,0.03597122302158273,0.60431654676259,0.3597122302158273,0.9532374100719424,0.046762589928057555
7987,1871,1233,638,908,963,0.6590058792089791,0.34099412079102087,0.4853019775521112,0.5146980224478889,291,0,25,266,289,2,0.0,0.0859106529209622,0.9140893470790378,0.993127147766323,0.006872852233676976
7988,118,91,27,89,29,0.7711864406779662,0.2288135593220339,0.7542372881355932,0.2457627118644068,11,0,0,11,10,1,0.0,0.0,1.0,0.9090909090909091,0.09090909090909091
7989,1648,1070,578,785,863,0.6492718446601942,0.35072815533980584,0.47633495145631066,0.5236650485436893,264,0,38,226,262,2,0.0,0.14393939393939395,0.8560606060606061,0.9924242424242424,0.007575757575757576
7990,78,63,15,41,37,0.8076923076923077,0.19230769230769232,0.5256410256410257,0.47435897435897434,9,0,0,9,8,1,0.0,0.0,1.0,0.8888888888888888,0.1111111111111111
7991,140,124,16,113,27,0.8857142857142857,0.11428571428571428,0.8071428571428572,0.19285714285714287,122,1,85,36,121,1,0.00819672131147541,0.6967213114754098,0.29508196721311475,0.9918032786885246,0.00819672131147541
7992,1864,1243,621,938,926,0.6668454935622318,0.3331545064377682,0.5032188841201717,0.4967811158798283,191,0,27,164,190,1,0.0,0.14136125654450263,0.8586387434554974,0.9947643979057592,0.005235602094240838
7993,276,232,44,222,54,0.8405797101449275,0.15942028985507245,0.8043478260869565,0.1956521739130435,56,1,1,54,52,4,0.017857142857142856,0.017857142857142856,0.9642857142857143,0.9285714285714286,0.07142857142857142
7994,104,56,48,94,10,0.5384615384615384,0.46153846153846156,0.9038461538461539,0.09615384615384616,89,2,24,63,87,2,0.02247191011235955,0.2696629213483146,0.7078651685393258,0.9775280898876404,0.02247191011235955
7995,103,89,14,65,38,0.8640776699029126,0.13592233009708737,0.6310679611650486,0.36893203883495146,33,0,0,33,31,2,0.0,0.0,1.0,0.9393939393939394,0.06060606060606061
7996,67,53,14,40,27,0.7910447761194029,0.208955223880597,0.5970149253731343,0.40298507462686567,8,0,0,8,7,1,0.0,0.0,1.0,0.875,0.125
7997,1760,1137,623,872,888,0.6460227272727272,0.35397727272727275,0.4954545454545455,0.5045454545454545,236,0,32,204,232,4,0.0,0.13559322033898305,0.864406779661017,0.9830508474576272,0.01694915254237288
7998,136,114,22,73,63,0.8382352941176471,0.16176470588235295,0.5367647058823529,0.4632352941176471,12,1,0,11,11,1,0.08333333333333333,0.0,0.9166666666666666,0.9166666666666666,0.08333333333333333
7999,3987,3234,753,3181,806,0.8111361926260346,0.18886380737396538,0.7978429897165789,0.20215701028342112,67,1,36,30,67,0,0.014925373134328358,0.5373134328358209,0.44776119402985076,1.0,0.0
8000,3457,2792,665,2804,653,0.8076366792016199,0.1923633207983801,0.8111078970205381,0.18889210297946196,132,1,41,90,132,0,0.007575757575757576,0.3106060606060606,0.6818181818181818,1.0,0.0
8001,92,79,13,57,35,0.8586956521739131,0.14130434782608695,0.6195652173913043,0.3804347826086957,9,0,0,9,7,2,0.0,0.0,1.0,0.7777777777777778,0.2222222222222222
8002,1699,1121,578,845,854,0.6597998822836962,0.3402001177163037,0.4973513831665686,0.5026486168334314,234,0,21,213,233,1,0.0,0.08974358974358974,0.9102564102564102,0.9957264957264957,0.004273504273504274
8003,4228,3499,729,3388,840,0.8275780510879849,0.17242194891201515,0.8013245033112583,0.1986754966887417,112,1,82,29,112,0,0.008928571428571428,0.7321428571428571,0.25892857142857145,1.0,0.0
8004,187,109,78,161,26,0.5828877005347594,0.41711229946524064,0.8609625668449198,0.13903743315508021,141,0,43,98,141,0,0.0,0.3049645390070922,0.6950354609929078,1.0,0.0
8005,96,77,19,58,38,0.8020833333333334,0.19791666666666666,0.6041666666666666,0.3958333333333333,11,0,0,11,9,2,0.0,0.0,1.0,0.8181818181818182,0.18181818181818182
8006,3410,2752,658,2766,644,0.8070381231671554,0.19296187683284458,0.8111436950146628,0.18885630498533723,132,1,41,90,132,0,0.007575757575757576,0.3106060606060606,0.6818181818181818,1.0,0.0
8007,86,71,15,59,27,0.8255813953488372,0.1744186046511628,0.686046511627907,0.313953488372093,8,0,0,8,7,1,0.0,0.0,1.0,0.875,0.125
8008,137,112,25,86,51,0.8175182481751825,0.18248175182481752,0.6277372262773723,0.3722627737226277,9,0,0,9,8,1,0.0,0.0,1.0,0.8888888888888888,0.1111111111111111
8009,1712,1120,592,869,843,0.6542056074766355,0.34579439252336447,0.5075934579439252,0.49240654205607476,225,0,24,201,224,1,0.0,0.10666666666666667,0.8933333333333333,0.9955555555555555,0.0044444444444444444
8010,201,167,34,157,44,0.8308457711442786,0.1691542288557214,0.7810945273631841,0.21890547263681592,55,2,1,52,51,4,0.03636363636363636,0.01818181818181818,0.9454545454545454,0.9272727272727272,0.07272727272727272
8011,98,82,16,68,30,0.8367346938775511,0.16326530612244897,0.6938775510204082,0.30612244897959184,116,0,0,116,92,24,0.0,0.0,1.0,0.7931034482758621,0.20689655172413793
8012,168,138,30,121,47,0.8214285714285714,0.17857142857142858,0.7202380952380952,0.27976190476190477,106,0,0,106,79,27,0.0,0.0,1.0,0.7452830188679245,0.25471698113207547
8013,55,7,48,51,4,0.12727272727272726,0.8727272727272727,0.9272727272727272,0.07272727272727272,523,0,0,523,523,0,0.0,0.0,1.0,1.0,0.0
8014,86,70,16,48,38,0.813953488372093,0.18604651162790697,0.5581395348837209,0.4418604651162791,13,0,0,13,9,4,0.0,0.0,1.0,0.6923076923076923,0.3076923076923077
8015,506,299,207,386,120,0.5909090909090909,0.4090909090909091,0.7628458498023716,0.23715415019762845,341,9,71,261,333,8,0.026392961876832845,0.20821114369501467,0.7653958944281525,0.9765395894428153,0.02346041055718475
8016,265,204,61,195,70,0.769811320754717,0.23018867924528302,0.7358490566037735,0.2641509433962264,65,4,8,53,59,6,0.06153846153846154,0.12307692307692308,0.8153846153846154,0.9076923076923077,0.09230769230769231
8017,97,84,13,72,25,0.865979381443299,0.13402061855670103,0.7422680412371134,0.25773195876288657,9,0,0,9,8,1,0.0,0.0,1.0,0.8888888888888888,0.1111111111111111
8018,51,4,47,47,4,0.0784313725490196,0.9215686274509803,0.9215686274509803,0.0784313725490196,611,0,0,611,611,0,0.0,0.0,1.0,1.0,0.0
8019,3299,2658,641,2663,636,0.8056986965747196,0.19430130342528038,0.8072143073658684,0.19278569263413156,132,1,41,90,132,0,0.007575757575757576,0.3106060606060606,0.6818181818181818,1.0,0.0
8020,491,300,191,418,73,0.6109979633401222,0.3890020366598778,0.8513238289205702,0.14867617107942974,324,11,68,245,313,11,0.033950617283950615,0.20987654320987653,0.7561728395061729,0.9660493827160493,0.033950617283950615
8021,97,85,12,56,41,0.8762886597938144,0.12371134020618557,0.5773195876288659,0.422680412371134,13,0,0,13,10,3,0.0,0.0,1.0,0.7692307692307693,0.23076923076923078
8022,106,90,16,59,47,0.8490566037735849,0.1509433962264151,0.5566037735849056,0.44339622641509435,12,0,0,12,9,3,0.0,0.0,1.0,0.75,0.25
8023,184,106,78,158,26,0.5760869565217391,0.42391304347826086,0.8586956521739131,0.14130434782608695,139,0,43,96,139,0,0.0,0.30935251798561153,0.6906474820143885,1.0,0.0
8024,336,275,61,265,71,0.8184523809523809,0.18154761904761904,0.7886904761904762,0.2113095238095238,273,10,168,95,260,13,0.03663003663003663,0.6153846153846154,0.34798534798534797,0.9523809523809523,0.047619047619047616
8025,148,123,25,106,42,0.831081081081081,0.16891891891891891,0.7162162162162162,0.28378378378378377,296,1,3,292,195,101,0.0033783783783783786,0.010135135135135136,0.9864864864864865,0.6587837837837838,0.34121621621621623
8026,184,106,78,158,26,0.5760869565217391,0.42391304347826086,0.8586956521739131,0.14130434782608695,139,0,43,96,139,0,0.0,0.30935251798561153,0.6906474820143885,1.0,0.0
8027,1872,1256,616,938,934,0.6709401709401709,0.32905982905982906,0.5010683760683761,0.49893162393162394,228,0,14,214,225,3,0.0,0.06140350877192982,0.9385964912280702,0.9868421052631579,0.013157894736842105
8028,203,120,83,177,26,0.5911330049261084,0.4088669950738916,0.8719211822660099,0.12807881773399016,146,1,42,103,145,1,0.00684931506849315,0.2876712328767123,0.7054794520547946,0.9931506849315068,0.00684931506849315
8029,123,100,23,69,54,0.8130081300813008,0.18699186991869918,0.5609756097560976,0.43902439024390244,33,0,0,33,30,3,0.0,0.0,1.0,0.9090909090909091,0.09090909090909091
8030,141,118,23,85,56,0.8368794326241135,0.16312056737588654,0.6028368794326241,0.3971631205673759,10,0,0,10,8,2,0.0,0.0,1.0,0.8,0.2
8031,207,158,49,150,57,0.7632850241545893,0.23671497584541062,0.7246376811594203,0.2753623188405797,77,6,13,58,73,4,0.07792207792207792,0.16883116883116883,0.7532467532467533,0.948051948051948,0.05194805194805195
8032,265,218,47,214,51,0.8226415094339623,0.17735849056603772,0.8075471698113208,0.19245283018867926,37,0,1,36,33,4,0.0,0.02702702702702703,0.972972972972973,0.8918918918918919,0.10810810810810811
8033,1795,1197,598,923,872,0.6668523676880223,0.3331476323119777,0.5142061281337047,0.48579387186629525,237,0,35,202,234,3,0.0,0.14767932489451477,0.8523206751054853,0.9873417721518988,0.012658227848101266
8034,152,136,16,120,32,0.8947368421052632,0.10526315789473684,0.7894736842105263,0.21052631578947367,126,1,85,40,124,2,0.007936507936507936,0.6746031746031746,0.31746031746031744,0.9841269841269841,0.015873015873015872
8035,56,9,47,51,5,0.16071428571428573,0.8392857142857143,0.9107142857142857,0.08928571428571429,455,0,0,455,455,0,0.0,0.0,1.0,1.0,0.0
8036,187,109,78,161,26,0.5828877005347594,0.41711229946524064,0.8609625668449198,0.13903743315508021,140,0,43,97,140,0,0.0,0.30714285714285716,0.6928571428571428,1.0,0.0
8037,74,56,18,68,6,0.7567567567567568,0.24324324324324326,0.918918918918919,0.08108108108108109,11,0,0,11,11,0,0.0,0.0,1.0,1.0,0.0
8038,96,76,20,53,43,0.7916666666666666,0.20833333333333334,0.5520833333333334,0.4479166666666667,11,0,0,11,9,2,0.0,0.0,1.0,0.8181818181818182,0.18181818181818182
8039,293,242,51,234,59,0.825938566552901,0.17406143344709898,0.7986348122866894,0.20136518771331058,49,4,9,36,45,4,0.08163265306122448,0.1836734693877551,0.7346938775510204,0.9183673469387755,0.08163265306122448
8040,89,79,10,62,27,0.8876404494382022,0.11235955056179775,0.6966292134831461,0.30337078651685395,8,0,0,8,7,1,0.0,0.0,1.0,0.875,0.125
8041,128,110,18,81,47,0.859375,0.140625,0.6328125,0.3671875,36,0,0,36,32,4,0.0,0.0,1.0,0.8888888888888888,0.1111111111111111
8042,184,106,78,158,26,0.5760869565217391,0.42391304347826086,0.8586956521739131,0.14130434782608695,139,0,43,96,139,0,0.0,0.30935251798561153,0.6906474820143885,1.0,0.0
8043,1758,1144,614,903,855,0.6507394766780432,0.3492605233219568,0.5136518771331058,0.4863481228668942,231,0,23,208,230,1,0.0,0.09956709956709957,0.9004329004329005,0.9956709956709957,0.004329004329004329
8044,184,106,78,158,26,0.5760869565217391,0.42391304347826086,0.8586956521739131,0.14130434782608695,139,0,43,96,139,0,0.0,0.30935251798561153,0.6906474820143885,1.0,0.0
8045,841,405,436,381,460,0.4815695600475624,0.5184304399524375,0.4530321046373365,0.5469678953626635,174,2,19,153,172,2,0.011494252873563218,0.10919540229885058,0.8793103448275862,0.9885057471264368,0.011494252873563218
8046,120,101,19,69,51,0.8416666666666667,0.15833333333333333,0.575,0.425,11,0,0,11,10,1,0.0,0.0,1.0,0.9090909090909091,0.09090909090909091
8047,1862,1201,661,923,939,0.6450053705692803,0.35499462943071963,0.495703544575725,0.5042964554242749,240,0,38,202,238,2,0.0,0.15833333333333333,0.8416666666666667,0.9916666666666667,0.008333333333333333
8048,52,5,47,48,4,0.09615384615384616,0.9038461538461539,0.9230769230769231,0.07692307692307693,443,0,0,443,443,0,0.0,0.0,1.0,1.0,0.0
8049,1697,1104,593,858,839,0.6505598114319388,0.3494401885680613,0.5055981143193872,0.49440188568061283,238,0,27,211,238,0,0.0,0.1134453781512605,0.8865546218487395,1.0,0.0
8050,151,131,20,90,61,0.8675496688741722,0.13245033112582782,0.5960264900662252,0.40397350993377484,12,0,0,12,9,3,0.0,0.0,1.0,0.75,0.25
8051,78,67,11,45,33,0.8589743589743589,0.14102564102564102,0.5769230769230769,0.4230769230769231,12,0,0,12,10,2,0.0,0.0,1.0,0.8333333333333334,0.16666666666666666
8052,4228,3499,729,3388,840,0.8275780510879849,0.17242194891201515,0.8013245033112583,0.1986754966887417,112,1,82,29,112,0,0.008928571428571428,0.7321428571428571,0.25892857142857145,1.0,0.0
8053,134,108,26,106,28,0.8059701492537313,0.19402985074626866,0.7910447761194029,0.208955223880597,17,0,0,17,13,4,0.0,0.0,1.0,0.7647058823529411,0.23529411764705882
8054,54,6,48,49,5,0.1111111111111111,0.8888888888888888,0.9074074074074074,0.09259259259259259,549,0,0,549,549,0,0.0,0.0,1.0,1.0,0.0
8055,474,289,185,401,73,0.609704641350211,0.39029535864978904,0.8459915611814346,0.1540084388185654,284,11,65,208,273,11,0.03873239436619718,0.22887323943661972,0.7323943661971831,0.9612676056338029,0.03873239436619718
8056,184,106,78,158,26,0.5760869565217391,0.42391304347826086,0.8586956521739131,0.14130434782608695,139,0,43,96,139,0,0.0,0.30935251798561153,0.6906474820143885,1.0,0.0
8057,1726,1116,610,826,900,0.6465816917728853,0.35341830822711473,0.47856315179606024,0.5214368482039398,220,0,25,195,218,2,0.0,0.11363636363636363,0.8863636363636364,0.990909090909091,0.00909090909090909
8058,117,101,16,67,50,0.8632478632478633,0.13675213675213677,0.5726495726495726,0.42735042735042733,12,0,0,12,10,2,0.0,0.0,1.0,0.8333333333333334,0.16666666666666666
8059,1089,577,512,470,619,0.5298438934802571,0.4701561065197429,0.4315886134067952,0.5684113865932048,412,2,47,363,407,5,0.0048543689320388345,0.11407766990291263,0.8810679611650486,0.9878640776699029,0.012135922330097087
8060,104,87,17,64,40,0.8365384615384616,0.16346153846153846,0.6153846153846154,0.38461538461538464,9,0,0,9,8,1,0.0,0.0,1.0,0.8888888888888888,0.1111111111111111
8061,621,494,127,408,213,0.7954911433172303,0.20450885668276972,0.6570048309178744,0.34299516908212563,44,0,0,44,40,4,0.0,0.0,1.0,0.9090909090909091,0.09090909090909091
8062,88,72,16,52,36,0.8181818181818182,0.18181818181818182,0.5909090909090909,0.4090909090909091,8,0,0,8,7,1,0.0,0.0,1.0,0.875,0.125
8063,182,149,33,145,37,0.8186813186813187,0.1813186813186813,0.7967032967032966,0.2032967032967033,20,0,1,19,16,4,0.0,0.05,0.95,0.8,0.2
8064,64,58,6,27,37,0.90625,0.09375,0.421875,0.578125,27,0,0,27,24,3,0.0,0.0,1.0,0.8888888888888888,0.1111111111111111
8065,123,103,20,73,50,0.8373983739837398,0.16260162601626016,0.5934959349593496,0.4065040650406504,16,0,0,16,14,2,0.0,0.0,1.0,0.875,0.125
8066,103,87,16,60,43,0.8446601941747572,0.1553398058252427,0.5825242718446602,0.4174757281553398,263,0,1,262,180,83,0.0,0.0038022813688212928,0.9961977186311787,0.6844106463878327,0.3155893536121673
8067,1978,1312,666,1022,956,0.6632962588473206,0.3367037411526795,0.5166835187057633,0.4833164812942366,274,0,23,251,270,4,0.0,0.08394160583941605,0.916058394160584,0.9854014598540146,0.014598540145985401
8068,51,4,47,48,3,0.0784313725490196,0.9215686274509803,0.9411764705882353,0.058823529411764705,546,0,0,546,546,0,0.0,0.0,1.0,1.0,0.0
8069,143,117,26,97,46,0.8181818181818182,0.18181818181818182,0.6783216783216783,0.32167832167832167,331,0,3,328,230,101,0.0,0.00906344410876133,0.9909365558912386,0.6948640483383686,0.30513595166163143
8070,291,240,51,238,53,0.8247422680412371,0.17525773195876287,0.8178694158075601,0.18213058419243985,18,0,0,18,13,5,0.0,0.0,1.0,0.7222222222222222,0.2777777777777778
8071,108,92,16,69,39,0.8518518518518519,0.14814814814814814,0.6388888888888888,0.3611111111111111,11,0,0,11,9,2,0.0,0.0,1.0,0.8181818181818182,0.18181818181818182
8072,207,123,84,180,27,0.5942028985507246,0.4057971014492754,0.8695652173913043,0.13043478260869565,145,1,44,100,144,1,0.006896551724137931,0.30344827586206896,0.6896551724137931,0.993103448275862,0.006896551724137931
8073,134,119,15,108,26,0.8880597014925373,0.11194029850746269,0.8059701492537313,0.19402985074626866,124,1,83,40,123,1,0.008064516129032258,0.6693548387096774,0.3225806451612903,0.9919354838709677,0.008064516129032258
8074,125,99,26,83,42,0.792,0.208,0.664,0.336,321,0,3,318,219,102,0.0,0.009345794392523364,0.9906542056074766,0.6822429906542056,0.3177570093457944
8075,302,242,60,231,71,0.8013245033112583,0.1986754966887417,0.7649006622516556,0.23509933774834438,54,4,8,42,47,7,0.07407407407407407,0.14814814814814814,0.7777777777777778,0.8703703703703703,0.12962962962962962
8076,61,50,11,41,20,0.819672131147541,0.18032786885245902,0.6721311475409836,0.32786885245901637,9,0,0,9,7,2,0.0,0.0,1.0,0.7777777777777778,0.2222222222222222
8077,203,120,83,177,26,0.5911330049261084,0.4088669950738916,0.8719211822660099,0.12807881773399016,148,1,42,105,147,1,0.006756756756756757,0.28378378378378377,0.7094594594594594,0.9932432432432432,0.006756756756756757
8078,127,109,18,75,52,0.8582677165354331,0.14173228346456693,0.5905511811023622,0.4094488188976378,8,0,0,8,7,1,0.0,0.0,1.0,0.875,0.125
8079,130,111,19,78,52,0.8538461538461538,0.14615384615384616,0.6,0.4,16,0,0,16,10,6,0.0,0.0,1.0,0.625,0.375
8080,863,419,444,398,465,0.4855156431054461,0.5144843568945539,0.46118192352259557,0.5388180764774044,339,2,35,302,336,3,0.0058997050147492625,0.10324483775811209,0.8908554572271387,0.9911504424778761,0.008849557522123894
8081,3460,2795,665,2807,653,0.8078034682080925,0.19219653179190752,0.8112716763005781,0.18872832369942197,132,1,41,90,132,0,0.007575757575757576,0.3106060606060606,0.6818181818181818,1.0,0.0
8082,474,289,185,401,73,0.609704641350211,0.39029535864978904,0.8459915611814346,0.1540084388185654,284,11,65,208,273,11,0.03873239436619718,0.22887323943661972,0.7323943661971831,0.9612676056338029,0.03873239436619718
8083,177,143,34,130,47,0.807909604519774,0.192090395480226,0.7344632768361582,0.2655367231638418,74,0,0,74,68,6,0.0,0.0,1.0,0.918918918918919,0.08108108108108109
8084,207,123,84,180,27,0.5942028985507246,0.4057971014492754,0.8695652173913043,0.13043478260869565,145,1,44,100,144,1,0.006896551724137931,0.30344827586206896,0.6896551724137931,0.993103448275862,0.006896551724137931
8085,135,115,20,80,55,0.8518518518518519,0.14814814814814814,0.5925925925925926,0.4074074074074074,10,0,0,10,8,2,0.0,0.0,1.0,0.8,0.2
8086,121,99,22,78,43,0.8181818181818182,0.18181818181818182,0.6446280991735537,0.35537190082644626,262,4,1,257,169,93,0.015267175572519083,0.003816793893129771,0.9809160305343512,0.6450381679389313,0.3549618320610687
8087,1793,1190,603,938,855,0.6636921360847742,0.3363078639152259,0.5231455660903513,0.47685443390964866,195,0,22,173,195,0,0.0,0.11282051282051282,0.8871794871794871,1.0,0.0
8088,53,5,48,50,3,0.09433962264150944,0.9056603773584906,0.9433962264150944,0.05660377358490566,496,0,0,496,496,0,0.0,0.0,1.0,1.0,0.0
8089,151,129,22,101,50,0.8543046357615894,0.1456953642384106,0.6688741721854304,0.33112582781456956,303,0,2,301,210,93,0.0,0.006600660066006601,0.9933993399339934,0.693069306930693,0.3069306930693069
8090,442,354,88,292,150,0.8009049773755657,0.19909502262443438,0.6606334841628959,0.3393665158371041,87,11,21,55,81,6,0.12643678160919541,0.2413793103448276,0.632183908045977,0.9310344827586207,0.06896551724137931
8091,347,243,104,249,98,0.7002881844380403,0.29971181556195964,0.7175792507204611,0.2824207492795389,68,4,8,56,62,6,0.058823529411764705,0.11764705882352941,0.8235294117647058,0.9117647058823529,0.08823529411764706
8092,241,216,25,212,29,0.8962655601659751,0.1037344398340249,0.8796680497925311,0.12033195020746888,37,0,1,36,33,4,0.0,0.02702702702702703,0.972972972972973,0.8918918918918919,0.10810810810810811
8093,47,46,1,24,23,0.9787234042553191,0.02127659574468085,0.5106382978723404,0.48936170212765956,27,0,0,27,25,2,0.0,0.0,1.0,0.9259259259259259,0.07407407407407407
8094,1915,1296,619,951,964,0.6767624020887728,0.32323759791122714,0.4966057441253264,0.5033942558746737,229,0,26,203,228,1,0.0,0.11353711790393013,0.8864628820960698,0.9956331877729258,0.004366812227074236
8095,203,120,83,177,26,0.5911330049261084,0.4088669950738916,0.8719211822660099,0.12807881773399016,146,1,42,103,145,1,0.00684931506849315,0.2876712328767123,0.7054794520547946,0.9931506849315068,0.00684931506849315
8096,3410,2752,658,2766,644,0.8070381231671554,0.19296187683284458,0.8111436950146628,0.18885630498533723,132,1,41,90,132,0,0.007575757575757576,0.3106060606060606,0.6818181818181818,1.0,0.0
8097,187,109,78,161,26,0.5828877005347594,0.41711229946524064,0.8609625668449198,0.13903743315508021,84,0,43,41,84,0,0.0,0.5119047619047619,0.4880952380952381,1.0,0.0
8098,967,511,456,472,495,0.5284384694932782,0.47156153050672184,0.48810754912099275,0.5118924508790073,235,2,30,203,231,4,0.00851063829787234,0.1276595744680851,0.8638297872340426,0.9829787234042553,0.01702127659574468
8099,128,107,21,73,55,0.8359375,0.1640625,0.5703125,0.4296875,10,0,0,10,8,2,0.0,0.0,1.0,0.8,0.2
8100,51,4,47,48,3,0.0784313725490196,0.9215686274509803,0.9411764705882353,0.058823529411764705,534,0,0,534,534,0,0.0,0.0,1.0,1.0,0.0
8101,265,223,42,213,52,0.8415094339622642,0.15849056603773584,0.8037735849056604,0.19622641509433963,66,2,1,63,61,5,0.030303030303030304,0.015151515151515152,0.9545454545454546,0.9242424242424242,0.07575757575757576
8102,139,123,16,112,27,0.8848920863309353,0.11510791366906475,0.8057553956834532,0.19424460431654678,122,1,85,36,121,1,0.00819672131147541,0.6967213114754098,0.29508196721311475,0.9918032786885246,0.00819672131147541
8103,152,130,22,125,27,0.8552631578947368,0.14473684210526316,0.8223684210526315,0.17763157894736842,26,0,0,26,22,4,0.0,0.0,1.0,0.8461538461538461,0.15384615384615385
8104,53,6,47,49,4,0.11320754716981132,0.8867924528301887,0.9245283018867925,0.07547169811320754,543,0,0,543,543,0,0.0,0.0,1.0,1.0,0.0
8105,180,164,16,100,80,0.9111111111111111,0.08888888888888889,0.5555555555555556,0.4444444444444444,13,0,0,13,12,1,0.0,0.0,1.0,0.9230769230769231,0.07692307692307693
8106,279,234,45,231,48,0.8387096774193549,0.16129032258064516,0.8279569892473119,0.17204301075268819,17,0,0,17,13,4,0.0,0.0,1.0,0.7647058823529411,0.23529411764705882
8107,97,84,13,61,36,0.865979381443299,0.13402061855670103,0.6288659793814433,0.3711340206185567,12,0,0,12,10,2,0.0,0.0,1.0,0.8333333333333334,0.16666666666666666
8108,4108,3331,777,3285,823,0.810856864654333,0.18914313534566699,0.7996592015579357,0.20034079844206426,75,1,42,32,75,0,0.013333333333333334,0.56,0.4266666666666667,1.0,0.0
8109,150,135,15,122,28,0.9,0.1,0.8133333333333334,0.18666666666666668,141,0,82,59,141,0,0.0,0.5815602836879432,0.41843971631205673,1.0,0.0
8110,57,9,48,50,7,0.15789473684210525,0.8421052631578947,0.8771929824561403,0.12280701754385964,431,0,0,431,431,0,0.0,0.0,1.0,1.0,0.0
8111,187,109,78,161,26,0.5828877005347594,0.41711229946524064,0.8609625668449198,0.13903743315508021,84,0,43,41,84,0,0.0,0.5119047619047619,0.4880952380952381,1.0,0.0
8112,106,94,12,80,26,0.8867924528301887,0.11320754716981132,0.7547169811320755,0.24528301886792453,100,0,69,31,100,0,0.0,0.69,0.31,1.0,0.0
8113,99,83,16,63,36,0.8383838383838383,0.16161616161616163,0.6363636363636364,0.36363636363636365,14,0,0,14,11,3,0.0,0.0,1.0,0.7857142857142857,0.21428571428571427
8114,104,56,48,94,10,0.5384615384615384,0.46153846153846156,0.9038461538461539,0.09615384615384616,89,2,24,63,87,2,0.02247191011235955,0.2696629213483146,0.7078651685393258,0.9775280898876404,0.02247191011235955
8115,177,144,33,142,35,0.8135593220338984,0.1864406779661017,0.8022598870056498,0.1977401129943503,19,0,0,19,15,4,0.0,0.0,1.0,0.7894736842105263,0.21052631578947367
8116,118,101,17,69,49,0.8559322033898306,0.1440677966101695,0.5847457627118644,0.4152542372881356,24,0,0,24,22,2,0.0,0.0,1.0,0.9166666666666666,0.08333333333333333
8117,1737,1165,572,864,873,0.6706966033390904,0.32930339666090963,0.49740932642487046,0.5025906735751295,225,0,21,204,224,1,0.0,0.09333333333333334,0.9066666666666666,0.9955555555555555,0.0044444444444444444
8118,878,634,244,635,243,0.7220956719817767,0.27790432801822323,0.7232346241457859,0.2767653758542141,664,0,117,547,288,376,0.0,0.17620481927710843,0.8237951807228916,0.43373493975903615,0.5662650602409639
8119,221,178,43,175,46,0.8054298642533937,0.19457013574660634,0.7918552036199095,0.2081447963800905,54,1,2,51,50,4,0.018518518518518517,0.037037037037037035,0.9444444444444444,0.9259259259259259,0.07407407407407407
8120,130,112,18,75,55,0.8615384615384616,0.13846153846153847,0.5769230769230769,0.4230769230769231,24,0,0,24,21,3,0.0,0.0,1.0,0.875,0.125
8121,97,84,13,63,34,0.865979381443299,0.13402061855670103,0.6494845360824743,0.35051546391752575,9,0,0,9,7,2,0.0,0.0,1.0,0.7777777777777778,0.2222222222222222
8122,1792,1171,621,900,892,0.6534598214285714,0.34654017857142855,0.5022321428571429,0.49776785714285715,219,0,33,186,217,2,0.0,0.1506849315068493,0.8493150684931506,0.9908675799086758,0.0091324200913242
8123,4070,3298,772,3255,815,0.8103194103194103,0.18968058968058968,0.7997542997542998,0.20024570024570024,75,1,42,32,70,5,0.013333333333333334,0.56,0.4266666666666667,0.9333333333333333,0.06666666666666667
8124,229,192,37,190,39,0.8384279475982532,0.1615720524017467,0.8296943231441049,0.1703056768558952,20,0,0,20,16,4,0.0,0.0,1.0,0.8,0.2
8125,129,110,19,86,43,0.8527131782945736,0.14728682170542637,0.6666666666666666,0.3333333333333333,251,0,0,251,180,71,0.0,0.0,1.0,0.7171314741035857,0.28286852589641437
8126,127,108,19,87,40,0.8503937007874016,0.14960629921259844,0.6850393700787402,0.31496062992125984,9,0,0,9,8,1,0.0,0.0,1.0,0.8888888888888888,0.1111111111111111
8127,53,5,48,49,4,0.09433962264150944,0.9056603773584906,0.9245283018867925,0.07547169811320754,644,0,0,644,644,0,0.0,0.0,1.0,1.0,0.0
8128,1790,1184,606,870,920,0.6614525139664804,0.33854748603351953,0.4860335195530726,0.5139664804469274,256,0,30,226,256,0,0.0,0.1171875,0.8828125,1.0,0.0
8129,633,497,136,428,205,0.7851500789889415,0.21484992101105846,0.6761453396524486,0.32385466034755134,45,0,0,45,42,3,0.0,0.0,1.0,0.9333333333333333,0.06666666666666667
8130,897,435,462,396,501,0.48494983277591974,0.5150501672240803,0.4414715719063545,0.5585284280936454,259,2,35,222,255,4,0.007722007722007722,0.13513513513513514,0.8571428571428571,0.9845559845559846,0.015444015444015444
8131,279,225,54,215,64,0.8064516129032258,0.1935483870967742,0.7706093189964157,0.22939068100358423,58,4,8,46,53,5,0.06896551724137931,0.13793103448275862,0.7931034482758621,0.9137931034482759,0.08620689655172414
8132,97,83,14,60,37,0.8556701030927835,0.14432989690721648,0.6185567010309279,0.38144329896907214,12,0,0,12,10,2,0.0,0.0,1.0,0.8333333333333334,0.16666666666666666
8133,3299,2658,641,2663,636,0.8056986965747196,0.19430130342528038,0.8072143073658684,0.19278569263413156,75,1,41,33,75,0,0.013333333333333334,0.5466666666666666,0.44,1.0,0.0
8134,111,96,15,70,41,0.8648648648648649,0.13513513513513514,0.6306306306306306,0.36936936936936937,17,0,0,17,14,3,0.0,0.0,1.0,0.8235294117647058,0.17647058823529413
8135,1701,1112,589,862,839,0.6537330981775427,0.3462669018224574,0.5067607289829512,0.4932392710170488,222,0,26,196,222,0,0.0,0.11711711711711711,0.8828828828828829,1.0,0.0
8136,257,213,44,211,46,0.8287937743190662,0.17120622568093385,0.8210116731517509,0.17898832684824903,17,0,1,16,13,4,0.0,0.058823529411764705,0.9411764705882353,0.7647058823529411,0.23529411764705882
8137,146,119,27,115,31,0.815068493150685,0.18493150684931506,0.7876712328767124,0.21232876712328766,19,0,1,18,13,6,0.0,0.05263157894736842,0.9473684210526315,0.6842105263157895,0.3157894736842105
8138,1705,1116,589,820,885,0.6545454545454545,0.34545454545454546,0.4809384164222874,0.5190615835777126,209,0,25,184,209,0,0.0,0.11961722488038277,0.8803827751196173,1.0,0.0
8139,138,109,29,107,31,0.7898550724637681,0.21014492753623187,0.7753623188405797,0.2246376811594203,11,0,0,11,10,1,0.0,0.0,1.0,0.9090909090909091,0.09090909090909091
8140,102,90,12,46,56,0.8823529411764706,0.11764705882352941,0.45098039215686275,0.5490196078431373,13,0,0,13,11,2,0.0,0.0,1.0,0.8461538461538461,0.15384615384615385
8141,142,113,29,109,33,0.795774647887324,0.20422535211267606,0.7676056338028169,0.2323943661971831,18,0,0,18,14,4,0.0,0.0,1.0,0.7777777777777778,0.2222222222222222
8142,103,89,14,60,43,0.8640776699029126,0.13592233009708737,0.5825242718446602,0.4174757281553398,10,0,0,10,9,1,0.0,0.0,1.0,0.9,0.1
8143,1730,1126,604,865,865,0.6508670520231213,0.3491329479768786,0.5,0.5,231,0,34,197,229,2,0.0,0.1471861471861472,0.8528138528138528,0.9913419913419913,0.008658008658008658
8144,127,107,20,84,43,0.84251968503937,0.15748031496062992,0.6614173228346457,0.33858267716535434,15,0,0,15,11,4,0.0,0.0,1.0,0.7333333333333333,0.26666666666666666
8145,796,379,417,371,425,0.47613065326633164,0.5238693467336684,0.46608040201005024,0.5339195979899497,336,2,34,300,334,2,0.005952380952380952,0.10119047619047619,0.8928571428571429,0.9940476190476191,0.005952380952380952
8146,184,106,78,158,26,0.5760869565217391,0.42391304347826086,0.8586956521739131,0.14130434782608695,139,0,43,96,139,0,0.0,0.30935251798561153,0.6906474820143885,1.0,0.0
8147,66,20,46,56,10,0.30303030303030304,0.696969696969697,0.8484848484848485,0.15151515151515152,536,0,0,536,536,0,0.0,0.0,1.0,1.0,0.0
8148,145,131,14,81,64,0.903448275862069,0.09655172413793103,0.5586206896551724,0.4413793103448276,11,0,0,11,9,2,0.0,0.0,1.0,0.8181818181818182,0.18181818181818182
8149,123,104,19,71,52,0.8455284552845529,0.15447154471544716,0.5772357723577236,0.42276422764227645,14,0,0,14,12,2,0.0,0.0,1.0,0.8571428571428571,0.14285714285714285
8150,139,123,16,112,27,0.8848920863309353,0.11510791366906475,0.8057553956834532,0.19424460431654678,122,1,86,35,121,1,0.00819672131147541,0.7049180327868853,0.28688524590163933,0.9918032786885246,0.00819672131147541
8151,1796,1171,625,871,925,0.6520044543429844,0.34799554565701557,0.4849665924276169,0.515033407572383,287,0,24,263,286,1,0.0,0.08362369337979095,0.9163763066202091,0.9965156794425087,0.003484320557491289
8152,134,118,16,83,51,0.8805970149253731,0.11940298507462686,0.6194029850746269,0.3805970149253731,11,0,0,11,9,2,0.0,0.0,1.0,0.8181818181818182,0.18181818181818182
8153,58,11,47,54,4,0.1896551724137931,0.8103448275862069,0.9310344827586207,0.06896551724137931,578,0,0,578,578,0,0.0,0.0,1.0,1.0,0.0
8154,187,109,78,161,26,0.5828877005347594,0.41711229946524064,0.8609625668449198,0.13903743315508021,140,0,43,97,140,0,0.0,0.30714285714285716,0.6928571428571428,1.0,0.0
8155,89,78,11,52,37,0.8764044943820225,0.12359550561797752,0.5842696629213483,0.4157303370786517,15,0,0,15,13,2,0.0,0.0,1.0,0.8666666666666667,0.13333333333333333
8156,127,107,20,83,44,0.84251968503937,0.15748031496062992,0.6535433070866141,0.3464566929133858,12,0,0,12,8,4,0.0,0.0,1.0,0.6666666666666666,0.3333333333333333
8157,89,75,14,64,25,0.8426966292134831,0.15730337078651685,0.7191011235955056,0.2808988764044944,9,0,0,9,7,2,0.0,0.0,1.0,0.7777777777777778,0.2222222222222222
8158,123,104,19,65,58,0.8455284552845529,0.15447154471544716,0.5284552845528455,0.4715447154471545,15,0,0,15,12,3,0.0,0.0,1.0,0.8,0.2
8159,94,74,20,43,51,0.7872340425531915,0.2127659574468085,0.4574468085106383,0.5425531914893617,23,0,0,23,21,2,0.0,0.0,1.0,0.9130434782608695,0.08695652173913043
8160,1760,1170,590,873,887,0.6647727272727273,0.3352272727272727,0.4960227272727273,0.5039772727272728,242,0,19,223,242,0,0.0,0.07851239669421488,0.9214876033057852,1.0,0.0
8161,106,93,13,71,35,0.8773584905660378,0.12264150943396226,0.6698113207547169,0.330188679245283,11,0,0,11,9,2,0.0,0.0,1.0,0.8181818181818182,0.18181818181818182
8162,64,49,15,33,31,0.765625,0.234375,0.515625,0.484375,13,0,0,13,9,4,0.0,0.0,1.0,0.6923076923076923,0.3076923076923077
8163,159,141,18,100,59,0.8867924528301887,0.11320754716981132,0.6289308176100629,0.3710691823899371,11,0,0,11,9,2,0.0,0.0,1.0,0.8181818181818182,0.18181818181818182
8164,187,109,78,161,26,0.5828877005347594,0.41711229946524064,0.8609625668449198,0.13903743315508021,84,0,43,41,84,0,0.0,0.5119047619047619,0.4880952380952381,1.0,0.0
8165,1711,1103,608,858,853,0.6446522501461134,0.3553477498538866,0.5014611338398597,0.49853886616014026,292,0,21,271,285,7,0.0,0.07191780821917808,0.928082191780822,0.976027397260274,0.023972602739726026
8166,157,139,18,86,71,0.8853503184713376,0.11464968152866242,0.5477707006369427,0.45222929936305734,13,0,0,13,12,1,0.0,0.0,1.0,0.9230769230769231,0.07692307692307693
8167,874,410,464,395,479,0.4691075514874142,0.5308924485125858,0.45194508009153317,0.5480549199084668,55,2,6,47,53,2,0.03636363636363636,0.10909090909090909,0.8545454545454545,0.9636363636363636,0.03636363636363636
8168,1290,942,348,1116,174,0.7302325581395349,0.26976744186046514,0.8651162790697674,0.13488372093023257,635,68,183,384,537,98,0.10708661417322834,0.28818897637795277,0.6047244094488189,0.8456692913385827,0.15433070866141732
8169,126,108,18,59,67,0.8571428571428571,0.14285714285714285,0.46825396825396826,0.5317460317460317,11,0,0,11,10,1,0.0,0.0,1.0,0.9090909090909091,0.09090909090909091
8170,97,82,15,57,40,0.845360824742268,0.15463917525773196,0.5876288659793815,0.41237113402061853,11,0,0,11,7,4,0.0,0.0,1.0,0.6363636363636364,0.36363636363636365
8171,48,46,2,24,24,0.9583333333333334,0.041666666666666664,0.5,0.5,26,0,0,26,24,2,0.0,0.0,1.0,0.9230769230769231,0.07692307692307693
8172,90,74,16,53,37,0.8222222222222222,0.17777777777777778,0.5888888888888889,0.4111111111111111,12,0,0,12,9,3,0.0,0.0,1.0,0.75,0.25
8173,184,106,78,158,26,0.5760869565217391,0.42391304347826086,0.8586956521739131,0.14130434782608695,139,0,43,96,139,0,0.0,0.30935251798561153,0.6906474820143885,1.0,0.0
8174,71,58,13,47,24,0.8169014084507042,0.18309859154929578,0.6619718309859155,0.3380281690140845,8,0,0,8,7,1,0.0,0.0,1.0,0.875,0.125
8175,152,136,16,120,32,0.8947368421052632,0.10526315789473684,0.7894736842105263,0.21052631578947367,126,1,85,40,124,2,0.007936507936507936,0.6746031746031746,0.31746031746031744,0.9841269841269841,0.015873015873015872
8176,3310,2652,658,2669,641,0.8012084592145015,0.1987915407854985,0.806344410876133,0.19365558912386707,132,1,41,90,132,0,0.007575757575757576,0.3106060606060606,0.6818181818181818,1.0,0.0
8177,4046,3282,764,3231,815,0.8111715274345032,0.18882847256549679,0.7985664854176965,0.20143351458230352,75,1,42,32,70,5,0.013333333333333334,0.56,0.4266666666666667,0.9333333333333333,0.06666666666666667
8178,228,208,20,144,84,0.9122807017543859,0.08771929824561403,0.631578947368421,0.3684210526315789,8,0,0,8,7,1,0.0,0.0,1.0,0.875,0.125
8179,3410,2752,658,2766,644,0.8070381231671554,0.19296187683284458,0.8111436950146628,0.18885630498533723,132,1,41,90,132,0,0.007575757575757576,0.3106060606060606,0.6818181818181818,1.0,0.0
8180,1774,1155,619,880,894,0.6510710259301015,0.34892897406989853,0.496054114994363,0.503945885005637,233,0,23,210,230,3,0.0,0.09871244635193133,0.9012875536480687,0.9871244635193133,0.012875536480686695
8181,595,472,123,386,209,0.7932773109243697,0.20672268907563024,0.6487394957983194,0.35126050420168065,47,0,0,47,40,7,0.0,0.0,1.0,0.851063829787234,0.14893617021276595
8182,150,135,15,122,28,0.9,0.1,0.8133333333333334,0.18666666666666668,141,0,82,59,141,0,0.0,0.5815602836879432,0.41843971631205673,1.0,0.0
8183,173,136,37,127,46,0.7861271676300579,0.2138728323699422,0.7341040462427746,0.2658959537572254,78,1,0,77,56,22,0.01282051282051282,0.0,0.9871794871794872,0.717948717948718,0.28205128205128205
8184,4070,3298,772,3255,815,0.8103194103194103,0.18968058968058968,0.7997542997542998,0.20024570024570024,75,1,42,32,75,0,0.013333333333333334,0.56,0.4266666666666667,1.0,0.0
8185,255,213,42,206,49,0.8352941176470589,0.16470588235294117,0.807843137254902,0.19215686274509805,42,1,2,39,37,5,0.023809523809523808,0.047619047619047616,0.9285714285714286,0.8809523809523809,0.11904761904761904
8186,282,232,50,226,56,0.8226950354609929,0.1773049645390071,0.8014184397163121,0.19858156028368795,19,0,0,19,15,4,0.0,0.0,1.0,0.7894736842105263,0.21052631578947367
8187,183,155,28,137,46,0.8469945355191257,0.15300546448087432,0.7486338797814208,0.25136612021857924,133,0,0,133,94,39,0.0,0.0,1.0,0.706766917293233,0.2932330827067669
8188,1786,1186,600,857,929,0.6640537513997761,0.335946248600224,0.4798432250839866,0.5201567749160134,233,0,27,206,233,0,0.0,0.11587982832618025,0.8841201716738197,1.0,0.0
8189,114,99,15,68,46,0.868421052631579,0.13157894736842105,0.5964912280701754,0.40350877192982454,10,0,0,10,7,3,0.0,0.0,1.0,0.7,0.3
8190,125,104,21,63,62,0.832,0.168,0.504,0.496,12,0,0,12,11,1,0.0,0.0,1.0,0.9166666666666666,0.08333333333333333
8191,72,61,11,49,23,0.8472222222222222,0.1527777777777778,0.6805555555555556,0.3194444444444444,9,0,0,9,8,1,0.0,0.0,1.0,0.8888888888888888,0.1111111111111111
8192,50,4,46,47,3,0.08,0.92,0.94,0.06,527,0,0,527,527,0,0.0,0.0,1.0,1.0,0.0
8193,184,106,78,158,26,0.5760869565217391,0.42391304347826086,0.8586956521739131,0.14130434782608695,139,0,43,96,139,0,0.0,0.30935251798561153,0.6906474820143885,1.0,0.0
8194,3410,2752,658,2766,644,0.8070381231671554,0.19296187683284458,0.8111436950146628,0.18885630498533723,132,1,41,90,132,0,0.007575757575757576,0.3106060606060606,0.6818181818181818,1.0,0.0
8195,147,129,18,90,57,0.8775510204081632,0.12244897959183673,0.6122448979591837,0.3877551020408163,13,0,0,13,12,1,0.0,0.0,1.0,0.9230769230769231,0.07692307692307693
8196,203,120,83,177,26,0.5911330049261084,0.4088669950738916,0.8719211822660099,0.12807881773399016,146,1,42,103,145,1,0.00684931506849315,0.2876712328767123,0.7054794520547946,0.9931506849315068,0.00684931506849315
8197,109,94,15,67,42,0.8623853211009175,0.13761467889908258,0.6146788990825688,0.3853211009174312,13,0,0,13,12,1,0.0,0.0,1.0,0.9230769230769231,0.07692307692307693
8198,1868,1248,620,922,946,0.6680942184154176,0.33190578158458245,0.493576017130621,0.5064239828693791,258,0,20,238,257,1,0.0,0.07751937984496124,0.9224806201550387,0.9961240310077519,0.003875968992248062
8199,102,83,19,78,24,0.8137254901960784,0.18627450980392157,0.7647058823529411,0.23529411764705882,196,0,2,194,128,68,0.0,0.01020408163265306,0.9897959183673469,0.6530612244897959,0.3469387755102041
8200,137,118,19,75,62,0.8613138686131386,0.1386861313868613,0.5474452554744526,0.45255474452554745,14,0,0,14,11,3,0.0,0.0,1.0,0.7857142857142857,0.21428571428571427
8201,184,106,78,158,26,0.5760869565217391,0.42391304347826086,0.8586956521739131,0.14130434782608695,139,0,43,96,139,0,0.0,0.30935251798561153,0.6906474820143885,1.0,0.0
8202,184,106,78,158,26,0.5760869565217391,0.42391304347826086,0.8586956521739131,0.14130434782608695,139,0,43,96,139,0,0.0,0.30935251798561153,0.6906474820143885,1.0,0.0
8203,57,9,48,51,6,0.15789473684210525,0.8421052631578947,0.8947368421052632,0.10526315789473684,620,0,0,620,620,0,0.0,0.0,1.0,1.0,0.0
8204,3987,3234,753,3181,806,0.8111361926260346,0.18886380737396538,0.7978429897165789,0.20215701028342112,67,1,36,30,67,0,0.014925373134328358,0.5373134328358209,0.44776119402985076,1.0,0.0
8205,121,104,17,68,53,0.859504132231405,0.14049586776859505,0.5619834710743802,0.4380165289256198,9,0,0,9,8,1,0.0,0.0,1.0,0.8888888888888888,0.1111111111111111
8206,202,182,20,127,75,0.900990099009901,0.09900990099009901,0.6287128712871287,0.3712871287128713,12,0,0,12,11,1,0.0,0.0,1.0,0.9166666666666666,0.08333333333333333
8207,150,135,15,85,65,0.9,0.1,0.5666666666666667,0.43333333333333335,11,0,0,11,7,4,0.0,0.0,1.0,0.6363636363636364,0.36363636363636365
8208,191,157,34,144,47,0.8219895287958116,0.17801047120418848,0.7539267015706806,0.24607329842931938,162,0,2,160,114,48,0.0,0.012345679012345678,0.9876543209876543,0.7037037037037037,0.2962962962962963
8209,1772,1168,604,867,905,0.6591422121896162,0.34085778781038373,0.48927765237020315,0.5107223476297968,282,0,30,252,279,3,0.0,0.10638297872340426,0.8936170212765957,0.9893617021276596,0.010638297872340425
8210,143,122,21,85,58,0.8531468531468531,0.14685314685314685,0.5944055944055944,0.40559440559440557,10,0,0,10,8,2,0.0,0.0,1.0,0.8,0.2
8211,112,93,19,59,53,0.8303571428571429,0.16964285714285715,0.5267857142857143,0.4732142857142857,12,0,0,12,9,3,0.0,0.0,1.0,0.75,0.25
8212,187,109,78,161,26,0.5828877005347594,0.41711229946524064,0.8609625668449198,0.13903743315508021,140,0,43,97,140,0,0.0,0.30714285714285716,0.6928571428571428,1.0,0.0
8213,474,289,185,401,73,0.609704641350211,0.39029535864978904,0.8459915611814346,0.1540084388185654,284,11,65,208,273,11,0.03873239436619718,0.22887323943661972,0.7323943661971831,0.9612676056338029,0.03873239436619718
8214,149,124,25,92,57,0.8322147651006712,0.16778523489932887,0.6174496644295302,0.3825503355704698,12,0,0,12,10,2,0.0,0.0,1.0,0.8333333333333334,0.16666666666666666
8215,856,415,441,386,470,0.4848130841121495,0.5151869158878505,0.45093457943925236,0.5490654205607477,254,2,21,231,249,5,0.007874015748031496,0.08267716535433071,0.9094488188976378,0.9803149606299213,0.01968503937007874
8216,234,194,40,187,47,0.8290598290598291,0.17094017094017094,0.7991452991452992,0.20085470085470086,76,1,0,75,57,19,0.013157894736842105,0.0,0.9868421052631579,0.75,0.25
8217,202,160,42,145,57,0.7920792079207921,0.2079207920792079,0.7178217821782178,0.28217821782178215,70,4,8,58,66,4,0.05714285714285714,0.11428571428571428,0.8285714285714286,0.9428571428571428,0.05714285714285714
8218,611,478,133,399,212,0.7823240589198036,0.2176759410801964,0.6530278232405892,0.3469721767594108,43,0,0,43,40,3,0.0,0.0,1.0,0.9302325581395349,0.06976744186046512
8219,822,379,443,384,438,0.4610705596107056,0.5389294403892944,0.46715328467153283,0.5328467153284672,498,2,57,439,469,29,0.004016064257028112,0.1144578313253012,0.8815261044176707,0.9417670682730924,0.05823293172690763
8220,105,86,19,61,44,0.819047619047619,0.18095238095238095,0.580952380952381,0.41904761904761906,10,0,0,10,9,1,0.0,0.0,1.0,0.9,0.1
8221,1859,1240,619,932,927,0.6670252824098978,0.3329747175901022,0.5013448090371168,0.49865519096288324,251,0,22,229,250,1,0.0,0.08764940239043825,0.9123505976095617,0.9960159362549801,0.00398406374501992
8222,180,157,23,148,32,0.8722222222222222,0.12777777777777777,0.8222222222222222,0.17777777777777778,166,1,100,65,165,1,0.006024096385542169,0.6024096385542169,0.39156626506024095,0.9939759036144579,0.006024096385542169
8223,1887,1253,634,964,923,0.6640169581346052,0.3359830418653948,0.510863804981452,0.48913619501854794,252,0,25,227,251,1,0.0,0.0992063492063492,0.9007936507936508,0.996031746031746,0.003968253968253968
8224,141,122,19,78,63,0.8652482269503546,0.1347517730496454,0.5531914893617021,0.44680851063829785,17,0,0,17,14,3,0.0,0.0,1.0,0.8235294117647058,0.17647058823529413
8225,174,133,41,122,52,0.764367816091954,0.23563218390804597,0.7011494252873564,0.2988505747126437,66,4,8,54,62,4,0.06060606060606061,0.12121212121212122,0.8181818181818182,0.9393939393939394,0.06060606060606061
8226,92,77,15,62,30,0.8369565217391305,0.16304347826086957,0.6739130434782609,0.32608695652173914,9,0,0,9,8,1,0.0,0.0,1.0,0.8888888888888888,0.1111111111111111
8227,1803,1188,615,871,932,0.6589018302828619,0.3410981697171381,0.48308374930671105,0.516916250693289,253,0,20,233,253,0,0.0,0.07905138339920949,0.9209486166007905,1.0,0.0
8228,77,7,70,53,24,0.09090909090909091,0.9090909090909091,0.6883116883116883,0.3116883116883117,66,0,48,18,64,2,0.0,0.7272727272727273,0.2727272727272727,0.9696969696969697,0.030303030303030304
8229,258,256,2,254,4,0.9922480620155039,0.007751937984496124,0.9844961240310077,0.015503875968992248,186,0,162,24,88,98,0.0,0.8709677419354839,0.12903225806451613,0.4731182795698925,0.5268817204301075
8230,44,5,39,21,23,0.11363636363636363,0.8863636363636364,0.4772727272727273,0.5227272727272727,120,0,48,72,117,3,0.0,0.4,0.6,0.975,0.025
8231,80,10,70,54,26,0.125,0.875,0.675,0.325,65,0,47,18,63,2,0.0,0.7230769230769231,0.27692307692307694,0.9692307692307692,0.03076923076923077
8232,48,9,39,17,31,0.1875,0.8125,0.3541666666666667,0.6458333333333334,63,0,46,17,61,2,0.0,0.7301587301587301,0.2698412698412698,0.9682539682539683,0.031746031746031744
8233,74,5,69,50,24,0.06756756756756757,0.9324324324324325,0.6756756756756757,0.32432432432432434,64,0,47,17,62,2,0.0,0.734375,0.265625,0.96875,0.03125
8234,75,5,70,51,24,0.06666666666666667,0.9333333333333333,0.68,0.32,63,0,46,17,61,2,0.0,0.7301587301587301,0.2698412698412698,0.9682539682539683,0.031746031746031744
8235,76,6,70,50,26,0.07894736842105263,0.9210526315789473,0.6578947368421053,0.34210526315789475,64,0,46,18,62,2,0.0,0.71875,0.28125,0.96875,0.03125
8236,46,7,39,21,25,0.15217391304347827,0.8478260869565217,0.45652173913043476,0.5434782608695652,64,0,48,16,62,2,0.0,0.75,0.25,0.96875,0.03125
8237,76,6,70,53,23,0.07894736842105263,0.9210526315789473,0.6973684210526315,0.3026315789473684,66,0,48,18,64,2,0.0,0.7272727272727273,0.2727272727272727,0.9696969696969697,0.030303030303030304
8238,211,209,2,206,5,0.990521327014218,0.009478672985781991,0.976303317535545,0.023696682464454975,347,0,315,32,337,10,0.0,0.9077809798270894,0.09221902017291066,0.9711815561959655,0.02881844380403458
8239,49,37,12,18,31,0.7551020408163265,0.24489795918367346,0.3673469387755102,0.6326530612244898,220,0,8,212,208,12,0.0,0.03636363636363636,0.9636363636363636,0.9454545454545454,0.05454545454545454
8240,49,10,39,20,29,0.20408163265306123,0.7959183673469388,0.40816326530612246,0.5918367346938775,63,0,48,15,61,2,0.0,0.7619047619047619,0.23809523809523808,0.9682539682539683,0.031746031746031744
8241,74,5,69,47,27,0.06756756756756757,0.9324324324324325,0.6351351351351351,0.36486486486486486,64,0,46,18,62,2,0.0,0.71875,0.28125,0.96875,0.03125
8242,76,6,70,49,27,0.07894736842105263,0.9210526315789473,0.6447368421052632,0.35526315789473684,63,0,46,17,61,2,0.0,0.7301587301587301,0.2698412698412698,0.9682539682539683,0.031746031746031744
8243,80,11,69,50,30,0.1375,0.8625,0.625,0.375,65,0,48,17,63,2,0.0,0.7384615384615385,0.26153846153846155,0.9692307692307692,0.03076923076923077
8244,79,9,70,52,27,0.11392405063291139,0.8860759493670886,0.6582278481012658,0.34177215189873417,66,0,48,18,64,2,0.0,0.7272727272727273,0.2727272727272727,0.9696969696969697,0.030303030303030304
8245,47,8,39,21,26,0.1702127659574468,0.8297872340425532,0.44680851063829785,0.5531914893617021,118,0,47,71,115,3,0.0,0.3983050847457627,0.6016949152542372,0.9745762711864406,0.025423728813559324
8246,78,9,69,51,27,0.11538461538461539,0.8846153846153846,0.6538461538461539,0.34615384615384615,66,0,48,18,64,2,0.0,0.7272727272727273,0.2727272727272727,0.9696969696969697,0.030303030303030304
8247,79,9,70,50,29,0.11392405063291139,0.8860759493670886,0.6329113924050633,0.3670886075949367,64,0,46,18,62,2,0.0,0.71875,0.28125,0.96875,0.03125
8248,80,10,70,53,27,0.125,0.875,0.6625,0.3375,65,0,47,18,63,2,0.0,0.7230769230769231,0.27692307692307694,0.9692307692307692,0.03076923076923077
8249,77,7,70,51,26,0.09090909090909091,0.9090909090909091,0.6623376623376623,0.33766233766233766,65,0,47,18,63,2,0.0,0.7230769230769231,0.27692307692307694,0.9692307692307692,0.03076923076923077
8250,77,7,70,51,26,0.09090909090909091,0.9090909090909091,0.6623376623376623,0.33766233766233766,63,0,46,17,61,2,0.0,0.7301587301587301,0.2698412698412698,0.9682539682539683,0.031746031746031744
8251,79,9,70,52,27,0.11392405063291139,0.8860759493670886,0.6582278481012658,0.34177215189873417,65,0,48,17,63,2,0.0,0.7384615384615385,0.26153846153846155,0.9692307692307692,0.03076923076923077
8252,75,5,70,49,26,0.06666666666666667,0.9333333333333333,0.6533333333333333,0.3466666666666667,65,0,48,17,63,2,0.0,0.7384615384615385,0.26153846153846155,0.9692307692307692,0.03076923076923077
8253,77,8,69,50,27,0.1038961038961039,0.8961038961038961,0.6493506493506493,0.35064935064935066,64,0,46,18,62,2,0.0,0.71875,0.28125,0.96875,0.03125
8254,77,7,70,52,25,0.09090909090909091,0.9090909090909091,0.6753246753246753,0.3246753246753247,64,0,46,18,62,2,0.0,0.71875,0.28125,0.96875,0.03125
8255,75,5,70,51,24,0.06666666666666667,0.9333333333333333,0.68,0.32,64,0,46,18,62,2,0.0,0.71875,0.28125,0.96875,0.03125
8256,223,221,2,219,4,0.9910313901345291,0.008968609865470852,0.9820627802690582,0.017937219730941704,499,0,484,15,66,433,0.0,0.969939879759519,0.03006012024048096,0.13226452905811623,0.8677354709418837
8257,46,7,39,18,28,0.15217391304347827,0.8478260869565217,0.391304347826087,0.6086956521739131,64,0,48,16,62,2,0.0,0.75,0.25,0.96875,0.03125
8258,49,10,39,19,30,0.20408163265306123,0.7959183673469388,0.3877551020408163,0.6122448979591837,63,0,46,17,61,2,0.0,0.7301587301587301,0.2698412698412698,0.9682539682539683,0.031746031746031744
8259,75,5,70,53,22,0.06666666666666667,0.9333333333333333,0.7066666666666667,0.29333333333333333,66,0,48,18,64,2,0.0,0.7272727272727273,0.2727272727272727,0.9696969696969697,0.030303030303030304
8260,47,8,39,18,29,0.1702127659574468,0.8297872340425532,0.3829787234042553,0.6170212765957447,62,0,46,16,60,2,0.0,0.7419354838709677,0.25806451612903225,0.967741935483871,0.03225806451612903
8261,44,5,39,19,25,0.11363636363636363,0.8863636363636364,0.4318181818181818,0.5681818181818182,120,0,48,72,117,3,0.0,0.4,0.6,0.975,0.025
8262,77,7,70,50,27,0.09090909090909091,0.9090909090909091,0.6493506493506493,0.35064935064935066,65,0,47,18,63,2,0.0,0.7230769230769231,0.27692307692307694,0.9692307692307692,0.03076923076923077
8263,81,12,69,52,29,0.14814814814814814,0.8518518518518519,0.6419753086419753,0.35802469135802467,63,0,16,47,61,2,0.0,0.25396825396825395,0.746031746031746,0.9682539682539683,0.031746031746031744
8264,290,288,2,268,22,0.993103448275862,0.006896551724137931,0.9241379310344827,0.07586206896551724,603,0,588,15,84,519,0.0,0.9751243781094527,0.024875621890547265,0.13930348258706468,0.8606965174129353
8265,75,5,70,50,25,0.06666666666666667,0.9333333333333333,0.6666666666666666,0.3333333333333333,63,0,46,17,61,2,0.0,0.7301587301587301,0.2698412698412698,0.9682539682539683,0.031746031746031744
8266,78,10,68,48,30,0.1282051282051282,0.8717948717948718,0.6153846153846154,0.38461538461538464,66,0,48,18,64,2,0.0,0.7272727272727273,0.2727272727272727,0.9696969696969697,0.030303030303030304
8267,79,10,69,52,27,0.12658227848101267,0.8734177215189873,0.6582278481012658,0.34177215189873417,66,0,48,18,64,2,0.0,0.7272727272727273,0.2727272727272727,0.9696969696969697,0.030303030303030304
8268,76,7,69,53,23,0.09210526315789473,0.9078947368421053,0.6973684210526315,0.3026315789473684,66,0,48,18,64,2,0.0,0.7272727272727273,0.2727272727272727,0.9696969696969697,0.030303030303030304
8269,77,7,70,53,24,0.09090909090909091,0.9090909090909091,0.6883116883116883,0.3116883116883117,65,0,47,18,63,2,0.0,0.7230769230769231,0.27692307692307694,0.9692307692307692,0.03076923076923077
8270,44,5,39,19,25,0.11363636363636363,0.8863636363636364,0.4318181818181818,0.5681818181818182,64,0,48,16,62,2,0.0,0.75,0.25,0.96875,0.03125
8271,79,9,70,54,25,0.11392405063291139,0.8860759493670886,0.6835443037974683,0.31645569620253167,65,0,47,18,63,2,0.0,0.7230769230769231,0.27692307692307694,0.9692307692307692,0.03076923076923077
8272,46,7,39,20,26,0.15217391304347827,0.8478260869565217,0.43478260869565216,0.5652173913043478,64,0,48,16,62,2,0.0,0.75,0.25,0.96875,0.03125
8273,49,10,39,22,27,0.20408163265306123,0.7959183673469388,0.4489795918367347,0.5510204081632653,63,0,48,15,61,2,0.0,0.7619047619047619,0.23809523809523808,0.9682539682539683,0.031746031746031744
8274,49,10,39,20,29,0.20408163265306123,0.7959183673469388,0.40816326530612246,0.5918367346938775,64,0,48,16,62,2,0.0,0.75,0.25,0.96875,0.03125
8275,73,5,68,51,22,0.0684931506849315,0.9315068493150684,0.6986301369863014,0.3013698630136986,65,0,47,18,63,2,0.0,0.7230769230769231,0.27692307692307694,0.9692307692307692,0.03076923076923077
8276,243,241,2,238,5,0.9917695473251029,0.00823045267489712,0.9794238683127572,0.0205761316872428,490,0,454,36,476,14,0.0,0.926530612244898,0.07346938775510205,0.9714285714285714,0.02857142857142857
8277,44,5,39,20,24,0.11363636363636363,0.8863636363636364,0.45454545454545453,0.5454545454545454,64,0,48,16,62,2,0.0,0.75,0.25,0.96875,0.03125
8278,75,5,70,55,20,0.06666666666666667,0.9333333333333333,0.7333333333333333,0.26666666666666666,64,0,46,18,62,2,0.0,0.71875,0.28125,0.96875,0.03125
8279,79,10,69,52,27,0.12658227848101267,0.8734177215189873,0.6582278481012658,0.34177215189873417,65,0,47,18,63,2,0.0,0.7230769230769231,0.27692307692307694,0.9692307692307692,0.03076923076923077
8280,45,6,39,22,23,0.13333333333333333,0.8666666666666667,0.4888888888888889,0.5111111111111111,64,0,48,16,62,2,0.0,0.75,0.25,0.96875,0.03125
8281,46,34,12,19,27,0.7391304347826086,0.2608695652173913,0.41304347826086957,0.5869565217391305,221,0,8,213,208,13,0.0,0.03619909502262444,0.9638009049773756,0.9411764705882353,0.058823529411764705
8282,76,6,70,55,21,0.07894736842105263,0.9210526315789473,0.7236842105263158,0.27631578947368424,63,0,16,47,61,2,0.0,0.25396825396825395,0.746031746031746,0.9682539682539683,0.031746031746031744
8283,76,6,70,55,21,0.07894736842105263,0.9210526315789473,0.7236842105263158,0.27631578947368424,63,0,46,17,61,2,0.0,0.7301587301587301,0.2698412698412698,0.9682539682539683,0.031746031746031744
8284,45,6,39,20,25,0.13333333333333333,0.8666666666666667,0.4444444444444444,0.5555555555555556,63,0,48,15,61,2,0.0,0.7619047619047619,0.23809523809523808,0.9682539682539683,0.031746031746031744
8285,46,7,39,20,26,0.15217391304347827,0.8478260869565217,0.43478260869565216,0.5652173913043478,64,0,48,16,62,2,0.0,0.75,0.25,0.96875,0.03125
8286,75,6,69,50,25,0.08,0.92,0.6666666666666666,0.3333333333333333,63,0,17,46,61,2,0.0,0.2698412698412698,0.7301587301587301,0.9682539682539683,0.031746031746031744
8287,78,9,69,52,26,0.11538461538461539,0.8846153846153846,0.6666666666666666,0.3333333333333333,64,0,46,18,62,2,0.0,0.71875,0.28125,0.96875,0.03125
8288,76,7,69,51,25,0.09210526315789473,0.9078947368421053,0.6710526315789473,0.32894736842105265,64,0,46,18,62,2,0.0,0.71875,0.28125,0.96875,0.03125
8289,48,9,39,17,31,0.1875,0.8125,0.3541666666666667,0.6458333333333334,62,0,46,16,60,2,0.0,0.7419354838709677,0.25806451612903225,0.967741935483871,0.03225806451612903
8290,76,7,69,52,24,0.09210526315789473,0.9078947368421053,0.6842105263157895,0.3157894736842105,64,0,47,17,62,2,0.0,0.734375,0.265625,0.96875,0.03125
8291,73,4,69,55,18,0.0547945205479452,0.9452054794520548,0.7534246575342466,0.2465753424657534,63,0,47,16,61,2,0.0,0.746031746031746,0.25396825396825395,0.9682539682539683,0.031746031746031744
8292,76,7,69,53,23,0.09210526315789473,0.9078947368421053,0.6973684210526315,0.3026315789473684,66,0,48,18,64,2,0.0,0.7272727272727273,0.2727272727272727,0.9696969696969697,0.030303030303030304
8293,81,12,69,51,30,0.14814814814814814,0.8518518518518519,0.6296296296296297,0.37037037037037035,65,0,47,18,63,2,0.0,0.7230769230769231,0.27692307692307694,0.9692307692307692,0.03076923076923077
8294,80,10,70,51,29,0.125,0.875,0.6375,0.3625,66,0,48,18,64,2,0.0,0.7272727272727273,0.2727272727272727,0.9696969696969697,0.030303030303030304
8295,77,9,68,51,26,0.11688311688311688,0.8831168831168831,0.6623376623376623,0.33766233766233766,64,0,46,18,62,2,0.0,0.71875,0.28125,0.96875,0.03125
8296,228,226,2,223,5,0.9912280701754386,0.008771929824561403,0.9780701754385965,0.021929824561403508,449,0,411,38,434,15,0.0,0.9153674832962138,0.08463251670378619,0.9665924276169265,0.0334075723830735
8297,47,8,39,20,27,0.1702127659574468,0.8297872340425532,0.425531914893617,0.574468085106383,63,0,47,16,61,2,0.0,0.746031746031746,0.25396825396825395,0.9682539682539683,0.031746031746031744
8298,78,8,70,50,28,0.10256410256410256,0.8974358974358975,0.6410256410256411,0.358974358974359,66,0,48,18,64,2,0.0,0.7272727272727273,0.2727272727272727,0.9696969696969697,0.030303030303030304
8299,45,6,39,18,27,0.13333333333333333,0.8666666666666667,0.4,0.6,64,0,48,16,62,2,0.0,0.75,0.25,0.96875,0.03125
8300,83,13,70,52,31,0.1566265060240964,0.8433734939759037,0.6265060240963856,0.37349397590361444,65,0,48,17,63,2,0.0,0.7384615384615385,0.26153846153846155,0.9692307692307692,0.03076923076923077
8301,268,266,2,246,22,0.9925373134328358,0.007462686567164179,0.917910447761194,0.08208955223880597,380,0,365,15,378,2,0.0,0.9605263157894737,0.039473684210526314,0.9947368421052631,0.005263157894736842
8302,77,8,69,51,26,0.1038961038961039,0.8961038961038961,0.6623376623376623,0.33766233766233766,63,0,16,47,61,2,0.0,0.25396825396825395,0.746031746031746,0.9682539682539683,0.031746031746031744
8303,79,10,69,52,27,0.12658227848101267,0.8734177215189873,0.6582278481012658,0.34177215189873417,66,0,48,18,64,2,0.0,0.7272727272727273,0.2727272727272727,0.9696969696969697,0.030303030303030304
8304,48,9,39,23,25,0.1875,0.8125,0.4791666666666667,0.5208333333333334,62,0,46,16,60,2,0.0,0.7419354838709677,0.25806451612903225,0.967741935483871,0.03225806451612903
8305,48,34,14,20,28,0.7083333333333334,0.2916666666666667,0.4166666666666667,0.5833333333333334,224,0,8,216,212,12,0.0,0.03571428571428571,0.9642857142857143,0.9464285714285714,0.05357142857142857
8306,273,271,2,251,22,0.9926739926739927,0.007326007326007326,0.9194139194139194,0.08058608058608059,234,0,219,15,232,2,0.0,0.9358974358974359,0.0641025641025641,0.9914529914529915,0.008547008547008548
8307,47,8,39,22,25,0.1702127659574468,0.8297872340425532,0.46808510638297873,0.5319148936170213,63,0,48,15,62,1,0.0,0.7619047619047619,0.23809523809523808,0.9841269841269841,0.015873015873015872
8308,303,301,2,299,4,0.9933993399339934,0.006600660066006601,0.9867986798679867,0.013201320132013201,585,0,548,37,571,14,0.0,0.9367521367521368,0.06324786324786325,0.976068376068376,0.023931623931623933
8309,47,8,39,22,25,0.1702127659574468,0.8297872340425532,0.46808510638297873,0.5319148936170213,63,0,48,15,61,2,0.0,0.7619047619047619,0.23809523809523808,0.9682539682539683,0.031746031746031744
8310,45,6,39,24,21,0.13333333333333333,0.8666666666666667,0.5333333333333333,0.4666666666666667,120,0,48,72,117,3,0.0,0.4,0.6,0.975,0.025
8311,47,8,39,24,23,0.1702127659574468,0.8297872340425532,0.5106382978723404,0.48936170212765956,120,0,48,72,117,3,0.0,0.4,0.6,0.975,0.025
8312,80,10,70,52,28,0.125,0.875,0.65,0.35,64,0,46,18,62,2,0.0,0.71875,0.28125,0.96875,0.03125
8313,81,11,70,54,27,0.13580246913580246,0.8641975308641975,0.6666666666666666,0.3333333333333333,64,0,47,17,62,2,0.0,0.734375,0.265625,0.96875,0.03125
8314,79,9,70,52,27,0.11392405063291139,0.8860759493670886,0.6582278481012658,0.34177215189873417,66,0,48,18,64,2,0.0,0.7272727272727273,0.2727272727272727,0.9696969696969697,0.030303030303030304
8315,77,7,70,51,26,0.09090909090909091,0.9090909090909091,0.6623376623376623,0.33766233766233766,63,0,16,47,61,2,0.0,0.25396825396825395,0.746031746031746,0.9682539682539683,0.031746031746031744
8316,45,6,39,18,27,0.13333333333333333,0.8666666666666667,0.4,0.6,63,0,46,17,61,2,0.0,0.7301587301587301,0.2698412698412698,0.9682539682539683,0.031746031746031744
8317,76,6,70,50,26,0.07894736842105263,0.9210526315789473,0.6578947368421053,0.34210526315789475,64,0,46,18,62,2,0.0,0.71875,0.28125,0.96875,0.03125
8318,221,219,2,218,3,0.9909502262443439,0.00904977375565611,0.9864253393665159,0.013574660633484163,354,0,338,16,352,2,0.0,0.9548022598870056,0.04519774011299435,0.9943502824858758,0.005649717514124294
8319,44,5,39,24,20,0.11363636363636363,0.8863636363636364,0.5454545454545454,0.45454545454545453,64,0,48,16,62,2,0.0,0.75,0.25,0.96875,0.03125
8320,44,5,39,21,23,0.11363636363636363,0.8863636363636364,0.4772727272727273,0.5227272727272727,64,0,48,16,62,2,0.0,0.75,0.25,0.96875,0.03125
8321,77,8,69,51,26,0.1038961038961039,0.8961038961038961,0.6623376623376623,0.33766233766233766,66,0,48,18,64,2,0.0,0.7272727272727273,0.2727272727272727,0.9696969696969697,0.030303030303030304
8322,77,7,70,54,23,0.09090909090909091,0.9090909090909091,0.7012987012987013,0.2987012987012987,66,0,48,18,64,2,0.0,0.7272727272727273,0.2727272727272727,0.9696969696969697,0.030303030303030304
8323,79,9,70,53,26,0.11392405063291139,0.8860759493670886,0.6708860759493671,0.3291139240506329,63,0,17,46,61,2,0.0,0.2698412698412698,0.7301587301587301,0.9682539682539683,0.031746031746031744
8324,79,9,70,47,32,0.11392405063291139,0.8860759493670886,0.5949367088607594,0.4050632911392405,63,0,16,47,61,2,0.0,0.25396825396825395,0.746031746031746,0.9682539682539683,0.031746031746031744
8325,79,9,70,52,27,0.11392405063291139,0.8860759493670886,0.6582278481012658,0.34177215189873417,65,0,47,18,63,2,0.0,0.7230769230769231,0.27692307692307694,0.9692307692307692,0.03076923076923077
8326,81,11,70,54,27,0.13580246913580246,0.8641975308641975,0.6666666666666666,0.3333333333333333,66,0,48,18,64,2,0.0,0.7272727272727273,0.2727272727272727,0.9696969696969697,0.030303030303030304
8327,77,8,69,51,26,0.1038961038961039,0.8961038961038961,0.6623376623376623,0.33766233766233766,64,0,47,17,62,2,0.0,0.734375,0.265625,0.96875,0.03125
8328,78,9,69,54,24,0.11538461538461539,0.8846153846153846,0.6923076923076923,0.3076923076923077,65,0,47,18,63,2,0.0,0.7230769230769231,0.27692307692307694,0.9692307692307692,0.03076923076923077
8329,51,12,39,19,32,0.23529411764705882,0.7647058823529411,0.37254901960784315,0.6274509803921569,64,0,48,16,62,2,0.0,0.75,0.25,0.96875,0.03125
8330,49,10,39,21,28,0.20408163265306123,0.7959183673469388,0.42857142857142855,0.5714285714285714,63,0,48,15,61,2,0.0,0.7619047619047619,0.23809523809523808,0.9682539682539683,0.031746031746031744
8331,283,281,2,259,24,0.9929328621908127,0.007067137809187279,0.9151943462897526,0.08480565371024736,440,0,422,18,438,2,0.0,0.9590909090909091,0.04090909090909091,0.9954545454545455,0.004545454545454545
8332,77,8,69,49,28,0.1038961038961039,0.8961038961038961,0.6363636363636364,0.36363636363636365,62,0,17,45,60,2,0.0,0.27419354838709675,0.7258064516129032,0.967741935483871,0.03225806451612903
8333,45,6,39,20,25,0.13333333333333333,0.8666666666666667,0.4444444444444444,0.5555555555555556,62,0,46,16,60,2,0.0,0.7419354838709677,0.25806451612903225,0.967741935483871,0.03225806451612903
8334,47,8,39,16,31,0.1702127659574468,0.8297872340425532,0.3404255319148936,0.6595744680851063,64,0,48,16,62,2,0.0,0.75,0.25,0.96875,0.03125
8335,49,35,14,20,29,0.7142857142857143,0.2857142857142857,0.40816326530612246,0.5918367346938775,231,0,8,223,219,12,0.0,0.03463203463203463,0.9653679653679653,0.948051948051948,0.05194805194805195
8336,278,276,2,256,22,0.9928057553956835,0.007194244604316547,0.920863309352518,0.07913669064748201,640,0,624,16,68,572,0.0,0.975,0.025,0.10625,0.89375
8337,76,7,69,50,26,0.09210526315789473,0.9078947368421053,0.6578947368421053,0.34210526315789475,64,0,46,18,62,2,0.0,0.71875,0.28125,0.96875,0.03125
8338,75,6,69,52,23,0.08,0.92,0.6933333333333334,0.30666666666666664,64,0,47,17,62,2,0.0,0.734375,0.265625,0.96875,0.03125
8339,79,9,70,51,28,0.11392405063291139,0.8860759493670886,0.6455696202531646,0.35443037974683544,66,0,48,18,64,2,0.0,0.7272727272727273,0.2727272727272727,0.9696969696969697,0.030303030303030304
8340,48,9,39,19,29,0.1875,0.8125,0.3958333333333333,0.6041666666666666,63,0,48,15,61,2,0.0,0.7619047619047619,0.23809523809523808,0.9682539682539683,0.031746031746031744
8341,266,264,2,244,22,0.9924812030075187,0.007518796992481203,0.9172932330827067,0.08270676691729323,184,0,169,15,182,2,0.0,0.9184782608695652,0.08152173913043478,0.9891304347826086,0.010869565217391304
8342,206,204,2,201,5,0.9902912621359223,0.009708737864077669,0.9757281553398058,0.024271844660194174,398,0,360,38,383,15,0.0,0.9045226130653267,0.09547738693467336,0.9623115577889447,0.03768844221105527
8343,50,11,39,25,25,0.22,0.78,0.5,0.5,120,0,48,72,117,3,0.0,0.4,0.6,0.975,0.025
8344,50,11,39,20,30,0.22,0.78,0.4,0.6,63,0,47,16,61,2,0.0,0.746031746031746,0.25396825396825395,0.9682539682539683,0.031746031746031744
8345,223,221,2,220,3,0.9910313901345291,0.008968609865470852,0.9865470852017937,0.013452914798206279,495,0,456,39,480,15,0.0,0.9212121212121213,0.07878787878787878,0.9696969696969697,0.030303030303030304
8346,76,7,69,51,25,0.09210526315789473,0.9078947368421053,0.6710526315789473,0.32894736842105265,64,0,46,18,62,2,0.0,0.71875,0.28125,0.96875,0.03125
8347,77,7,70,52,25,0.09090909090909091,0.9090909090909091,0.6753246753246753,0.3246753246753247,64,0,46,18,62,2,0.0,0.71875,0.28125,0.96875,0.03125
8348,49,10,39,21,28,0.20408163265306123,0.7959183673469388,0.42857142857142855,0.5714285714285714,64,0,48,16,62,2,0.0,0.75,0.25,0.96875,0.03125
8349,51,12,39,23,28,0.23529411764705882,0.7647058823529411,0.45098039215686275,0.5490196078431373,64,0,48,16,62,2,0.0,0.75,0.25,0.96875,0.03125
8350,81,11,70,48,33,0.13580246913580246,0.8641975308641975,0.5925925925925926,0.4074074074074074,65,0,48,17,63,2,0.0,0.7384615384615385,0.26153846153846155,0.9692307692307692,0.03076923076923077
8351,46,7,39,20,26,0.15217391304347827,0.8478260869565217,0.43478260869565216,0.5652173913043478,63,0,48,15,61,2,0.0,0.7619047619047619,0.23809523809523808,0.9682539682539683,0.031746031746031744
8352,50,11,39,21,29,0.22,0.78,0.42,0.58,120,0,48,72,117,3,0.0,0.4,0.6,0.975,0.025
8353,49,10,39,23,26,0.20408163265306123,0.7959183673469388,0.46938775510204084,0.5306122448979592,120,0,48,72,117,3,0.0,0.4,0.6,0.975,0.025
8354,75,6,69,51,24,0.08,0.92,0.68,0.32,65,0,47,18,63,2,0.0,0.7230769230769231,0.27692307692307694,0.9692307692307692,0.03076923076923077
8355,27401,22081,5320,22187,5214,0.8058465019524835,0.19415349804751653,0.8097149739060618,0.1902850260939382,9754,803,749,8202,6952,2802,0.08232519991798237,0.07678900963707197,0.8408857904449457,0.7127332376460939,0.2872667623539061
8356,76,7,69,51,25,0.09210526315789473,0.9078947368421053,0.6710526315789473,0.32894736842105265,64,0,47,17,62,2,0.0,0.734375,0.265625,0.96875,0.03125
8357,49,10,39,20,29,0.20408163265306123,0.7959183673469388,0.40816326530612246,0.5918367346938775,64,0,48,16,62,2,0.0,0.75,0.25,0.96875,0.03125
8358,77,7,70,54,23,0.09090909090909091,0.9090909090909091,0.7012987012987013,0.2987012987012987,64,0,46,18,62,2,0.0,0.71875,0.28125,0.96875,0.03125
8359,76,6,70,54,22,0.07894736842105263,0.9210526315789473,0.7105263157894737,0.2894736842105263,64,0,47,17,62,2,0.0,0.734375,0.265625,0.96875,0.03125
8360,27349,22039,5310,22153,5196,0.8058429924311675,0.1941570075688325,0.8100113349665435,0.18998866503345643,9656,803,746,8107,6860,2796,0.08316072908036454,0.07725766362883181,0.8395816072908037,0.7104391052195526,0.2895608947804474
8361,77,7,70,52,25,0.09090909090909091,0.9090909090909091,0.6753246753246753,0.3246753246753247,66,0,48,18,64,2,0.0,0.7272727272727273,0.2727272727272727,0.9696969696969697,0.030303030303030304
8362,79,10,69,48,31,0.12658227848101267,0.8734177215189873,0.6075949367088608,0.3924050632911392,65,0,47,18,63,2,0.0,0.7230769230769231,0.27692307692307694,0.9692307692307692,0.03076923076923077
8363,44,5,39,20,24,0.11363636363636363,0.8863636363636364,0.45454545454545453,0.5454545454545454,63,0,48,15,61,2,0.0,0.7619047619047619,0.23809523809523808,0.9682539682539683,0.031746031746031744
8364,74,6,68,51,23,0.08108108108108109,0.918918918918919,0.6891891891891891,0.3108108108108108,62,0,45,17,60,2,0.0,0.7258064516129032,0.27419354838709675,0.967741935483871,0.03225806451612903
8365,75,6,69,50,25,0.08,0.92,0.6666666666666666,0.3333333333333333,62,0,15,47,60,2,0.0,0.24193548387096775,0.7580645161290323,0.967741935483871,0.03225806451612903
8366,76,6,70,51,25,0.07894736842105263,0.9210526315789473,0.6710526315789473,0.32894736842105265,65,0,48,17,63,2,0.0,0.7384615384615385,0.26153846153846155,0.9692307692307692,0.03076923076923077
8367,76,7,69,51,25,0.09210526315789473,0.9078947368421053,0.6710526315789473,0.32894736842105265,65,0,47,18,63,2,0.0,0.7230769230769231,0.27692307692307694,0.9692307692307692,0.03076923076923077
8368,79,10,69,48,31,0.12658227848101267,0.8734177215189873,0.6075949367088608,0.3924050632911392,64,0,46,18,62,2,0.0,0.71875,0.28125,0.96875,0.03125
8369,78,9,69,55,23,0.11538461538461539,0.8846153846153846,0.7051282051282052,0.2948717948717949,65,0,47,18,63,2,0.0,0.7230769230769231,0.27692307692307694,0.9692307692307692,0.03076923076923077
8370,50,11,39,21,29,0.22,0.78,0.42,0.58,63,0,48,15,61,2,0.0,0.7619047619047619,0.23809523809523808,0.9682539682539683,0.031746031746031744
8371,78,8,70,53,25,0.10256410256410256,0.8974358974358975,0.6794871794871795,0.32051282051282054,64,0,16,48,62,2,0.0,0.25,0.75,0.96875,0.03125
8372,0,0,0,0,0,0.0,0.0,0.0,0.0,0,0,0,0,0,0,0.0,0.0,0.0,0.0,0.0
8373,78,9,69,52,26,0.11538461538461539,0.8846153846153846,0.6666666666666666,0.3333333333333333,65,0,48,17,63,2,0.0,0.7384615384615385,0.26153846153846155,0.9692307692307692,0.03076923076923077
8374,76,6,70,57,19,0.07894736842105263,0.9210526315789473,0.75,0.25,65,0,48,17,63,2,0.0,0.7384615384615385,0.26153846153846155,0.9692307692307692,0.03076923076923077
8375,54,15,39,21,33,0.2777777777777778,0.7222222222222222,0.3888888888888889,0.6111111111111112,64,0,48,16,62,2,0.0,0.75,0.25,0.96875,0.03125
8376,76,7,69,49,27,0.09210526315789473,0.9078947368421053,0.6447368421052632,0.35526315789473684,64,0,47,17,62,2,0.0,0.734375,0.265625,0.96875,0.03125
8377,46,7,39,20,26,0.15217391304347827,0.8478260869565217,0.43478260869565216,0.5652173913043478,64,0,48,16,62,2,0.0,0.75,0.25,0.96875,0.03125
8378,84,14,70,54,30,0.16666666666666666,0.8333333333333334,0.6428571428571429,0.35714285714285715,64,0,47,17,62,2,0.0,0.734375,0.265625,0.96875,0.03125
8379,76,6,70,52,24,0.07894736842105263,0.9210526315789473,0.6842105263157895,0.3157894736842105,64,0,46,18,62,2,0.0,0.71875,0.28125,0.96875,0.03125
8380,76,6,70,49,27,0.07894736842105263,0.9210526315789473,0.6447368421052632,0.35526315789473684,64,0,46,18,62,2,0.0,0.71875,0.28125,0.96875,0.03125
8381,295,293,2,273,22,0.9932203389830508,0.006779661016949152,0.9254237288135593,0.07457627118644068,526,0,511,15,524,2,0.0,0.9714828897338403,0.028517110266159697,0.9961977186311787,0.0038022813688212928
8382,47,8,39,20,27,0.1702127659574468,0.8297872340425532,0.425531914893617,0.574468085106383,63,0,46,17,61,2,0.0,0.7301587301587301,0.2698412698412698,0.9682539682539683,0.031746031746031744
8383,78,8,70,54,24,0.10256410256410256,0.8974358974358975,0.6923076923076923,0.3076923076923077,65,0,47,18,63,2,0.0,0.7230769230769231,0.27692307692307694,0.9692307692307692,0.03076923076923077
8384,48,9,39,17,31,0.1875,0.8125,0.3541666666666667,0.6458333333333334,64,0,48,16,62,2,0.0,0.75,0.25,0.96875,0.03125
8385,78,8,70,53,25,0.10256410256410256,0.8974358974358975,0.6794871794871795,0.32051282051282054,66,0,48,18,64,2,0.0,0.7272727272727273,0.2727272727272727,0.9696969696969697,0.030303030303030304
8386,83,13,70,51,32,0.1566265060240964,0.8433734939759037,0.6144578313253012,0.3855421686746988,65,0,47,18,63,2,0.0,0.7230769230769231,0.27692307692307694,0.9692307692307692,0.03076923076923077
8387,43,4,39,19,24,0.09302325581395349,0.9069767441860465,0.4418604651162791,0.5581395348837209,63,0,48,15,61,2,0.0,0.7619047619047619,0.23809523809523808,0.9682539682539683,0.031746031746031744
8388,43,4,39,20,23,0.09302325581395349,0.9069767441860465,0.46511627906976744,0.5348837209302325,63,0,48,15,61,2,0.0,0.7619047619047619,0.23809523809523808,0.9682539682539683,0.031746031746031744
8389,217,215,2,214,3,0.9907834101382489,0.009216589861751152,0.9861751152073732,0.013824884792626729,532,0,487,45,514,18,0.0,0.9154135338345865,0.08458646616541353,0.9661654135338346,0.03383458646616541
8390,216,214,2,212,4,0.9907407407407407,0.009259259259259259,0.9814814814814815,0.018518518518518517,298,0,267,31,287,11,0.0,0.8959731543624161,0.1040268456375839,0.9630872483221476,0.03691275167785235
8391,46,7,39,19,27,0.15217391304347827,0.8478260869565217,0.41304347826086957,0.5869565217391305,64,0,48,16,62,2,0.0,0.75,0.25,0.96875,0.03125
8392,50,11,39,19,31,0.22,0.78,0.38,0.62,64,0,48,16,62,2,0.0,0.75,0.25,0.96875,0.03125
8393,79,9,70,50,29,0.11392405063291139,0.8860759493670886,0.6329113924050633,0.3670886075949367,64,0,46,18,62,2,0.0,0.71875,0.28125,0.96875,0.03125
8394,47,8,39,24,23,0.1702127659574468,0.8297872340425532,0.5106382978723404,0.48936170212765956,119,0,48,71,116,3,0.0,0.40336134453781514,0.5966386554621849,0.9747899159663865,0.025210084033613446
8395,78,8,70,52,26,0.10256410256410256,0.8974358974358975,0.6666666666666666,0.3333333333333333,66,0,48,18,64,2,0.0,0.7272727272727273,0.2727272727272727,0.9696969696969697,0.030303030303030304
8396,297,295,2,274,23,0.9932659932659933,0.006734006734006734,0.9225589225589226,0.07744107744107744,400,0,385,15,86,314,0.0,0.9625,0.0375,0.215,0.785
8397,244,242,2,239,5,0.9918032786885246,0.00819672131147541,0.9795081967213115,0.020491803278688523,577,0,537,40,561,16,0.0,0.9306759098786829,0.06932409012131716,0.9722703639514731,0.02772963604852686
8398,49,10,39,22,27,0.20408163265306123,0.7959183673469388,0.4489795918367347,0.5510204081632653,119,0,48,71,116,3,0.0,0.40336134453781514,0.5966386554621849,0.9747899159663865,0.025210084033613446
8399,78,8,70,53,25,0.10256410256410256,0.8974358974358975,0.6794871794871795,0.32051282051282054,64,0,46,18,62,2,0.0,0.71875,0.28125,0.96875,0.03125
8400,47,8,39,22,25,0.1702127659574468,0.8297872340425532,0.46808510638297873,0.5319148936170213,64,0,48,16,62,2,0.0,0.75,0.25,0.96875,0.03125
8401,211,209,2,207,4,0.990521327014218,0.009478672985781991,0.981042654028436,0.018957345971563982,407,0,370,37,393,14,0.0,0.9090909090909091,0.09090909090909091,0.9656019656019657,0.0343980343980344
8402,49,10,39,22,27,0.20408163265306123,0.7959183673469388,0.4489795918367347,0.5510204081632653,120,0,48,72,117,3,0.0,0.4,0.6,0.975,0.025
8403,79,10,69,52,27,0.12658227848101267,0.8734177215189873,0.6582278481012658,0.34177215189873417,63,0,46,17,61,2,0.0,0.7301587301587301,0.2698412698412698,0.9682539682539683,0.031746031746031744
8404,290,288,2,285,5,0.993103448275862,0.006896551724137931,0.9827586206896551,0.017241379310344827,389,0,354,35,376,13,0.0,0.910025706940874,0.08997429305912596,0.9665809768637532,0.033419023136246784
8405,247,245,2,243,4,0.9919028340080972,0.008097165991902834,0.9838056680161943,0.016194331983805668,537,0,494,43,519,18,0.0,0.9199255121042831,0.08007448789571694,0.9664804469273743,0.0335195530726257
8406,45,33,12,18,27,0.7333333333333333,0.26666666666666666,0.4,0.6,232,0,8,224,220,12,0.0,0.034482758620689655,0.9655172413793104,0.9482758620689655,0.05172413793103448
8407,77,8,69,51,26,0.1038961038961039,0.8961038961038961,0.6623376623376623,0.33766233766233766,65,0,48,17,63,2,0.0,0.7384615384615385,0.26153846153846155,0.9692307692307692,0.03076923076923077
8408,45,6,39,23,22,0.13333333333333333,0.8666666666666667,0.5111111111111111,0.4888888888888889,79,0,63,16,78,1,0.0,0.7974683544303798,0.20253164556962025,0.9873417721518988,0.012658227848101266
8409,27350,22040,5310,22154,5196,0.8058500914076783,0.19414990859232176,0.810018281535649,0.189981718464351,9653,803,746,8104,6860,2793,0.0831865741220346,0.07728167409095618,0.8395317517870092,0.7106598984771574,0.2893401015228426
8410,49,10,39,16,33,0.20408163265306123,0.7959183673469388,0.32653061224489793,0.673469387755102,64,0,48,16,62,2,0.0,0.75,0.25,0.96875,0.03125
8411,78,8,70,51,27,0.10256410256410256,0.8974358974358975,0.6538461538461539,0.34615384615384615,66,0,48,18,64,2,0.0,0.7272727272727273,0.2727272727272727,0.9696969696969697,0.030303030303030304
8412,0,0,0,0,0,0.0,0.0,0.0,0.0,0,0,0,0,0,0,0.0,0.0,0.0,0.0,0.0
8413,48,9,39,21,27,0.1875,0.8125,0.4375,0.5625,62,0,47,15,60,2,0.0,0.7580645161290323,0.24193548387096775,0.967741935483871,0.03225806451612903
8414,75,7,68,47,28,0.09333333333333334,0.9066666666666666,0.6266666666666667,0.37333333333333335,63,0,46,17,61,2,0.0,0.7301587301587301,0.2698412698412698,0.9682539682539683,0.031746031746031744
8415,78,9,69,47,31,0.11538461538461539,0.8846153846153846,0.6025641025641025,0.3974358974358974,64,0,17,47,62,2,0.0,0.265625,0.734375,0.96875,0.03125
8416,50,11,39,23,27,0.22,0.78,0.46,0.54,64,0,48,16,62,2,0.0,0.75,0.25,0.96875,0.03125
8417,234,232,2,229,5,0.9914529914529915,0.008547008547008548,0.9786324786324786,0.021367521367521368,363,0,334,29,353,10,0.0,0.9201101928374655,0.07988980716253444,0.9724517906336089,0.027548209366391185
8418,78,8,70,53,25,0.10256410256410256,0.8974358974358975,0.6794871794871795,0.32051282051282054,65,0,48,17,63,2,0.0,0.7384615384615385,0.26153846153846155,0.9692307692307692,0.03076923076923077
8419,77,8,69,49,28,0.1038961038961039,0.8961038961038961,0.6363636363636364,0.36363636363636365,65,0,48,17,63,2,0.0,0.7384615384615385,0.26153846153846155,0.9692307692307692,0.03076923076923077
8420,81,11,70,52,29,0.13580246913580246,0.8641975308641975,0.6419753086419753,0.35802469135802467,65,0,47,18,63,2,0.0,0.7230769230769231,0.27692307692307694,0.9692307692307692,0.03076923076923077
8421,73,4,69,52,21,0.0547945205479452,0.9452054794520548,0.7123287671232876,0.2876712328767123,65,0,47,18,63,2,0.0,0.7230769230769231,0.27692307692307694,0.9692307692307692,0.03076923076923077
8422,77,7,70,54,23,0.09090909090909091,0.9090909090909091,0.7012987012987013,0.2987012987012987,63,0,46,17,61,2,0.0,0.7301587301587301,0.2698412698412698,0.9682539682539683,0.031746031746031744
8423,47,8,39,21,26,0.1702127659574468,0.8297872340425532,0.44680851063829785,0.5531914893617021,63,0,48,15,61,2,0.0,0.7619047619047619,0.23809523809523808,0.9682539682539683,0.031746031746031744
8424,75,5,70,53,22,0.06666666666666667,0.9333333333333333,0.7066666666666667,0.29333333333333333,64,0,46,18,62,2,0.0,0.71875,0.28125,0.96875,0.03125
8425,75,5,70,51,24,0.06666666666666667,0.9333333333333333,0.68,0.32,64,0,47,17,62,2,0.0,0.734375,0.265625,0.96875,0.03125
8426,47,8,39,23,24,0.1702127659574468,0.8297872340425532,0.48936170212765956,0.5106382978723404,120,0,48,72,117,3,0.0,0.4,0.6,0.975,0.025
8427,78,8,70,53,25,0.10256410256410256,0.8974358974358975,0.6794871794871795,0.32051282051282054,63,0,46,17,61,2,0.0,0.7301587301587301,0.2698412698412698,0.9682539682539683,0.031746031746031744
8428,80,10,70,56,24,0.125,0.875,0.7,0.3,65,0,47,18,63,2,0.0,0.7230769230769231,0.27692307692307694,0.9692307692307692,0.03076923076923077
8429,75,5,70,53,22,0.06666666666666667,0.9333333333333333,0.7066666666666667,0.29333333333333333,63,0,17,46,61,2,0.0,0.2698412698412698,0.7301587301587301,0.9682539682539683,0.031746031746031744
8430,44,5,39,24,20,0.11363636363636363,0.8863636363636364,0.5454545454545454,0.45454545454545453,120,0,48,72,117,3,0.0,0.4,0.6,0.975,0.025
8431,294,292,2,291,3,0.9931972789115646,0.006802721088435374,0.9897959183673469,0.01020408163265306,397,0,363,34,384,13,0.0,0.9143576826196473,0.08564231738035265,0.9672544080604534,0.0327455919395466
8432,77,9,68,49,28,0.11688311688311688,0.8831168831168831,0.6363636363636364,0.36363636363636365,64,0,46,18,62,2,0.0,0.71875,0.28125,0.96875,0.03125
8433,47,8,39,20,27,0.1702127659574468,0.8297872340425532,0.425531914893617,0.574468085106383,63,0,48,15,61,2,0.0,0.7619047619047619,0.23809523809523808,0.9682539682539683,0.031746031746031744
8434,47,8,39,18,29,0.1702127659574468,0.8297872340425532,0.3829787234042553,0.6170212765957447,120,0,48,72,117,3,0.0,0.4,0.6,0.975,0.025
8435,77,9,68,50,27,0.11688311688311688,0.8831168831168831,0.6493506493506493,0.35064935064935066,63,0,46,17,61,2,0.0,0.7301587301587301,0.2698412698412698,0.9682539682539683,0.031746031746031744
8436,76,8,68,53,23,0.10526315789473684,0.8947368421052632,0.6973684210526315,0.3026315789473684,64,0,47,17,62,2,0.0,0.734375,0.265625,0.96875,0.03125
8437,46,7,39,20,26,0.15217391304347827,0.8478260869565217,0.43478260869565216,0.5652173913043478,63,0,48,15,61,2,0.0,0.7619047619047619,0.23809523809523808,0.9682539682539683,0.031746031746031744
8438,76,7,69,52,24,0.09210526315789473,0.9078947368421053,0.6842105263157895,0.3157894736842105,66,0,48,18,64,2,0.0,0.7272727272727273,0.2727272727272727,0.9696969696969697,0.030303030303030304
8439,45,33,12,18,27,0.7333333333333333,0.26666666666666666,0.4,0.6,226,0,8,218,215,11,0.0,0.035398230088495575,0.9646017699115044,0.9513274336283186,0.048672566371681415
8440,80,11,69,52,28,0.1375,0.8625,0.65,0.35,63,0,46,17,61,2,0.0,0.7301587301587301,0.2698412698412698,0.9682539682539683,0.031746031746031744
8441,196,194,2,193,3,0.9897959183673469,0.01020408163265306,0.9846938775510204,0.015306122448979591,166,0,142,24,80,86,0.0,0.8554216867469879,0.14457831325301204,0.4819277108433735,0.5180722891566265
8442,78,9,69,51,27,0.11538461538461539,0.8846153846153846,0.6538461538461539,0.34615384615384615,64,0,47,17,62,2,0.0,0.734375,0.265625,0.96875,0.03125
8443,0,0,0,0,0,0.0,0.0,0.0,0.0,0,0,0,0,0,0,0.0,0.0,0.0,0.0,0.0
8444,78,9,69,52,26,0.11538461538461539,0.8846153846153846,0.6666666666666666,0.3333333333333333,66,0,48,18,64,2,0.0,0.7272727272727273,0.2727272727272727,0.9696969696969697,0.030303030303030304
8445,243,241,2,238,5,0.9917695473251029,0.00823045267489712,0.9794238683127572,0.0205761316872428,452,0,420,32,440,12,0.0,0.9292035398230089,0.07079646017699115,0.9734513274336283,0.02654867256637168
8446,78,8,70,53,25,0.10256410256410256,0.8974358974358975,0.6794871794871795,0.32051282051282054,63,0,46,17,61,2,0.0,0.7301587301587301,0.2698412698412698,0.9682539682539683,0.031746031746031744
8447,82,12,70,51,31,0.14634146341463414,0.8536585365853658,0.6219512195121951,0.3780487804878049,66,0,48,18,64,2,0.0,0.7272727272727273,0.2727272727272727,0.9696969696969697,0.030303030303030304
8448,77,7,70,52,25,0.09090909090909091,0.9090909090909091,0.6753246753246753,0.3246753246753247,64,0,46,18,62,2,0.0,0.71875,0.28125,0.96875,0.03125
8449,77,7,70,51,26,0.09090909090909091,0.9090909090909091,0.6623376623376623,0.33766233766233766,64,0,46,18,62,2,0.0,0.71875,0.28125,0.96875,0.03125
8450,80,10,70,51,29,0.125,0.875,0.6375,0.3625,64,0,47,17,62,2,0.0,0.734375,0.265625,0.96875,0.03125
8451,79,10,69,53,26,0.12658227848101267,0.8734177215189873,0.6708860759493671,0.3291139240506329,64,0,46,18,62,2,0.0,0.71875,0.28125,0.96875,0.03125
8452,79,9,70,51,28,0.11392405063291139,0.8860759493670886,0.6455696202531646,0.35443037974683544,66,0,48,18,64,2,0.0,0.7272727272727273,0.2727272727272727,0.9696969696969697,0.030303030303030304
8453,52,13,39,27,25,0.25,0.75,0.5192307692307693,0.4807692307692308,120,0,48,72,117,3,0.0,0.4,0.6,0.975,0.025
8454,44,5,39,21,23,0.11363636363636363,0.8863636363636364,0.4772727272727273,0.5227272727272727,113,0,48,65,110,3,0.0,0.4247787610619469,0.5752212389380531,0.9734513274336283,0.02654867256637168
8455,251,249,2,246,5,0.9920318725099602,0.00796812749003984,0.9800796812749004,0.0199203187250996,583,0,568,15,74,509,0.0,0.9742710120068611,0.025728987993138937,0.1269296740994854,0.8730703259005146
8456,74,4,70,52,22,0.05405405405405406,0.9459459459459459,0.7027027027027027,0.2972972972972973,64,0,46,18,62,2,0.0,0.71875,0.28125,0.96875,0.03125
8457,79,9,70,52,27,0.11392405063291139,0.8860759493670886,0.6582278481012658,0.34177215189873417,64,0,46,18,62,2,0.0,0.71875,0.28125,0.96875,0.03125
8458,0,0,0,0,0,0.0,0.0,0.0,0.0,0,0,0,0,0,0,0.0,0.0,0.0,0.0,0.0
8459,305,303,2,281,24,0.9934426229508196,0.006557377049180328,0.921311475409836,0.07868852459016394,181,0,164,17,85,96,0.0,0.9060773480662984,0.09392265193370165,0.4696132596685083,0.5303867403314917
8460,46,7,39,21,25,0.15217391304347827,0.8478260869565217,0.45652173913043476,0.5434782608695652,64,0,48,16,62,2,0.0,0.75,0.25,0.96875,0.03125
8461,45,6,39,18,27,0.13333333333333333,0.8666666666666667,0.4,0.6,62,0,46,16,60,2,0.0,0.7419354838709677,0.25806451612903225,0.967741935483871,0.03225806451612903
8462,81,11,70,53,28,0.13580246913580246,0.8641975308641975,0.654320987654321,0.345679012345679,66,0,48,18,64,2,0.0,0.7272727272727273,0.2727272727272727,0.9696969696969697,0.030303030303030304
8463,82,13,69,51,31,0.15853658536585366,0.8414634146341463,0.6219512195121951,0.3780487804878049,65,0,47,18,63,2,0.0,0.7230769230769231,0.27692307692307694,0.9692307692307692,0.03076923076923077
8464,1,1,0,0,1,1.0,0.0,0.0,1.0,0,0,0,0,0,0,0.0,0.0,0.0,0.0,0.0
8465,3,3,0,1,2,1.0,0.0,0.3333333333333333,0.6666666666666666,0,0,0,0,0,0,0.0,0.0,0.0,0.0,0.0
8466,51,12,39,19,32,0.23529411764705882,0.7647058823529411,0.37254901960784315,0.6274509803921569,62,0,47,15,60,2,0.0,0.7580645161290323,0.24193548387096775,0.967741935483871,0.03225806451612903
8467,77,8,69,51,26,0.1038961038961039,0.8961038961038961,0.6623376623376623,0.33766233766233766,64,0,46,18,62,2,0.0,0.71875,0.28125,0.96875,0.03125
8468,77,9,68,51,26,0.11688311688311688,0.8831168831168831,0.6623376623376623,0.33766233766233766,63,0,16,47,61,2,0.0,0.25396825396825395,0.746031746031746,0.9682539682539683,0.031746031746031744
8469,73,6,67,49,24,0.0821917808219178,0.9178082191780822,0.6712328767123288,0.3287671232876712,64,0,46,18,62,2,0.0,0.71875,0.28125,0.96875,0.03125
8470,46,7,39,22,24,0.15217391304347827,0.8478260869565217,0.4782608695652174,0.5217391304347826,62,0,46,16,60,2,0.0,0.7419354838709677,0.25806451612903225,0.967741935483871,0.03225806451612903
8471,81,11,70,56,25,0.13580246913580246,0.8641975308641975,0.691358024691358,0.30864197530864196,66,0,48,18,64,2,0.0,0.7272727272727273,0.2727272727272727,0.9696969696969697,0.030303030303030304
8472,49,10,39,19,30,0.20408163265306123,0.7959183673469388,0.3877551020408163,0.6122448979591837,63,0,48,15,61,2,0.0,0.7619047619047619,0.23809523809523808,0.9682539682539683,0.031746031746031744
8473,2,2,0,2,0,1.0,0.0,1.0,0.0,0,0,0,0,0,0,0.0,0.0,0.0,0.0,0.0
8474,77,7,70,55,22,0.09090909090909091,0.9090909090909091,0.7142857142857143,0.2857142857142857,64,0,46,18,62,2,0.0,0.71875,0.28125,0.96875,0.03125
8475,75,6,69,51,24,0.08,0.92,0.68,0.32,64,0,46,18,62,2,0.0,0.71875,0.28125,0.96875,0.03125
8476,78,9,69,51,27,0.11538461538461539,0.8846153846153846,0.6538461538461539,0.34615384615384615,64,0,46,18,62,2,0.0,0.71875,0.28125,0.96875,0.03125
8477,77,8,69,55,22,0.1038961038961039,0.8961038961038961,0.7142857142857143,0.2857142857142857,66,0,48,18,64,2,0.0,0.7272727272727273,0.2727272727272727,0.9696969696969697,0.030303030303030304
8478,81,11,70,50,31,0.13580246913580246,0.8641975308641975,0.6172839506172839,0.38271604938271603,65,0,48,17,63,2,0.0,0.7384615384615385,0.26153846153846155,0.9692307692307692,0.03076923076923077
8479,79,9,70,51,28,0.11392405063291139,0.8860759493670886,0.6455696202531646,0.35443037974683544,63,0,46,17,61,2,0.0,0.7301587301587301,0.2698412698412698,0.9682539682539683,0.031746031746031744
8480,79,10,69,49,30,0.12658227848101267,0.8734177215189873,0.620253164556962,0.379746835443038,64,0,46,18,62,2,0.0,0.71875,0.28125,0.96875,0.03125
8481,72,3,69,53,19,0.041666666666666664,0.9583333333333334,0.7361111111111112,0.2638888888888889,64,0,47,17,62,2,0.0,0.734375,0.265625,0.96875,0.03125
8482,79,9,70,50,29,0.11392405063291139,0.8860759493670886,0.6329113924050633,0.3670886075949367,62,0,46,16,60,2,0.0,0.7419354838709677,0.25806451612903225,0.967741935483871,0.03225806451612903
8483,279,277,2,274,5,0.992831541218638,0.007168458781362007,0.982078853046595,0.017921146953405017,185,0,153,32,89,96,0.0,0.827027027027027,0.17297297297297298,0.4810810810810811,0.518918918918919
8484,45,6,39,25,20,0.13333333333333333,0.8666666666666667,0.5555555555555556,0.4444444444444444,64,0,48,16,62,2,0.0,0.75,0.25,0.96875,0.03125
8485,78,8,70,49,29,0.10256410256410256,0.8974358974358975,0.6282051282051282,0.3717948717948718,65,0,47,18,63,2,0.0,0.7230769230769231,0.27692307692307694,0.9692307692307692,0.03076923076923077
8486,75,5,70,54,21,0.06666666666666667,0.9333333333333333,0.72,0.28,65,0,47,18,63,2,0.0,0.7230769230769231,0.27692307692307694,0.9692307692307692,0.03076923076923077
8487,79,9,70,50,29,0.11392405063291139,0.8860759493670886,0.6329113924050633,0.3670886075949367,62,0,46,16,60,2,0.0,0.7419354838709677,0.25806451612903225,0.967741935483871,0.03225806451612903
8488,47,8,39,24,23,0.1702127659574468,0.8297872340425532,0.5106382978723404,0.48936170212765956,64,0,48,16,62,2,0.0,0.75,0.25,0.96875,0.03125
8489,82,12,70,49,33,0.14634146341463414,0.8536585365853658,0.5975609756097561,0.4024390243902439,64,0,46,18,62,2,0.0,0.71875,0.28125,0.96875,0.03125
8490,269,267,2,247,22,0.9925650557620818,0.007434944237918215,0.9182156133828996,0.08178438661710037,461,0,442,19,458,3,0.0,0.9587852494577006,0.04121475054229935,0.9934924078091106,0.006507592190889371
8491,247,245,2,243,4,0.9919028340080972,0.008097165991902834,0.9838056680161943,0.016194331983805668,572,0,532,40,558,14,0.0,0.9300699300699301,0.06993006993006994,0.9755244755244755,0.024475524475524476
8492,74,4,70,51,23,0.05405405405405406,0.9459459459459459,0.6891891891891891,0.3108108108108108,64,0,46,18,62,2,0.0,0.71875,0.28125,0.96875,0.03125
8493,77,9,68,52,25,0.11688311688311688,0.8831168831168831,0.6753246753246753,0.3246753246753247,62,0,45,17,60,2,0.0,0.7258064516129032,0.27419354838709675,0.967741935483871,0.03225806451612903
8494,250,248,2,246,4,0.992,0.008,0.984,0.016,628,0,585,43,611,17,0.0,0.9315286624203821,0.06847133757961783,0.9729299363057324,0.027070063694267517
8495,77,7,70,53,24,0.09090909090909091,0.9090909090909091,0.6883116883116883,0.3116883116883117,63,0,46,17,61,2,0.0,0.7301587301587301,0.2698412698412698,0.9682539682539683,0.031746031746031744
8496,75,5,70,53,22,0.06666666666666667,0.9333333333333333,0.7066666666666667,0.29333333333333333,63,0,46,17,61,2,0.0,0.7301587301587301,0.2698412698412698,0.9682539682539683,0.031746031746031744
8497,241,239,2,237,4,0.991701244813278,0.008298755186721992,0.983402489626556,0.016597510373443983,556,0,517,39,542,14,0.0,0.9298561151079137,0.07014388489208633,0.9748201438848921,0.025179856115107913
8498,261,259,2,256,5,0.9923371647509579,0.007662835249042145,0.9808429118773946,0.019157088122605363,307,0,277,30,296,11,0.0,0.9022801302931596,0.09771986970684039,0.9641693811074918,0.035830618892508145
8499,79,10,69,50,29,0.12658227848101267,0.8734177215189873,0.6329113924050633,0.3670886075949367,63,0,46,17,61,2,0.0,0.7301587301587301,0.2698412698412698,0.9682539682539683,0.031746031746031744
8500,296,294,2,293,3,0.9932432432432432,0.006756756756756757,0.9898648648648649,0.010135135135135136,620,0,576,44,604,16,0.0,0.9290322580645162,0.07096774193548387,0.9741935483870968,0.025806451612903226
8501,77,7,70,51,26,0.09090909090909091,0.9090909090909091,0.6623376623376623,0.33766233766233766,64,0,47,17,62,2,0.0,0.734375,0.265625,0.96875,0.03125
8502,44,5,39,17,27,0.11363636363636363,0.8863636363636364,0.38636363636363635,0.6136363636363636,62,0,46,16,60,2,0.0,0.7419354838709677,0.25806451612903225,0.967741935483871,0.03225806451612903
8503,81,11,70,49,32,0.13580246913580246,0.8641975308641975,0.6049382716049383,0.3950617283950617,65,0,47,18,63,2,0.0,0.7230769230769231,0.27692307692307694,0.9692307692307692,0.03076923076923077
8504,75,5,70,51,24,0.06666666666666667,0.9333333333333333,0.68,0.32,63,0,46,17,61,2,0.0,0.7301587301587301,0.2698412698412698,0.9682539682539683,0.031746031746031744
8505,263,261,2,259,4,0.9923954372623575,0.0076045627376425855,0.9847908745247148,0.015209125475285171,521,0,485,36,507,14,0.0,0.9309021113243762,0.0690978886756238,0.9731285988483686,0.026871401151631478
8506,73,4,69,52,21,0.0547945205479452,0.9452054794520548,0.7123287671232876,0.2876712328767123,63,0,16,47,61,2,0.0,0.25396825396825395,0.746031746031746,0.9682539682539683,0.031746031746031744
8507,78,9,69,49,29,0.11538461538461539,0.8846153846153846,0.6282051282051282,0.3717948717948718,64,0,46,18,62,2,0.0,0.71875,0.28125,0.96875,0.03125
8508,47,8,39,23,24,0.1702127659574468,0.8297872340425532,0.48936170212765956,0.5106382978723404,64,0,48,16,62,2,0.0,0.75,0.25,0.96875,0.03125
8509,75,6,69,50,25,0.08,0.92,0.6666666666666666,0.3333333333333333,64,0,46,18,62,2,0.0,0.71875,0.28125,0.96875,0.03125
8510,243,241,2,219,24,0.9917695473251029,0.00823045267489712,0.9012345679012346,0.09876543209876543,667,0,650,17,70,597,0.0,0.974512743628186,0.025487256371814093,0.10494752623688156,0.8950524737631185
8511,78,8,70,51,27,0.10256410256410256,0.8974358974358975,0.6538461538461539,0.34615384615384615,66,0,48,18,64,2,0.0,0.7272727272727273,0.2727272727272727,0.9696969696969697,0.030303030303030304
8512,27389,22016,5373,22178,5211,0.8038263536456242,0.19617364635437584,0.8097411369527913,0.19025886304720874,8807,802,750,7255,6165,2642,0.09106392642216418,0.08515953219030317,0.8237765413875326,0.7000113546042921,0.29998864539570796
8513,48,9,39,19,29,0.1875,0.8125,0.3958333333333333,0.6041666666666666,64,0,48,16,62,2,0.0,0.75,0.25,0.96875,0.03125
8514,226,224,2,223,3,0.9911504424778761,0.008849557522123894,0.9867256637168141,0.01327433628318584,516,0,499,17,81,435,0.0,0.9670542635658915,0.03294573643410853,0.1569767441860465,0.8430232558139535
8515,76,7,69,48,28,0.09210526315789473,0.9078947368421053,0.631578947368421,0.3684210526315789,63,0,16,47,61,2,0.0,0.25396825396825395,0.746031746031746,0.9682539682539683,0.031746031746031744
8516,77,8,69,52,25,0.1038961038961039,0.8961038961038961,0.6753246753246753,0.3246753246753247,65,0,47,18,63,2,0.0,0.7230769230769231,0.27692307692307694,0.9692307692307692,0.03076923076923077
8517,76,6,70,55,21,0.07894736842105263,0.9210526315789473,0.7236842105263158,0.27631578947368424,64,0,46,18,62,2,0.0,0.71875,0.28125,0.96875,0.03125
8518,78,8,70,52,26,0.10256410256410256,0.8974358974358975,0.6666666666666666,0.3333333333333333,64,0,46,18,62,2,0.0,0.71875,0.28125,0.96875,0.03125
8519,74,5,69,49,25,0.06756756756756757,0.9324324324324325,0.6621621621621622,0.33783783783783783,63,0,46,17,61,2,0.0,0.7301587301587301,0.2698412698412698,0.9682539682539683,0.031746031746031744
8520,77,7,70,54,23,0.09090909090909091,0.9090909090909091,0.7012987012987013,0.2987012987012987,65,0,47,18,63,2,0.0,0.7230769230769231,0.27692307692307694,0.9692307692307692,0.03076923076923077
8521,80,12,68,51,29,0.15,0.85,0.6375,0.3625,66,0,48,18,64,2,0.0,0.7272727272727273,0.2727272727272727,0.9696969696969697,0.030303030303030304
8522,78,8,70,57,21,0.10256410256410256,0.8974358974358975,0.7307692307692307,0.2692307692307692,65,0,47,18,63,2,0.0,0.7230769230769231,0.27692307692307694,0.9692307692307692,0.03076923076923077
8523,208,206,2,204,4,0.9903846153846154,0.009615384615384616,0.9807692307692307,0.019230769230769232,408,0,392,16,59,349,0.0,0.9607843137254902,0.0392156862745098,0.14460784313725492,0.8553921568627451
8524,47,8,39,22,25,0.1702127659574468,0.8297872340425532,0.46808510638297873,0.5319148936170213,119,0,47,72,116,3,0.0,0.3949579831932773,0.6050420168067226,0.9747899159663865,0.025210084033613446
8525,43,4,39,18,25,0.09302325581395349,0.9069767441860465,0.4186046511627907,0.5813953488372093,62,0,48,14,60,2,0.0,0.7741935483870968,0.22580645161290322,0.967741935483871,0.03225806451612903
8526,288,286,2,265,23,0.9930555555555556,0.006944444444444444,0.9201388888888888,0.0798611111111111,429,0,412,17,427,2,0.0,0.9603729603729604,0.039627039627039624,0.9953379953379954,0.004662004662004662
8527,45,6,39,21,24,0.13333333333333333,0.8666666666666667,0.4666666666666667,0.5333333333333333,119,0,48,71,116,3,0.0,0.40336134453781514,0.5966386554621849,0.9747899159663865,0.025210084033613446
8528,49,10,39,20,29,0.20408163265306123,0.7959183673469388,0.40816326530612246,0.5918367346938775,120,0,48,72,117,3,0.0,0.4,0.6,0.975,0.025
8529,46,7,39,21,25,0.15217391304347827,0.8478260869565217,0.45652173913043476,0.5434782608695652,61,0,48,13,59,2,0.0,0.7868852459016393,0.21311475409836064,0.9672131147540983,0.03278688524590164
8530,77,8,69,53,24,0.1038961038961039,0.8961038961038961,0.6883116883116883,0.3116883116883117,65,0,47,18,63,2,0.0,0.7230769230769231,0.27692307692307694,0.9692307692307692,0.03076923076923077
8531,77,7,70,51,26,0.09090909090909091,0.9090909090909091,0.6623376623376623,0.33766233766233766,65,0,47,18,63,2,0.0,0.7230769230769231,0.27692307692307694,0.9692307692307692,0.03076923076923077
8532,80,10,70,54,26,0.125,0.875,0.675,0.325,64,0,46,18,62,2,0.0,0.71875,0.28125,0.96875,0.03125
8533,78,8,70,51,27,0.10256410256410256,0.8974358974358975,0.6538461538461539,0.34615384615384615,64,0,16,48,62,2,0.0,0.25,0.75,0.96875,0.03125
8534,76,6,70,52,24,0.07894736842105263,0.9210526315789473,0.6842105263157895,0.3157894736842105,66,0,48,18,64,2,0.0,0.7272727272727273,0.2727272727272727,0.9696969696969697,0.030303030303030304
8535,80,11,69,50,30,0.1375,0.8625,0.625,0.375,66,0,48,18,64,2,0.0,0.7272727272727273,0.2727272727272727,0.9696969696969697,0.030303030303030304
8536,43,4,39,19,24,0.09302325581395349,0.9069767441860465,0.4418604651162791,0.5581395348837209,64,0,48,16,62,2,0.0,0.75,0.25,0.96875,0.03125
8537,74,4,70,50,24,0.05405405405405406,0.9459459459459459,0.6756756756756757,0.32432432432432434,63,0,16,47,61,2,0.0,0.25396825396825395,0.746031746031746,0.9682539682539683,0.031746031746031744
8538,280,278,2,257,23,0.9928571428571429,0.007142857142857143,0.9178571428571428,0.08214285714285714,629,0,612,17,626,3,0.0,0.972972972972973,0.02702702702702703,0.9952305246422893,0.0047694753577106515
8539,77,7,70,51,26,0.09090909090909091,0.9090909090909091,0.6623376623376623,0.33766233766233766,64,0,46,18,62,2,0.0,0.71875,0.28125,0.96875,0.03125
8540,79,10,69,54,25,0.12658227848101267,0.8734177215189873,0.6835443037974683,0.31645569620253167,65,0,47,18,63,2,0.0,0.7230769230769231,0.27692307692307694,0.9692307692307692,0.03076923076923077
8541,76,6,70,53,23,0.07894736842105263,0.9210526315789473,0.6973684210526315,0.3026315789473684,65,0,47,18,63,2,0.0,0.7230769230769231,0.27692307692307694,0.9692307692307692,0.03076923076923077
8542,75,5,70,48,27,0.06666666666666667,0.9333333333333333,0.64,0.36,64,0,46,18,62,2,0.0,0.71875,0.28125,0.96875,0.03125
8543,76,9,67,53,23,0.11842105263157894,0.881578947368421,0.6973684210526315,0.3026315789473684,65,0,47,18,63,2,0.0,0.7230769230769231,0.27692307692307694,0.9692307692307692,0.03076923076923077
8544,74,4,70,49,25,0.05405405405405406,0.9459459459459459,0.6621621621621622,0.33783783783783783,66,0,48,18,64,2,0.0,0.7272727272727273,0.2727272727272727,0.9696969696969697,0.030303030303030304
8545,0,0,0,0,0,0.0,0.0,0.0,0.0,0,0,0,0,0,0,0.0,0.0,0.0,0.0,0.0
8546,76,6,70,56,20,0.07894736842105263,0.9210526315789473,0.7368421052631579,0.2631578947368421,63,0,46,17,61,2,0.0,0.7301587301587301,0.2698412698412698,0.9682539682539683,0.031746031746031744
8547,80,10,70,47,33,0.125,0.875,0.5875,0.4125,65,0,47,18,63,2,0.0,0.7230769230769231,0.27692307692307694,0.9692307692307692,0.03076923076923077
8548,0,0,0,0,0,0.0,0.0,0.0,0.0,0,0,0,0,0,0,0.0,0.0,0.0,0.0,0.0
8549,77,7,70,51,26,0.09090909090909091,0.9090909090909091,0.6623376623376623,0.33766233766233766,65,0,47,18,63,2,0.0,0.7230769230769231,0.27692307692307694,0.9692307692307692,0.03076923076923077
8550,77,8,69,53,24,0.1038961038961039,0.8961038961038961,0.6883116883116883,0.3116883116883117,65,0,47,18,63,2,0.0,0.7230769230769231,0.27692307692307694,0.9692307692307692,0.03076923076923077
8551,81,11,70,52,29,0.13580246913580246,0.8641975308641975,0.6419753086419753,0.35802469135802467,65,0,47,18,63,2,0.0,0.7230769230769231,0.27692307692307694,0.9692307692307692,0.03076923076923077
8552,80,11,69,53,27,0.1375,0.8625,0.6625,0.3375,65,0,47,18,63,2,0.0,0.7230769230769231,0.27692307692307694,0.9692307692307692,0.03076923076923077
8553,75,6,69,53,22,0.08,0.92,0.7066666666666667,0.29333333333333333,65,0,47,18,63,2,0.0,0.7230769230769231,0.27692307692307694,0.9692307692307692,0.03076923076923077
8554,266,264,2,244,22,0.9924812030075187,0.007518796992481203,0.9172932330827067,0.08270676691729323,264,0,248,16,65,199,0.0,0.9393939393939394,0.06060606060606061,0.24621212121212122,0.7537878787878788
8555,78,8,70,52,26,0.10256410256410256,0.8974358974358975,0.6666666666666666,0.3333333333333333,64,0,48,16,62,2,0.0,0.75,0.25,0.96875,0.03125
8556,183,181,2,178,5,0.9890710382513661,0.01092896174863388,0.9726775956284153,0.0273224043715847,354,0,338,16,352,2,0.0,0.9548022598870056,0.04519774011299435,0.9943502824858758,0.005649717514124294
8557,76,6,70,54,22,0.07894736842105263,0.9210526315789473,0.7105263157894737,0.2894736842105263,65,0,47,18,63,2,0.0,0.7230769230769231,0.27692307692307694,0.9692307692307692,0.03076923076923077
8558,80,12,68,50,30,0.15,0.85,0.625,0.375,64,0,47,17,62,2,0.0,0.734375,0.265625,0.96875,0.03125
8559,42,3,39,21,21,0.07142857142857142,0.9285714285714286,0.5,0.5,64,0,48,16,62,2,0.0,0.75,0.25,0.96875,0.03125
8560,77,9,68,50,27,0.11688311688311688,0.8831168831168831,0.6493506493506493,0.35064935064935066,65,0,48,17,63,2,0.0,0.7384615384615385,0.26153846153846155,0.9692307692307692,0.03076923076923077
8561,1,1,0,1,0,1.0,0.0,1.0,0.0,0,0,0,0,0,0,0.0,0.0,0.0,0.0,0.0
8562,77,7,70,52,25,0.09090909090909091,0.9090909090909091,0.6753246753246753,0.3246753246753247,65,0,47,18,63,2,0.0,0.7230769230769231,0.27692307692307694,0.9692307692307692,0.03076923076923077
8563,47,8,39,22,25,0.1702127659574468,0.8297872340425532,0.46808510638297873,0.5319148936170213,64,0,48,16,62,2,0.0,0.75,0.25,0.96875,0.03125
8564,47,8,39,20,27,0.1702127659574468,0.8297872340425532,0.425531914893617,0.574468085106383,63,0,48,15,61,2,0.0,0.7619047619047619,0.23809523809523808,0.9682539682539683,0.031746031746031744
8565,72,3,69,48,24,0.041666666666666664,0.9583333333333334,0.6666666666666666,0.3333333333333333,64,0,46,18,62,2,0.0,0.71875,0.28125,0.96875,0.03125
8566,76,6,70,54,22,0.07894736842105263,0.9210526315789473,0.7105263157894737,0.2894736842105263,64,0,46,18,62,2,0.0,0.71875,0.28125,0.96875,0.03125
8567,49,10,39,22,27,0.20408163265306123,0.7959183673469388,0.4489795918367347,0.5510204081632653,64,0,48,16,62,2,0.0,0.75,0.25,0.96875,0.03125
8568,76,7,69,51,25,0.09210526315789473,0.9078947368421053,0.6710526315789473,0.32894736842105265,66,0,48,18,64,2,0.0,0.7272727272727273,0.2727272727272727,0.9696969696969697,0.030303030303030304
8569,45,6,39,21,24,0.13333333333333333,0.8666666666666667,0.4666666666666667,0.5333333333333333,64,0,48,16,62,2,0.0,0.75,0.25,0.96875,0.03125
8570,80,10,70,52,28,0.125,0.875,0.65,0.35,66,0,48,18,64,2,0.0,0.7272727272727273,0.2727272727272727,0.9696969696969697,0.030303030303030304
8571,254,252,2,249,5,0.9921259842519685,0.007874015748031496,0.9803149606299213,0.01968503937007874,550,0,511,39,534,16,0.0,0.9290909090909091,0.07090909090909091,0.9709090909090909,0.02909090909090909
8572,46,7,39,21,25,0.15217391304347827,0.8478260869565217,0.45652173913043476,0.5434782608695652,63,0,47,16,61,2,0.0,0.746031746031746,0.25396825396825395,0.9682539682539683,0.031746031746031744
8573,219,217,2,214,5,0.9908675799086758,0.0091324200913242,0.9771689497716894,0.0228310502283105,533,0,490,43,516,17,0.0,0.9193245778611632,0.08067542213883677,0.9681050656660413,0.03189493433395872
8574,74,4,70,50,24,0.05405405405405406,0.9459459459459459,0.6756756756756757,0.32432432432432434,63,0,46,17,61,2,0.0,0.7301587301587301,0.2698412698412698,0.9682539682539683,0.031746031746031744
8575,74,6,68,47,27,0.08108108108108109,0.918918918918919,0.6351351351351351,0.36486486486486486,64,0,47,17,62,2,0.0,0.734375,0.265625,0.96875,0.03125
8576,81,12,69,51,30,0.14814814814814814,0.8518518518518519,0.6296296296296297,0.37037037037037035,65,0,47,18,63,2,0.0,0.7230769230769231,0.27692307692307694,0.9692307692307692,0.03076923076923077
8577,76,7,69,50,26,0.09210526315789473,0.9078947368421053,0.6578947368421053,0.34210526315789475,64,0,47,17,62,2,0.0,0.734375,0.265625,0.96875,0.03125
8578,80,11,69,48,32,0.1375,0.8625,0.6,0.4,64,0,47,17,62,2,0.0,0.734375,0.265625,0.96875,0.03125
8579,76,9,67,51,25,0.11842105263157894,0.881578947368421,0.6710526315789473,0.32894736842105265,64,0,46,18,62,2,0.0,0.71875,0.28125,0.96875,0.03125
8580,45,6,39,20,25,0.13333333333333333,0.8666666666666667,0.4444444444444444,0.5555555555555556,64,0,48,16,62,2,0.0,0.75,0.25,0.96875,0.03125
8581,78,8,70,55,23,0.10256410256410256,0.8974358974358975,0.7051282051282052,0.2948717948717949,65,0,47,18,63,2,0.0,0.7230769230769231,0.27692307692307694,0.9692307692307692,0.03076923076923077
8582,240,238,2,217,23,0.9916666666666667,0.008333333333333333,0.9041666666666667,0.09583333333333334,380,0,364,16,63,317,0.0,0.9578947368421052,0.042105263157894736,0.16578947368421051,0.8342105263157895
8583,43,4,39,21,22,0.09302325581395349,0.9069767441860465,0.4883720930232558,0.5116279069767442,120,0,48,72,117,3,0.0,0.4,0.6,0.975,0.025
8584,270,268,2,265,5,0.9925925925925926,0.007407407407407408,0.9814814814814815,0.018518518518518517,346,0,313,33,334,12,0.0,0.9046242774566474,0.0953757225433526,0.9653179190751445,0.03468208092485549
8585,47,8,39,21,26,0.1702127659574468,0.8297872340425532,0.44680851063829785,0.5531914893617021,64,0,48,16,62,2,0.0,0.75,0.25,0.96875,0.03125
8586,43,4,39,18,25,0.09302325581395349,0.9069767441860465,0.4186046511627907,0.5813953488372093,120,0,48,72,117,3,0.0,0.4,0.6,0.975,0.025
8587,74,6,68,56,18,0.08108108108108109,0.918918918918919,0.7567567567567568,0.24324324324324326,66,0,48,18,64,2,0.0,0.7272727272727273,0.2727272727272727,0.9696969696969697,0.030303030303030304
8588,48,9,39,21,27,0.1875,0.8125,0.4375,0.5625,63,0,46,17,61,2,0.0,0.7301587301587301,0.2698412698412698,0.9682539682539683,0.031746031746031744
8589,228,226,2,204,24,0.9912280701754386,0.008771929824561403,0.8947368421052632,0.10526315789473684,166,0,151,15,60,106,0.0,0.9096385542168675,0.09036144578313253,0.3614457831325301,0.6385542168674698
8590,219,217,2,214,5,0.9908675799086758,0.0091324200913242,0.9771689497716894,0.0228310502283105,410,0,382,28,400,10,0.0,0.9317073170731708,0.06829268292682927,0.975609756097561,0.024390243902439025
8591,49,10,39,21,28,0.20408163265306123,0.7959183673469388,0.42857142857142855,0.5714285714285714,64,0,48,16,62,2,0.0,0.75,0.25,0.96875,0.03125
8592,45,6,39,20,25,0.13333333333333333,0.8666666666666667,0.4444444444444444,0.5555555555555556,63,0,48,15,61,2,0.0,0.7619047619047619,0.23809523809523808,0.9682539682539683,0.031746031746031744
8593,76,6,70,50,26,0.07894736842105263,0.9210526315789473,0.6578947368421053,0.34210526315789475,64,0,47,17,62,2,0.0,0.734375,0.265625,0.96875,0.03125
8594,44,5,39,21,23,0.11363636363636363,0.8863636363636364,0.4772727272727273,0.5227272727272727,63,0,48,15,62,1,0.0,0.7619047619047619,0.23809523809523808,0.9841269841269841,0.015873015873015872
8595,77,7,70,55,22,0.09090909090909091,0.9090909090909091,0.7142857142857143,0.2857142857142857,62,0,17,45,60,2,0.0,0.27419354838709675,0.7258064516129032,0.967741935483871,0.03225806451612903
8596,275,273,2,270,5,0.9927272727272727,0.007272727272727273,0.9818181818181818,0.01818181818181818,374,0,338,36,360,14,0.0,0.9037433155080213,0.0962566844919786,0.9625668449197861,0.0374331550802139
8597,76,6,70,50,26,0.07894736842105263,0.9210526315789473,0.6578947368421053,0.34210526315789475,64,0,46,18,62,2,0.0,0.71875,0.28125,0.96875,0.03125
8598,76,6,70,48,28,0.07894736842105263,0.9210526315789473,0.631578947368421,0.3684210526315789,64,0,16,48,62,2,0.0,0.25,0.75,0.96875,0.03125
8599,78,8,70,54,24,0.10256410256410256,0.8974358974358975,0.6923076923076923,0.3076923076923077,66,0,48,18,64,2,0.0,0.7272727272727273,0.2727272727272727,0.9696969696969697,0.030303030303030304
8600,78,8,70,54,24,0.10256410256410256,0.8974358974358975,0.6923076923076923,0.3076923076923077,65,0,47,18,63,2,0.0,0.7230769230769231,0.27692307692307694,0.9692307692307692,0.03076923076923077
8601,81,11,70,52,29,0.13580246913580246,0.8641975308641975,0.6419753086419753,0.35802469135802467,66,0,48,18,64,2,0.0,0.7272727272727273,0.2727272727272727,0.9696969696969697,0.030303030303030304
8602,79,9,70,55,24,0.11392405063291139,0.8860759493670886,0.6962025316455697,0.3037974683544304,66,0,48,18,64,2,0.0,0.7272727272727273,0.2727272727272727,0.9696969696969697,0.030303030303030304
8603,0,0,0,0,0,0.0,0.0,0.0,0.0,0,0,0,0,0,0,0.0,0.0,0.0,0.0,0.0
8604,48,9,39,21,27,0.1875,0.8125,0.4375,0.5625,64,0,48,16,62,2,0.0,0.75,0.25,0.96875,0.03125
8605,217,215,2,213,4,0.9907834101382489,0.009216589861751152,0.9815668202764977,0.018433179723502304,187,0,162,25,83,104,0.0,0.8663101604278075,0.13368983957219252,0.44385026737967914,0.5561497326203209
8606,76,6,70,55,21,0.07894736842105263,0.9210526315789473,0.7236842105263158,0.27631578947368424,63,0,46,17,61,2,0.0,0.7301587301587301,0.2698412698412698,0.9682539682539683,0.031746031746031744
8607,78,8,70,49,29,0.10256410256410256,0.8974358974358975,0.6282051282051282,0.3717948717948718,64,0,46,18,62,2,0.0,0.71875,0.28125,0.96875,0.03125
8608,254,252,2,231,23,0.9921259842519685,0.007874015748031496,0.9094488188976378,0.09055118110236221,356,0,340,16,60,296,0.0,0.9550561797752809,0.0449438202247191,0.16853932584269662,0.8314606741573034
8609,77,8,69,51,26,0.1038961038961039,0.8961038961038961,0.6623376623376623,0.33766233766233766,65,0,47,18,63,2,0.0,0.7230769230769231,0.27692307692307694,0.9692307692307692,0.03076923076923077
8610,76,7,69,51,25,0.09210526315789473,0.9078947368421053,0.6710526315789473,0.32894736842105265,63,0,16,47,61,2,0.0,0.25396825396825395,0.746031746031746,0.9682539682539683,0.031746031746031744
8611,49,10,39,20,29,0.20408163265306123,0.7959183673469388,0.40816326530612246,0.5918367346938775,63,0,48,15,61,2,0.0,0.7619047619047619,0.23809523809523808,0.9682539682539683,0.031746031746031744
8612,79,9,70,51,28,0.11392405063291139,0.8860759493670886,0.6455696202531646,0.35443037974683544,63,0,16,47,61,2,0.0,0.25396825396825395,0.746031746031746,0.9682539682539683,0.031746031746031744
8613,46,7,39,20,26,0.15217391304347827,0.8478260869565217,0.43478260869565216,0.5652173913043478,64,0,48,16,62,2,0.0,0.75,0.25,0.96875,0.03125
8614,44,5,39,23,21,0.11363636363636363,0.8863636363636364,0.5227272727272727,0.4772727272727273,63,0,48,15,61,2,0.0,0.7619047619047619,0.23809523809523808,0.9682539682539683,0.031746031746031744
8615,76,6,70,48,28,0.07894736842105263,0.9210526315789473,0.631578947368421,0.3684210526315789,66,0,48,18,64,2,0.0,0.7272727272727273,0.2727272727272727,0.9696969696969697,0.030303030303030304
8616,46,7,39,22,24,0.15217391304347827,0.8478260869565217,0.4782608695652174,0.5217391304347826,64,0,48,16,62,2,0.0,0.75,0.25,0.96875,0.03125
8617,77,7,70,49,28,0.09090909090909091,0.9090909090909091,0.6363636363636364,0.36363636363636365,64,0,46,18,62,2,0.0,0.71875,0.28125,0.96875,0.03125
8618,77,7,70,53,24,0.09090909090909091,0.9090909090909091,0.6883116883116883,0.3116883116883117,65,0,47,18,63,2,0.0,0.7230769230769231,0.27692307692307694,0.9692307692307692,0.03076923076923077
8619,78,8,70,54,24,0.10256410256410256,0.8974358974358975,0.6923076923076923,0.3076923076923077,65,0,47,18,63,2,0.0,0.7230769230769231,0.27692307692307694,0.9692307692307692,0.03076923076923077
8620,49,10,39,21,28,0.20408163265306123,0.7959183673469388,0.42857142857142855,0.5714285714285714,64,0,48,16,62,2,0.0,0.75,0.25,0.96875,0.03125
8621,77,7,70,53,24,0.09090909090909091,0.9090909090909091,0.6883116883116883,0.3116883116883117,64,0,46,18,62,2,0.0,0.71875,0.28125,0.96875,0.03125
8622,75,5,70,49,26,0.06666666666666667,0.9333333333333333,0.6533333333333333,0.3466666666666667,65,0,47,18,63,2,0.0,0.7230769230769231,0.27692307692307694,0.9692307692307692,0.03076923076923077
8623,45,6,39,21,24,0.13333333333333333,0.8666666666666667,0.4666666666666667,0.5333333333333333,62,0,48,14,61,1,0.0,0.7741935483870968,0.22580645161290322,0.9838709677419355,0.016129032258064516
8624,77,8,69,52,25,0.1038961038961039,0.8961038961038961,0.6753246753246753,0.3246753246753247,66,0,48,18,64,2,0.0,0.7272727272727273,0.2727272727272727,0.9696969696969697,0.030303030303030304
8625,224,222,2,221,3,0.9910714285714286,0.008928571428571428,0.9866071428571429,0.013392857142857142,161,0,139,22,73,88,0.0,0.8633540372670807,0.13664596273291926,0.453416149068323,0.546583850931677
8626,363,262,101,309,54,0.721763085399449,0.27823691460055094,0.8512396694214877,0.1487603305785124,191,19,60,112,185,6,0.09947643979057591,0.31413612565445026,0.5863874345549738,0.9685863874345549,0.031413612565445025
8627,342,238,104,289,53,0.695906432748538,0.30409356725146197,0.8450292397660819,0.15497076023391812,221,23,67,131,214,7,0.10407239819004525,0.3031674208144796,0.5927601809954751,0.9683257918552036,0.03167420814479638
8628,122,102,20,90,32,0.8360655737704918,0.16393442622950818,0.7377049180327869,0.26229508196721313,259,2,24,233,238,21,0.007722007722007722,0.09266409266409266,0.8996138996138996,0.918918918918919,0.08108108108108109
8629,157,135,22,114,43,0.8598726114649682,0.14012738853503184,0.7261146496815286,0.27388535031847133,224,30,40,154,211,13,0.13392857142857142,0.17857142857142858,0.6875,0.9419642857142857,0.05803571428571429
8630,275,222,53,230,45,0.8072727272727273,0.19272727272727272,0.8363636363636363,0.16363636363636364,161,21,58,82,158,3,0.13043478260869565,0.36024844720496896,0.5093167701863354,0.9813664596273292,0.018633540372670808
8631,375,289,86,332,43,0.7706666666666667,0.22933333333333333,0.8853333333333333,0.11466666666666667,191,19,60,112,185,6,0.09947643979057591,0.31413612565445026,0.5863874345549738,0.9685863874345549,0.031413612565445025
8632,294,248,46,245,49,0.8435374149659864,0.1564625850340136,0.8333333333333334,0.16666666666666666,191,19,60,112,185,6,0.09947643979057591,0.31413612565445026,0.5863874345549738,0.9685863874345549,0.031413612565445025
8633,213,181,32,159,54,0.8497652582159625,0.15023474178403756,0.7464788732394366,0.2535211267605634,361,101,132,128,339,22,0.27977839335180055,0.3656509695290859,0.3545706371191136,0.9390581717451524,0.060941828254847646
8634,1542,1297,245,1262,280,0.8411154345006485,0.15888456549935148,0.8184176394293126,0.1815823605706874,179,41,50,88,174,5,0.22905027932960895,0.27932960893854747,0.49162011173184356,0.9720670391061452,0.027932960893854747
8635,467,386,81,348,119,0.8265524625267666,0.1734475374732334,0.7451820128479657,0.25481798715203424,136,11,20,105,123,13,0.08088235294117647,0.14705882352941177,0.7720588235294118,0.9044117647058824,0.09558823529411764
8636,347,297,50,297,50,0.8559077809798271,0.1440922190201729,0.8559077809798271,0.1440922190201729,191,19,60,112,185,6,0.09947643979057591,0.31413612565445026,0.5863874345549738,0.9685863874345549,0.031413612565445025
8637,414,302,112,365,49,0.7294685990338164,0.27053140096618356,0.8816425120772947,0.11835748792270531,191,19,60,112,185,6,0.09947643979057591,0.31413612565445026,0.5863874345549738,0.9685863874345549,0.031413612565445025
8638,359,244,115,315,44,0.6796657381615598,0.3203342618384401,0.8774373259052924,0.12256267409470752,191,19,60,112,185,6,0.09947643979057591,0.31413612565445026,0.5863874345549738,0.9685863874345549,0.031413612565445025
8639,139,117,22,116,23,0.841726618705036,0.15827338129496402,0.8345323741007195,0.16546762589928057,296,2,24,270,284,12,0.006756756756756757,0.08108108108108109,0.9121621621621622,0.9594594594594594,0.04054054054054054
8640,332,241,91,279,53,0.7259036144578314,0.2740963855421687,0.8403614457831325,0.15963855421686746,193,23,56,114,185,8,0.11917098445595854,0.29015544041450775,0.5906735751295337,0.9585492227979274,0.04145077720207254
8641,302,236,66,250,52,0.7814569536423841,0.2185430463576159,0.8278145695364238,0.17218543046357615,221,23,67,131,214,7,0.10407239819004525,0.3031674208144796,0.5927601809954751,0.9683257918552036,0.03167420814479638
8642,359,246,113,314,45,0.6852367688022284,0.3147632311977716,0.8746518105849582,0.12534818941504178,191,19,60,112,185,6,0.09947643979057591,0.31413612565445026,0.5863874345549738,0.9685863874345549,0.031413612565445025
8643,326,293,33,272,54,0.8987730061349694,0.10122699386503067,0.8343558282208589,0.1656441717791411,4,0,3,1,1,3,0.0,0.75,0.25,0.25,0.75
8644,373,283,90,315,58,0.7587131367292225,0.24128686327077747,0.8445040214477212,0.1554959785522788,221,23,67,131,214,7,0.10407239819004525,0.3031674208144796,0.5927601809954751,0.9683257918552036,0.03167420814479638
8645,309,239,70,260,49,0.7734627831715211,0.22653721682847897,0.8414239482200647,0.15857605177993528,221,23,67,131,214,7,0.10407239819004525,0.3031674208144796,0.5927601809954751,0.9683257918552036,0.03167420814479638
8646,427,313,114,380,47,0.7330210772833724,0.26697892271662765,0.8899297423887588,0.11007025761124122,191,19,60,112,185,6,0.09947643979057591,0.31413612565445026,0.5863874345549738,0.9685863874345549,0.031413612565445025
8647,357,244,113,312,45,0.6834733893557423,0.3165266106442577,0.8739495798319328,0.12605042016806722,191,19,60,112,185,6,0.09947643979057591,0.31413612565445026,0.5863874345549738,0.9685863874345549,0.031413612565445025
8648,330,238,92,279,51,0.7212121212121212,0.2787878787878788,0.8454545454545455,0.15454545454545454,161,21,58,82,158,3,0.13043478260869565,0.36024844720496896,0.5093167701863354,0.9813664596273292,0.018633540372670808
8649,36,36,0,19,17,1.0,0.0,0.5277777777777778,0.4722222222222222,7,0,0,7,6,1,0.0,0.0,1.0,0.8571428571428571,0.14285714285714285
8650,338,245,93,289,49,0.7248520710059172,0.27514792899408286,0.8550295857988166,0.14497041420118342,193,23,56,114,185,8,0.11917098445595854,0.29015544041450775,0.5906735751295337,0.9585492227979274,0.04145077720207254
8651,358,246,112,311,47,0.6871508379888268,0.3128491620111732,0.8687150837988827,0.13128491620111732,191,19,60,112,185,6,0.09947643979057591,0.31413612565445026,0.5863874345549738,0.9685863874345549,0.031413612565445025
8652,377,267,110,319,58,0.7082228116710876,0.2917771883289125,0.8461538461538461,0.15384615384615385,191,19,60,112,185,6,0.09947643979057591,0.31413612565445026,0.5863874345549738,0.9685863874345549,0.031413612565445025
8653,144,118,26,107,37,0.8194444444444444,0.18055555555555555,0.7430555555555556,0.2569444444444444,150,17,35,98,144,6,0.11333333333333333,0.23333333333333334,0.6533333333333333,0.96,0.04
8654,183,156,27,134,49,0.8524590163934426,0.14754098360655737,0.73224043715847,0.2677595628415301,189,27,35,127,177,12,0.14285714285714285,0.18518518518518517,0.671957671957672,0.9365079365079365,0.06349206349206349
8655,326,252,74,276,50,0.7730061349693251,0.22699386503067484,0.8466257668711656,0.15337423312883436,191,19,60,112,185,6,0.09947643979057591,0.31413612565445026,0.5863874345549738,0.9685863874345549,0.031413612565445025
8656,308,237,71,253,55,0.7694805194805194,0.2305194805194805,0.8214285714285714,0.17857142857142858,221,23,67,131,214,7,0.10407239819004525,0.3031674208144796,0.5927601809954751,0.9683257918552036,0.03167420814479638
8657,159,138,21,126,33,0.8679245283018868,0.1320754716981132,0.7924528301886793,0.20754716981132076,323,26,44,253,308,15,0.0804953560371517,0.13622291021671826,0.7832817337461301,0.9535603715170279,0.04643962848297214
8658,281,233,48,232,49,0.8291814946619217,0.1708185053380783,0.8256227758007118,0.17437722419928825,193,23,56,114,185,8,0.11917098445595854,0.29015544041450775,0.5906735751295337,0.9585492227979274,0.04145077720207254
8659,343,237,106,293,50,0.6909620991253644,0.30903790087463556,0.8542274052478134,0.1457725947521866,221,23,67,131,214,7,0.10407239819004525,0.3031674208144796,0.5927601809954751,0.9683257918552036,0.03167420814479638
8660,436,327,109,383,53,0.75,0.25,0.8784403669724771,0.12155963302752294,191,19,60,112,185,6,0.09947643979057591,0.31413612565445026,0.5863874345549738,0.9685863874345549,0.031413612565445025
8661,445,357,88,381,64,0.802247191011236,0.19775280898876405,0.8561797752808988,0.14382022471910114,178,4,55,119,156,22,0.02247191011235955,0.3089887640449438,0.6685393258426966,0.8764044943820225,0.12359550561797752
8662,363,251,112,319,44,0.6914600550964187,0.3085399449035813,0.8787878787878788,0.12121212121212122,191,19,60,112,185,6,0.09947643979057591,0.31413612565445026,0.5863874345549738,0.9685863874345549,0.031413612565445025
8663,338,251,87,289,49,0.742603550295858,0.257396449704142,0.8550295857988166,0.14497041420118342,191,19,60,112,185,6,0.09947643979057591,0.31413612565445026,0.5863874345549738,0.9685863874345549,0.031413612565445025
8664,286,246,40,238,48,0.8601398601398601,0.13986013986013987,0.8321678321678322,0.16783216783216784,191,19,60,112,185,6,0.09947643979057591,0.31413612565445026,0.5863874345549738,0.9685863874345549,0.031413612565445025
8665,209,179,30,164,45,0.8564593301435407,0.14354066985645933,0.784688995215311,0.215311004784689,192,17,25,150,182,10,0.08854166666666667,0.13020833333333334,0.78125,0.9479166666666666,0.052083333333333336
8666,398,286,112,354,44,0.7185929648241206,0.2814070351758794,0.8894472361809045,0.11055276381909548,191,19,60,112,185,6,0.09947643979057591,0.31413612565445026,0.5863874345549738,0.9685863874345549,0.031413612565445025
8667,348,252,96,298,50,0.7241379310344828,0.27586206896551724,0.8563218390804598,0.14367816091954022,191,19,60,112,185,6,0.09947643979057591,0.31413612565445026,0.5863874345549738,0.9685863874345549,0.031413612565445025
8668,362,252,110,310,52,0.6961325966850829,0.30386740331491713,0.856353591160221,0.143646408839779,191,19,60,112,185,6,0.09947643979057591,0.31413612565445026,0.5863874345549738,0.9685863874345549,0.031413612565445025
8669,1258,713,545,1123,135,0.5667726550079492,0.4332273449920509,0.8926868044515104,0.10731319554848967,24,3,10,11,10,14,0.125,0.4166666666666667,0.4583333333333333,0.4166666666666667,0.5833333333333334
8670,287,247,40,243,44,0.8606271777003485,0.13937282229965156,0.8466898954703833,0.15331010452961671,191,19,60,112,185,6,0.09947643979057591,0.31413612565445026,0.5863874345549738,0.9685863874345549,0.031413612565445025
8671,909,732,177,648,261,0.8052805280528053,0.19471947194719472,0.7128712871287128,0.2871287128712871,150,17,41,92,144,6,0.11333333333333333,0.2733333333333333,0.6133333333333333,0.96,0.04
8672,947,795,152,645,302,0.839493136219641,0.16050686378035903,0.6810982048574445,0.31890179514255546,113,17,22,74,102,11,0.1504424778761062,0.19469026548672566,0.6548672566371682,0.9026548672566371,0.09734513274336283
8673,327,236,91,275,52,0.7217125382262997,0.2782874617737003,0.8409785932721713,0.15902140672782875,161,21,58,82,158,3,0.13043478260869565,0.36024844720496896,0.5093167701863354,0.9813664596273292,0.018633540372670808
8674,340,235,105,293,47,0.6911764705882353,0.3088235294117647,0.861764705882353,0.13823529411764707,221,23,67,131,214,7,0.10407239819004525,0.3031674208144796,0.5927601809954751,0.9683257918552036,0.03167420814479638
8675,365,265,100,311,54,0.726027397260274,0.273972602739726,0.852054794520548,0.14794520547945206,221,23,67,131,214,7,0.10407239819004525,0.3031674208144796,0.5927601809954751,0.9683257918552036,0.03167420814479638
8676,83,83,0,65,18,1.0,0.0,0.7831325301204819,0.21686746987951808,3,0,0,3,3,0,0.0,0.0,1.0,1.0,0.0
8677,295,253,42,245,50,0.8576271186440678,0.1423728813559322,0.8305084745762712,0.1694915254237288,191,19,60,112,185,6,0.09947643979057591,0.31413612565445026,0.5863874345549738,0.9685863874345549,0.031413612565445025
8678,365,251,114,319,46,0.6876712328767123,0.31232876712328766,0.873972602739726,0.12602739726027398,191,19,60,112,185,6,0.09947643979057591,0.31413612565445026,0.5863874345549738,0.9685863874345549,0.031413612565445025
8679,309,239,70,265,44,0.7734627831715211,0.22653721682847897,0.8576051779935275,0.1423948220064725,191,19,60,112,185,6,0.09947643979057591,0.31413612565445026,0.5863874345549738,0.9685863874345549,0.031413612565445025
8680,358,246,112,314,44,0.6871508379888268,0.3128491620111732,0.8770949720670391,0.12290502793296089,191,19,60,112,185,6,0.09947643979057591,0.31413612565445026,0.5863874345549738,0.9685863874345549,0.031413612565445025
8681,343,253,90,294,49,0.7376093294460642,0.26239067055393583,0.8571428571428571,0.14285714285714285,191,19,60,112,185,6,0.09947643979057591,0.31413612565445026,0.5863874345549738,0.9685863874345549,0.031413612565445025
8682,319,228,91,270,49,0.7147335423197492,0.2852664576802508,0.8463949843260188,0.1536050156739812,161,21,58,82,158,3,0.13043478260869565,0.36024844720496896,0.5093167701863354,0.9813664596273292,0.018633540372670808
8683,355,243,112,309,46,0.6845070422535211,0.3154929577464789,0.8704225352112676,0.1295774647887324,191,19,60,112,185,6,0.09947643979057591,0.31413612565445026,0.5863874345549738,0.9685863874345549,0.031413612565445025
8684,345,259,86,294,51,0.7507246376811594,0.2492753623188406,0.8521739130434782,0.14782608695652175,191,19,60,112,185,6,0.09947643979057591,0.31413612565445026,0.5863874345549738,0.9685863874345549,0.031413612565445025
8685,405,303,102,355,50,0.7481481481481481,0.2518518518518518,0.8765432098765432,0.12345679012345678,221,23,67,131,214,7,0.10407239819004525,0.3031674208144796,0.5927601809954751,0.9683257918552036,0.03167420814479638
8686,562,438,124,533,29,0.7793594306049823,0.2206405693950178,0.9483985765124555,0.051601423487544484,392,75,136,181,379,13,0.1913265306122449,0.3469387755102041,0.461734693877551,0.9668367346938775,0.03316326530612245
8687,361,251,110,315,46,0.6952908587257618,0.3047091412742382,0.8725761772853186,0.12742382271468145,191,19,60,112,185,6,0.09947643979057591,0.31413612565445026,0.5863874345549738,0.9685863874345549,0.031413612565445025
8688,271,253,18,205,66,0.933579335793358,0.06642066420664207,0.7564575645756457,0.24354243542435425,227,83,75,69,214,13,0.3656387665198238,0.3303964757709251,0.3039647577092511,0.9427312775330396,0.05726872246696035
8689,521,447,74,421,100,0.8579654510556622,0.1420345489443378,0.8080614203454894,0.19193857965451055,98,12,21,65,96,2,0.12244897959183673,0.21428571428571427,0.6632653061224489,0.9795918367346939,0.02040816326530612
8690,356,251,105,306,50,0.7050561797752809,0.2949438202247191,0.8595505617977528,0.1404494382022472,191,19,60,112,185,6,0.09947643979057591,0.31413612565445026,0.5863874345549738,0.9685863874345549,0.031413612565445025
8691,363,259,104,308,55,0.7134986225895317,0.2865013774104683,0.8484848484848485,0.15151515151515152,221,23,67,131,214,7,0.10407239819004525,0.3031674208144796,0.5927601809954751,0.9683257918552036,0.03167420814479638
8692,345,248,97,299,46,0.7188405797101449,0.2811594202898551,0.8666666666666667,0.13333333333333333,191,19,60,112,185,6,0.09947643979057591,0.31413612565445026,0.5863874345549738,0.9685863874345549,0.031413612565445025
8693,836,676,160,648,188,0.8086124401913876,0.19138755980861244,0.7751196172248804,0.22488038277511962,100,14,19,67,91,9,0.14,0.19,0.67,0.91,0.09
8694,145,133,12,115,30,0.9172413793103448,0.08275862068965517,0.7931034482758621,0.20689655172413793,185,56,63,66,170,15,0.3027027027027027,0.34054054054054056,0.3567567567567568,0.918918918918919,0.08108108108108109
8695,154,133,21,114,40,0.8636363636363636,0.13636363636363635,0.7402597402597403,0.2597402597402597,207,85,14,108,201,6,0.4106280193236715,0.06763285024154589,0.5217391304347826,0.9710144927536232,0.028985507246376812
8696,376,266,110,329,47,0.7074468085106383,0.2925531914893617,0.875,0.125,191,19,60,112,185,6,0.09947643979057591,0.31413612565445026,0.5863874345549738,0.9685863874345549,0.031413612565445025
8697,357,246,111,308,49,0.6890756302521008,0.31092436974789917,0.8627450980392157,0.13725490196078433,191,19,60,112,185,6,0.09947643979057591,0.31413612565445026,0.5863874345549738,0.9685863874345549,0.031413612565445025
8698,339,248,91,286,53,0.7315634218289085,0.26843657817109146,0.8436578171091446,0.15634218289085547,193,23,56,114,185,8,0.11917098445595854,0.29015544041450775,0.5906735751295337,0.9585492227979274,0.04145077720207254
8699,351,246,105,294,57,0.7008547008547008,0.29914529914529914,0.8376068376068376,0.1623931623931624,221,23,67,131,214,7,0.10407239819004525,0.3031674208144796,0.5927601809954751,0.9683257918552036,0.03167420814479638
8700,346,259,87,291,55,0.7485549132947977,0.2514450867052023,0.8410404624277457,0.15895953757225434,191,19,60,112,185,6,0.09947643979057591,0.31413612565445026,0.5863874345549738,0.9685863874345549,0.031413612565445025
8701,328,307,21,297,31,0.9359756097560976,0.06402439024390244,0.9054878048780488,0.09451219512195122,274,105,103,66,261,13,0.38321167883211676,0.3759124087591241,0.24087591240875914,0.9525547445255474,0.04744525547445255
8702,442,332,110,390,52,0.751131221719457,0.248868778280543,0.8823529411764706,0.11764705882352941,191,19,60,112,185,6,0.09947643979057591,0.31413612565445026,0.5863874345549738,0.9685863874345549,0.031413612565445025
8703,429,371,58,375,54,0.8648018648018648,0.1351981351981352,0.8741258741258742,0.1258741258741259,191,19,60,112,185,6,0.09947643979057591,0.31413612565445026,0.5863874345549738,0.9685863874345549,0.031413612565445025
8704,459,378,81,342,117,0.8235294117647058,0.17647058823529413,0.7450980392156863,0.2549019607843137,96,12,19,65,85,11,0.125,0.19791666666666666,0.6770833333333334,0.8854166666666666,0.11458333333333333
8705,315,249,66,266,49,0.7904761904761904,0.20952380952380953,0.8444444444444444,0.15555555555555556,191,19,60,112,185,6,0.09947643979057591,0.31413612565445026,0.5863874345549738,0.9685863874345549,0.031413612565445025
8706,13909,13897,12,13888,21,0.9991372492630671,0.0008627507369329212,0.9984901862103673,0.001509813789632612,114,2,5,107,112,2,0.017543859649122806,0.043859649122807015,0.9385964912280702,0.9824561403508771,0.017543859649122806
8707,336,271,65,284,52,0.8065476190476191,0.19345238095238096,0.8452380952380952,0.15476190476190477,191,19,60,112,185,6,0.09947643979057591,0.31413612565445026,0.5863874345549738,0.9685863874345549,0.031413612565445025
8708,285,232,53,235,50,0.8140350877192982,0.18596491228070175,0.8245614035087719,0.17543859649122806,161,21,58,82,158,3,0.13043478260869565,0.36024844720496896,0.5093167701863354,0.9813664596273292,0.018633540372670808
8709,500,301,199,268,232,0.602,0.398,0.536,0.464,4077,357,1228,2492,2914,1163,0.0875643855776306,0.3012018641157714,0.611233750306598,0.7147412312975227,0.2852587687024773
8710,290,243,47,240,50,0.8379310344827586,0.16206896551724137,0.8275862068965517,0.1724137931034483,221,23,67,131,214,7,0.10407239819004525,0.3031674208144796,0.5927601809954751,0.9683257918552036,0.03167420814479638
8711,297,246,51,249,48,0.8282828282828283,0.1717171717171717,0.8383838383838383,0.16161616161616163,191,19,60,112,185,6,0.09947643979057591,0.31413612565445026,0.5863874345549738,0.9685863874345549,0.031413612565445025
8712,338,237,101,288,50,0.7011834319526628,0.2988165680473373,0.8520710059171598,0.14792899408284024,221,23,67,131,214,7,0.10407239819004525,0.3031674208144796,0.5927601809954751,0.9683257918552036,0.03167420814479638
8713,312,220,92,268,44,0.7051282051282052,0.2948717948717949,0.8589743589743589,0.14102564102564102,161,21,58,82,158,3,0.13043478260869565,0.36024844720496896,0.5093167701863354,0.9813664596273292,0.018633540372670808
8714,332,239,93,282,50,0.7198795180722891,0.28012048192771083,0.8493975903614458,0.15060240963855423,221,23,67,131,214,7,0.10407239819004525,0.3031674208144796,0.5927601809954751,0.9683257918552036,0.03167420814479638
8715,397,294,103,352,45,0.7405541561712846,0.2594458438287154,0.8866498740554156,0.11335012594458438,221,23,67,131,214,7,0.10407239819004525,0.3031674208144796,0.5927601809954751,0.9683257918552036,0.03167420814479638
8716,126,105,21,100,26,0.8333333333333334,0.16666666666666666,0.7936507936507936,0.20634920634920634,227,2,20,205,220,7,0.00881057268722467,0.0881057268722467,0.9030837004405287,0.9691629955947136,0.030837004405286344
8717,353,239,114,311,42,0.6770538243626062,0.32294617563739375,0.8810198300283286,0.11898016997167139,191,19,60,112,185,6,0.09947643979057591,0.31413612565445026,0.5863874345549738,0.9685863874345549,0.031413612565445025
8718,997,849,148,774,223,0.8515546639919759,0.14844533600802406,0.7763289869608826,0.22367101303911735,134,46,61,27,134,0,0.34328358208955223,0.4552238805970149,0.20149253731343283,1.0,0.0
8719,317,257,60,264,53,0.8107255520504731,0.1892744479495268,0.832807570977918,0.167192429022082,191,19,60,112,185,6,0.09947643979057591,0.31413612565445026,0.5863874345549738,0.9685863874345549,0.031413612565445025
8720,173,127,46,107,66,0.7341040462427746,0.2658959537572254,0.6184971098265896,0.3815028901734104,160,3,5,152,116,44,0.01875,0.03125,0.95,0.725,0.275
8721,362,256,106,307,55,0.7071823204419889,0.292817679558011,0.8480662983425414,0.15193370165745856,191,19,60,112,185,6,0.09947643979057591,0.31413612565445026,0.5863874345549738,0.9685863874345549,0.031413612565445025
8722,36,36,0,19,17,1.0,0.0,0.5277777777777778,0.4722222222222222,7,0,0,7,6,1,0.0,0.0,1.0,0.8571428571428571,0.14285714285714285
8723,157,144,13,117,40,0.9171974522292994,0.08280254777070063,0.7452229299363057,0.25477707006369427,158,50,56,52,150,8,0.31645569620253167,0.35443037974683544,0.3291139240506329,0.9493670886075949,0.05063291139240506
8724,327,251,76,277,50,0.7675840978593272,0.2324159021406728,0.8470948012232415,0.1529051987767584,191,19,60,112,185,6,0.09947643979057591,0.31413612565445026,0.5863874345549738,0.9685863874345549,0.031413612565445025
8725,346,254,92,298,48,0.7341040462427746,0.2658959537572254,0.861271676300578,0.13872832369942195,191,19,60,112,185,6,0.09947643979057591,0.31413612565445026,0.5863874345549738,0.9685863874345549,0.031413612565445025
8726,403,295,108,359,44,0.7320099255583127,0.2679900744416873,0.890818858560794,0.10918114143920596,113,16,19,78,109,4,0.1415929203539823,0.168141592920354,0.6902654867256637,0.9646017699115044,0.035398230088495575
8727,278,230,48,230,48,0.8273381294964028,0.17266187050359713,0.8273381294964028,0.17266187050359713,221,23,67,131,214,7,0.10407239819004525,0.3031674208144796,0.5927601809954751,0.9683257918552036,0.03167420814479638
8728,750,651,99,610,140,0.868,0.132,0.8133333333333334,0.18666666666666668,73,16,15,42,68,5,0.2191780821917808,0.2054794520547945,0.5753424657534246,0.9315068493150684,0.0684931506849315
8729,300,223,77,255,45,0.7433333333333333,0.25666666666666665,0.85,0.15,208,23,64,121,201,7,0.11057692307692307,0.3076923076923077,0.5817307692307693,0.9663461538461539,0.03365384615384615
8730,878,729,149,663,215,0.8302961275626424,0.16970387243735763,0.755125284738041,0.244874715261959,87,15,19,53,77,10,0.1724137931034483,0.21839080459770116,0.6091954022988506,0.8850574712643678,0.11494252873563218
8731,896,750,146,601,295,0.8370535714285714,0.16294642857142858,0.6707589285714286,0.32924107142857145,90,18,19,53,77,13,0.2,0.2111111111111111,0.5888888888888889,0.8555555555555555,0.14444444444444443
8732,903,726,177,646,257,0.8039867109634552,0.19601328903654486,0.7153931339977851,0.28460686600221485,150,17,39,94,142,8,0.11333333333333333,0.26,0.6266666666666667,0.9466666666666667,0.05333333333333334
8733,351,245,106,298,53,0.698005698005698,0.301994301994302,0.8490028490028491,0.150997150997151,221,23,67,131,214,7,0.10407239819004525,0.3031674208144796,0.5927601809954751,0.9683257918552036,0.03167420814479638
8734,358,248,110,310,48,0.6927374301675978,0.30726256983240224,0.8659217877094972,0.1340782122905028,191,19,60,112,185,6,0.09947643979057591,0.31413612565445026,0.5863874345549738,0.9685863874345549,0.031413612565445025
8735,55,1,54,34,21,0.01818181818181818,0.9818181818181818,0.6181818181818182,0.38181818181818183,405,124,68,213,354,51,0.30617283950617286,0.16790123456790124,0.5259259259259259,0.8740740740740741,0.1259259259259259
8736,121,100,21,101,20,0.8264462809917356,0.17355371900826447,0.8347107438016529,0.1652892561983471,124,2,27,95,120,4,0.016129032258064516,0.21774193548387097,0.7661290322580645,0.967741935483871,0.03225806451612903
8737,143,123,20,111,32,0.8601398601398601,0.13986013986013987,0.7762237762237763,0.22377622377622378,263,2,27,234,249,14,0.0076045627376425855,0.10266159695817491,0.8897338403041825,0.9467680608365019,0.053231939163498096
8738,392,284,108,351,41,0.7244897959183674,0.2755102040816326,0.8954081632653061,0.10459183673469388,112,15,20,77,108,4,0.13392857142857142,0.17857142857142858,0.6875,0.9642857142857143,0.03571428571428571
8739,1639,1527,112,1592,47,0.9316656497864552,0.06833435021354485,0.9713239780353874,0.02867602196461257,191,19,60,112,185,6,0.09947643979057591,0.31413612565445026,0.5863874345549738,0.9685863874345549,0.031413612565445025
8740,313,245,68,266,47,0.7827476038338658,0.21725239616613418,0.8498402555910544,0.1501597444089457,191,19,60,112,185,6,0.09947643979057591,0.31413612565445026,0.5863874345549738,0.9685863874345549,0.031413612565445025
8741,422,395,27,385,37,0.9360189573459715,0.06398104265402843,0.9123222748815166,0.08767772511848342,1038,210,469,359,991,47,0.2023121387283237,0.45183044315992293,0.34585741811175336,0.9547206165703276,0.04527938342967245
8742,333,239,94,287,46,0.7177177177177178,0.2822822822822823,0.8618618618618619,0.13813813813813813,193,23,56,114,185,8,0.11917098445595854,0.29015544041450775,0.5906735751295337,0.9585492227979274,0.04145077720207254
8743,450,369,81,333,117,0.82,0.18,0.74,0.26,139,12,20,107,124,15,0.08633093525179857,0.14388489208633093,0.7697841726618705,0.8920863309352518,0.1079136690647482
8744,30,30,0,14,16,1.0,0.0,0.4666666666666667,0.5333333333333333,8,0,0,8,8,0,0.0,0.0,1.0,1.0,0.0
8745,302,254,48,253,49,0.8410596026490066,0.15894039735099338,0.8377483443708609,0.16225165562913907,191,19,60,112,185,6,0.09947643979057591,0.31413612565445026,0.5863874345549738,0.9685863874345549,0.031413612565445025
8746,419,365,54,360,59,0.8711217183770883,0.1288782816229117,0.8591885441527446,0.14081145584725538,60,10,13,37,57,3,0.16666666666666666,0.21666666666666667,0.6166666666666667,0.95,0.05
8747,422,395,27,385,37,0.9360189573459715,0.06398104265402843,0.9123222748815166,0.08767772511848342,1038,210,469,359,991,47,0.2023121387283237,0.45183044315992293,0.34585741811175336,0.9547206165703276,0.04527938342967245
8748,322,227,95,278,44,0.7049689440993789,0.2950310559006211,0.8633540372670807,0.13664596273291926,161,21,58,82,158,3,0.13043478260869565,0.36024844720496896,0.5093167701863354,0.9813664596273292,0.018633540372670808
8749,0,0,0,0,0,0.0,0.0,0.0,0.0,0,0,0,0,0,0,0.0,0.0,0.0,0.0,0.0
8750,360,257,103,310,50,0.7138888888888889,0.2861111111111111,0.8611111111111112,0.1388888888888889,191,19,60,112,185,6,0.09947643979057591,0.31413612565445026,0.5863874345549738,0.9685863874345549,0.031413612565445025
8751,383,270,113,330,53,0.7049608355091384,0.2950391644908616,0.8616187989556136,0.13838120104438642,191,19,60,112,185,6,0.09947643979057591,0.31413612565445026,0.5863874345549738,0.9685863874345549,0.031413612565445025
8752,382,285,97,338,44,0.7460732984293194,0.25392670157068065,0.8848167539267016,0.11518324607329843,191,19,60,112,185,6,0.09947643979057591,0.31413612565445026,0.5863874345549738,0.9685863874345549,0.031413612565445025
8753,323,231,92,280,43,0.7151702786377709,0.2848297213622291,0.8668730650154799,0.13312693498452013,161,21,58,82,158,3,0.13043478260869565,0.36024844720496896,0.5093167701863354,0.9813664596273292,0.018633540372670808
8754,362,249,113,312,50,0.6878453038674033,0.31215469613259667,0.861878453038674,0.13812154696132597,191,19,60,112,185,6,0.09947643979057591,0.31413612565445026,0.5863874345549738,0.9685863874345549,0.031413612565445025
8755,339,252,87,289,50,0.7433628318584071,0.25663716814159293,0.8525073746312685,0.14749262536873156,191,19,60,112,185,6,0.09947643979057591,0.31413612565445026,0.5863874345549738,0.9685863874345549,0.031413612565445025
8756,154,133,21,113,41,0.8636363636363636,0.13636363636363635,0.7337662337662337,0.2662337662337662,335,112,138,85,306,29,0.33432835820895523,0.41194029850746267,0.2537313432835821,0.9134328358208955,0.08656716417910448
8757,0,0,0,0,0,0.0,0.0,0.0,0.0,0,0,0,0,0,0,0.0,0.0,0.0,0.0,0.0
8758,360,247,113,314,46,0.6861111111111111,0.3138888888888889,0.8722222222222222,0.12777777777777777,191,19,60,112,185,6,0.09947643979057591,0.31413612565445026,0.5863874345549738,0.9685863874345549,0.031413612565445025
8759,5251,4082,1169,3628,1623,0.7773757379546753,0.2226242620453247,0.690916015996953,0.30908398400304704,3056,143,677,2236,2498,558,0.046793193717277484,0.22153141361256545,0.731675392670157,0.8174083769633508,0.18259162303664922
8760,329,251,78,278,51,0.7629179331306991,0.23708206686930092,0.8449848024316109,0.15501519756838905,191,19,60,112,185,6,0.09947643979057591,0.31413612565445026,0.5863874345549738,0.9685863874345549,0.031413612565445025
8761,36,36,0,19,17,1.0,0.0,0.5277777777777778,0.4722222222222222,7,0,0,7,6,1,0.0,0.0,1.0,0.8571428571428571,0.14285714285714285
8762,146,123,23,115,31,0.8424657534246576,0.15753424657534246,0.7876712328767124,0.21232876712328766,604,38,82,484,581,23,0.06291390728476821,0.1357615894039735,0.8013245033112583,0.9619205298013245,0.0380794701986755
8763,332,246,86,285,47,0.7409638554216867,0.25903614457831325,0.858433734939759,0.14156626506024098,191,19,60,112,185,6,0.09947643979057591,0.31413612565445026,0.5863874345549738,0.9685863874345549,0.031413612565445025
8764,883,820,63,813,70,0.928652321630804,0.07134767836919592,0.9207248018120046,0.07927519818799547,173,41,50,82,173,0,0.23699421965317918,0.28901734104046245,0.47398843930635837,1.0,0.0
8765,346,240,106,290,56,0.6936416184971098,0.3063583815028902,0.838150289017341,0.16184971098265896,221,23,67,131,214,7,0.10407239819004525,0.3031674208144796,0.5927601809954751,0.9683257918552036,0.03167420814479638
8766,307,255,52,257,50,0.8306188925081434,0.16938110749185667,0.8371335504885994,0.16286644951140064,191,19,60,112,185,6,0.09947643979057591,0.31413612565445026,0.5863874345549738,0.9685863874345549,0.031413612565445025
8767,0,0,0,0,0,0.0,0.0,0.0,0.0,0,0,0,0,0,0,0.0,0.0,0.0,0.0,0.0
8768,333,225,108,283,50,0.6756756756756757,0.32432432432432434,0.8498498498498499,0.15015015015015015,212,23,64,125,205,7,0.10849056603773585,0.3018867924528302,0.589622641509434,0.9669811320754716,0.0330188679245283
8769,325,247,78,277,48,0.76,0.24,0.8523076923076923,0.1476923076923077,191,19,60,112,185,6,0.09947643979057591,0.31413612565445026,0.5863874345549738,0.9685863874345549,0.031413612565445025
8770,8095,7026,1069,6675,1420,0.8679431747992588,0.1320568252007412,0.8245830759728228,0.17541692402717726,1632,170,372,1090,1219,413,0.10416666666666667,0.22794117647058823,0.6678921568627451,0.7469362745098039,0.25306372549019607
8771,334,224,110,284,50,0.6706586826347305,0.32934131736526945,0.8502994011976048,0.1497005988023952,212,23,64,125,205,7,0.10849056603773585,0.3018867924528302,0.589622641509434,0.9669811320754716,0.0330188679245283
8772,357,248,109,313,44,0.6946778711484594,0.30532212885154064,0.876750700280112,0.12324929971988796,191,19,60,112,185,6,0.09947643979057591,0.31413612565445026,0.5863874345549738,0.9685863874345549,0.031413612565445025
8773,356,245,111,310,46,0.6882022471910112,0.31179775280898875,0.8707865168539326,0.12921348314606743,191,19,60,112,185,6,0.09947643979057591,0.31413612565445026,0.5863874345549738,0.9685863874345549,0.031413612565445025
8774,4782,3966,816,3987,795,0.8293601003764115,0.17063989962358847,0.8337515683814304,0.16624843161856964,1375,123,274,978,1027,348,0.08945454545454545,0.19927272727272727,0.7112727272727273,0.7469090909090909,0.2530909090909091
8775,265,193,72,177,88,0.7283018867924528,0.27169811320754716,0.6679245283018868,0.3320754716981132,81,3,20,58,61,20,0.037037037037037035,0.24691358024691357,0.7160493827160493,0.7530864197530864,0.24691358024691357
8776,338,248,90,292,46,0.7337278106508875,0.26627218934911245,0.863905325443787,0.13609467455621302,191,19,60,112,185,6,0.09947643979057591,0.31413612565445026,0.5863874345549738,0.9685863874345549,0.031413612565445025
8777,317,222,95,274,43,0.7003154574132492,0.2996845425867508,0.8643533123028391,0.13564668769716087,161,21,58,82,158,3,0.13043478260869565,0.36024844720496896,0.5093167701863354,0.9813664596273292,0.018633540372670808
8778,356,241,115,310,46,0.6769662921348315,0.32303370786516855,0.8707865168539326,0.12921348314606743,191,19,60,112,185,6,0.09947643979057591,0.31413612565445026,0.5863874345549738,0.9685863874345549,0.031413612565445025
8779,713,623,90,681,32,0.8737727910238429,0.12622720897615708,0.9551192145862553,0.04488078541374474,318,79,96,143,305,13,0.24842767295597484,0.3018867924528302,0.449685534591195,0.9591194968553459,0.040880503144654086
8780,292,235,57,240,52,0.8047945205479452,0.1952054794520548,0.821917808219178,0.1780821917808219,221,23,67,131,214,7,0.10407239819004525,0.3031674208144796,0.5927601809954751,0.9683257918552036,0.03167420814479638
8781,308,258,50,258,50,0.8376623376623377,0.16233766233766234,0.8376623376623377,0.16233766233766234,191,19,60,112,185,6,0.09947643979057591,0.31413612565445026,0.5863874345549738,0.9685863874345549,0.031413612565445025
8782,504,404,100,396,108,0.8015873015873016,0.1984126984126984,0.7857142857142857,0.21428571428571427,305,42,52,211,287,18,0.1377049180327869,0.17049180327868851,0.6918032786885245,0.940983606557377,0.05901639344262295
8783,348,246,102,294,54,0.7068965517241379,0.29310344827586204,0.8448275862068966,0.15517241379310345,221,23,67,131,214,7,0.10407239819004525,0.3031674208144796,0.5927601809954751,0.9683257918552036,0.03167420814479638
8784,342,239,103,292,50,0.6988304093567251,0.30116959064327486,0.8538011695906432,0.14619883040935672,221,23,67,131,214,7,0.10407239819004525,0.3031674208144796,0.5927601809954751,0.9683257918552036,0.03167420814479638
8785,326,247,79,276,50,0.7576687116564417,0.24233128834355827,0.8466257668711656,0.15337423312883436,191,19,60,112,185,6,0.09947643979057591,0.31413612565445026,0.5863874345549738,0.9685863874345549,0.031413612565445025
8786,373,260,113,323,50,0.6970509383378016,0.30294906166219837,0.8659517426273459,0.13404825737265416,191,19,60,112,185,6,0.09947643979057591,0.31413612565445026,0.5863874345549738,0.9685863874345549,0.031413612565445025
8787,324,231,93,277,47,0.7129629629629629,0.28703703703703703,0.8549382716049383,0.14506172839506173,221,23,67,131,214,7,0.10407239819004525,0.3031674208144796,0.5927601809954751,0.9683257918552036,0.03167420814479638
8788,9439,7636,1803,7663,1776,0.8089840025426422,0.19101599745735778,0.8118444750503231,0.18815552494967688,2838,202,484,2152,1815,1023,0.0711768851303735,0.17054263565891473,0.7582804792107117,0.6395348837209303,0.36046511627906974
8789,359,248,111,311,48,0.6908077994428969,0.30919220055710306,0.8662952646239555,0.13370473537604458,191,19,60,112,185,6,0.09947643979057591,0.31413612565445026,0.5863874345549738,0.9685863874345549,0.031413612565445025
8790,280,232,48,230,50,0.8285714285714286,0.17142857142857143,0.8214285714285714,0.17857142857142858,161,21,58,82,158,3,0.13043478260869565,0.36024844720496896,0.5093167701863354,0.9813664596273292,0.018633540372670808
8791,371,258,113,318,53,0.6954177897574124,0.3045822102425876,0.8571428571428571,0.14285714285714285,191,19,60,112,185,6,0.09947643979057591,0.31413612565445026,0.5863874345549738,0.9685863874345549,0.031413612565445025
8792,398,312,86,347,51,0.7839195979899497,0.21608040201005024,0.871859296482412,0.12814070351758794,191,19,60,112,185,6,0.09947643979057591,0.31413612565445026,0.5863874345549738,0.9685863874345549,0.031413612565445025
8793,295,248,47,239,56,0.8406779661016949,0.15932203389830507,0.8101694915254237,0.18983050847457628,221,23,67,131,214,7,0.10407239819004525,0.3031674208144796,0.5927601809954751,0.9683257918552036,0.03167420814479638
8794,959,783,176,660,299,0.8164754953076121,0.1835245046923879,0.6882168925964547,0.31178310740354537,148,19,34,95,140,8,0.12837837837837837,0.22972972972972974,0.6418918918918919,0.9459459459459459,0.05405405405405406
8795,293,251,42,243,50,0.856655290102389,0.14334470989761092,0.8293515358361775,0.17064846416382254,191,19,60,112,185,6,0.09947643979057591,0.31413612565445026,0.5863874345549738,0.9685863874345549,0.031413612565445025
8796,316,245,71,269,47,0.7753164556962026,0.22468354430379747,0.8512658227848101,0.14873417721518986,191,19,60,112,185,6,0.09947643979057591,0.31413612565445026,0.5863874345549738,0.9685863874345549,0.031413612565445025
8797,296,246,50,250,46,0.831081081081081,0.16891891891891891,0.8445945945945946,0.1554054054054054,191,19,60,112,185,6,0.09947643979057591,0.31413612565445026,0.5863874345549738,0.9685863874345549,0.031413612565445025
8798,431,321,110,378,53,0.7447795823665894,0.2552204176334107,0.877030162412993,0.12296983758700696,191,19,60,112,185,6,0.09947643979057591,0.31413612565445026,0.5863874345549738,0.9685863874345549,0.031413612565445025
8799,194,177,17,148,46,0.9123711340206185,0.08762886597938144,0.7628865979381443,0.23711340206185566,297,112,93,92,280,17,0.3771043771043771,0.31313131313131315,0.30976430976430974,0.9427609427609428,0.05723905723905724
8800,325,253,72,280,45,0.7784615384615384,0.22153846153846155,0.8615384615384616,0.13846153846153847,191,19,60,112,185,6,0.09947643979057591,0.31413612565445026,0.5863874345549738,0.9685863874345549,0.031413612565445025
8801,423,396,27,386,37,0.9361702127659575,0.06382978723404255,0.9125295508274232,0.08747044917257683,1038,210,469,359,991,47,0.2023121387283237,0.45183044315992293,0.34585741811175336,0.9547206165703276,0.04527938342967245
8802,361,248,113,318,43,0.6869806094182825,0.31301939058171746,0.8808864265927978,0.11911357340720222,191,19,60,112,185,6,0.09947643979057591,0.31413612565445026,0.5863874345549738,0.9685863874345549,0.031413612565445025
8803,327,258,69,272,55,0.7889908256880734,0.21100917431192662,0.8318042813455657,0.16819571865443425,191,19,60,112,185,6,0.09947643979057591,0.31413612565445026,0.5863874345549738,0.9685863874345549,0.031413612565445025
8804,1099,976,123,864,235,0.8880800727934486,0.11191992720655142,0.7861692447679709,0.21383075523202913,139,44,75,20,139,0,0.31654676258992803,0.539568345323741,0.14388489208633093,1.0,0.0
8805,912,736,176,647,265,0.8070175438596491,0.19298245614035087,0.7094298245614035,0.2905701754385965,151,17,41,93,143,8,0.11258278145695365,0.271523178807947,0.6158940397350994,0.9470198675496688,0.052980132450331126
8806,361,250,111,310,51,0.6925207756232687,0.3074792243767313,0.8587257617728532,0.14127423822714683,191,19,60,112,185,6,0.09947643979057591,0.31413612565445026,0.5863874345549738,0.9685863874345549,0.031413612565445025
8807,971,815,156,762,209,0.839340885684861,0.16065911431513905,0.7847579814624099,0.21524201853759012,99,31,46,22,99,0,0.31313131313131315,0.46464646464646464,0.2222222222222222,1.0,0.0
8808,365,254,111,317,48,0.6958904109589041,0.3041095890410959,0.8684931506849315,0.13150684931506848,191,19,60,112,185,6,0.09947643979057591,0.31413612565445026,0.5863874345549738,0.9685863874345549,0.031413612565445025
8809,405,296,109,360,45,0.7308641975308642,0.2691358024691358,0.8888888888888888,0.1111111111111111,191,19,60,112,185,6,0.09947643979057591,0.31413612565445026,0.5863874345549738,0.9685863874345549,0.031413612565445025
8810,9914,7021,2893,5330,4584,0.7081904377647771,0.2918095622352229,0.5376235626386927,0.46237643736130724,2076,53,415,1608,1939,137,0.025529865125240848,0.19990366088631983,0.7745664739884393,0.9340077071290944,0.06599229287090559
8811,294,238,56,243,51,0.8095238095238095,0.19047619047619047,0.826530612244898,0.17346938775510204,221,23,67,131,214,7,0.10407239819004525,0.3031674208144796,0.5927601809954751,0.9683257918552036,0.03167420814479638
8812,308,247,61,256,52,0.801948051948052,0.19805194805194806,0.8311688311688312,0.16883116883116883,212,23,64,125,205,7,0.10849056603773585,0.3018867924528302,0.589622641509434,0.9669811320754716,0.0330188679245283
8813,5636,5617,19,4143,1493,0.9966288147622427,0.003371185237757275,0.7350958126330731,0.2649041873669269,280,116,12,152,261,19,0.4142857142857143,0.04285714285714286,0.5428571428571428,0.9321428571428572,0.06785714285714285
8814,354,250,104,305,49,0.7062146892655368,0.2937853107344633,0.8615819209039548,0.1384180790960452,191,19,60,112,185,6,0.09947643979057591,0.31413612565445026,0.5863874345549738,0.9685863874345549,0.031413612565445025
8815,297,249,48,250,47,0.8383838383838383,0.16161616161616163,0.8417508417508418,0.15824915824915825,191,19,60,112,185,6,0.09947643979057591,0.31413612565445026,0.5863874345549738,0.9685863874345549,0.031413612565445025
8816,321,228,93,273,48,0.7102803738317757,0.2897196261682243,0.8504672897196262,0.14953271028037382,161,21,58,82,158,3,0.13043478260869565,0.36024844720496896,0.5093167701863354,0.9813664596273292,0.018633540372670808
8817,322,260,62,274,48,0.8074534161490683,0.19254658385093168,0.8509316770186336,0.14906832298136646,191,19,60,112,185,6,0.09947643979057591,0.31413612565445026,0.5863874345549738,0.9685863874345549,0.031413612565445025
8818,300,242,58,253,47,0.8066666666666666,0.19333333333333333,0.8433333333333334,0.15666666666666668,191,19,60,112,185,6,0.09947643979057591,0.31413612565445026,0.5863874345549738,0.9685863874345549,0.031413612565445025
8819,342,239,103,290,52,0.6988304093567251,0.30116959064327486,0.847953216374269,0.15204678362573099,221,23,67,131,214,7,0.10407239819004525,0.3031674208144796,0.5927601809954751,0.9683257918552036,0.03167420814479638
8820,221,170,51,149,72,0.7692307692307693,0.23076923076923078,0.6742081447963801,0.3257918552036199,281,0,230,51,269,12,0.0,0.8185053380782918,0.18149466192170818,0.9572953736654805,0.042704626334519574
8821,293,243,50,251,42,0.8293515358361775,0.17064846416382254,0.856655290102389,0.14334470989761092,191,19,60,112,185,6,0.09947643979057591,0.31413612565445026,0.5863874345549738,0.9685863874345549,0.031413612565445025
8822,17308,14841,2467,14480,2828,0.8574647561821123,0.14253524381788768,0.8366073492026809,0.16339265079731916,6777,204,593,5980,3874,2903,0.03010181496237273,0.08750184447395602,0.8823963405636712,0.5716393684521175,0.42836063154788256
8823,358,246,112,311,47,0.6871508379888268,0.3128491620111732,0.8687150837988827,0.13128491620111732,191,19,60,112,185,6,0.09947643979057591,0.31413612565445026,0.5863874345549738,0.9685863874345549,0.031413612565445025
8824,280,236,44,230,50,0.8428571428571429,0.15714285714285714,0.8214285714285714,0.17857142857142858,212,23,64,125,205,7,0.10849056603773585,0.3018867924528302,0.589622641509434,0.9669811320754716,0.0330188679245283
8825,405,294,111,358,47,0.725925925925926,0.2740740740740741,0.8839506172839506,0.11604938271604938,191,19,60,112,185,6,0.09947643979057591,0.31413612565445026,0.5863874345549738,0.9685863874345549,0.031413612565445025
8826,361,251,110,312,49,0.6952908587257618,0.3047091412742382,0.8642659279778393,0.13573407202216067,191,19,60,112,185,6,0.09947643979057591,0.31413612565445026,0.5863874345549738,0.9685863874345549,0.031413612565445025
8827,36,36,0,19,17,1.0,0.0,0.5277777777777778,0.4722222222222222,7,0,0,7,6,1,0.0,0.0,1.0,0.8571428571428571,0.14285714285714285
8828,281,236,45,232,49,0.8398576512455516,0.1601423487544484,0.8256227758007118,0.17437722419928825,221,23,67,131,214,7,0.10407239819004525,0.3031674208144796,0.5927601809954751,0.9683257918552036,0.03167420814479638
8829,306,256,50,259,47,0.8366013071895425,0.16339869281045752,0.8464052287581699,0.15359477124183007,191,19,60,112,185,6,0.09947643979057591,0.31413612565445026,0.5863874345549738,0.9685863874345549,0.031413612565445025
8830,510,410,100,434,76,0.803921568627451,0.19607843137254902,0.8509803921568627,0.14901960784313725,496,40,52,404,479,17,0.08064516129032258,0.10483870967741936,0.8145161290322581,0.9657258064516129,0.034274193548387094
8831,164,141,23,123,41,0.8597560975609756,0.1402439024390244,0.75,0.25,604,37,83,484,582,22,0.061258278145695365,0.13741721854304637,0.8013245033112583,0.9635761589403974,0.03642384105960265
8832,361,251,110,310,51,0.6952908587257618,0.3047091412742382,0.8587257617728532,0.14127423822714683,191,19,60,112,185,6,0.09947643979057591,0.31413612565445026,0.5863874345549738,0.9685863874345549,0.031413612565445025
8833,422,395,27,385,37,0.9360189573459715,0.06398104265402843,0.9123222748815166,0.08767772511848342,1038,210,469,359,991,47,0.2023121387283237,0.45183044315992293,0.34585741811175336,0.9547206165703276,0.04527938342967245
8834,419,310,109,373,46,0.7398568019093079,0.26014319809069214,0.8902147971360382,0.10978520286396182,191,19,60,112,185,6,0.09947643979057591,0.31413612565445026,0.5863874345549738,0.9685863874345549,0.031413612565445025
8835,1949,1930,19,1431,518,0.9902514109799897,0.009748589020010261,0.7342226782965623,0.26577732170343765,292,116,21,155,281,11,0.3972602739726027,0.07191780821917808,0.5308219178082192,0.9623287671232876,0.03767123287671233
8836,326,234,92,275,51,0.7177914110429447,0.2822085889570552,0.843558282208589,0.15644171779141106,161,21,58,82,158,3,0.13043478260869565,0.36024844720496896,0.5093167701863354,0.9813664596273292,0.018633540372670808
8837,4511,3636,875,3956,555,0.8060297051651518,0.19397029483484815,0.8769674129904678,0.12303258700953225,1579,184,404,991,1323,256,0.11652944901836605,0.2558581380620646,0.6276124129195694,0.8378720709309689,0.16212792906903103
8838,348,248,100,301,47,0.7126436781609196,0.28735632183908044,0.8649425287356322,0.13505747126436782,191,19,60,112,185,6,0.09947643979057591,0.31413612565445026,0.5863874345549738,0.9685863874345549,0.031413612565445025
8839,390,278,112,339,51,0.7128205128205128,0.28717948717948716,0.8692307692307693,0.13076923076923078,191,19,60,112,185,6,0.09947643979057591,0.31413612565445026,0.5863874345549738,0.9685863874345549,0.031413612565445025
8840,345,249,96,299,46,0.7217391304347827,0.2782608695652174,0.8666666666666667,0.13333333333333333,191,19,60,112,185,6,0.09947643979057591,0.31413612565445026,0.5863874345549738,0.9685863874345549,0.031413612565445025
8841,348,251,97,300,48,0.7212643678160919,0.27873563218390807,0.8620689655172413,0.13793103448275862,191,19,60,112,185,6,0.09947643979057591,0.31413612565445026,0.5863874345549738,0.9685863874345549,0.031413612565445025
8842,1043,893,150,824,219,0.8561840843720039,0.14381591562799617,0.7900287631831256,0.2099712368168744,126,12,23,91,113,13,0.09523809523809523,0.18253968253968253,0.7222222222222222,0.8968253968253969,0.10317460317460317
8843,365,251,114,314,51,0.6876712328767123,0.31232876712328766,0.8602739726027397,0.13972602739726028,191,19,60,112,185,6,0.09947643979057591,0.31413612565445026,0.5863874345549738,0.9685863874345549,0.031413612565445025
8844,370,259,111,319,51,0.7,0.3,0.8621621621621621,0.13783783783783785,191,19,60,112,185,6,0.09947643979057591,0.31413612565445026,0.5863874345549738,0.9685863874345549,0.031413612565445025
8845,638,536,102,581,57,0.8401253918495298,0.15987460815047022,0.9106583072100314,0.08934169278996865,1235,46,548,641,1187,48,0.03724696356275304,0.4437246963562753,0.5190283400809717,0.9611336032388664,0.038866396761133605
8846,344,242,102,295,49,0.7034883720930233,0.29651162790697677,0.8575581395348837,0.14244186046511628,221,23,67,131,214,7,0.10407239819004525,0.3031674208144796,0.5927601809954751,0.9683257918552036,0.03167420814479638
8847,136,115,21,106,30,0.8455882352941176,0.15441176470588236,0.7794117647058824,0.22058823529411764,483,1,44,438,464,19,0.002070393374741201,0.09109730848861283,0.906832298136646,0.9606625258799172,0.039337474120082816
8848,14185,11060,3125,10378,3807,0.7796968628833275,0.22030313711667254,0.7316179062389848,0.2683820937610152,9594,567,1828,7199,7534,2060,0.05909943714821764,0.19053575151136126,0.7503648113404211,0.7852824682092975,0.21471753179070252
8849,335,243,92,283,52,0.7253731343283583,0.2746268656716418,0.844776119402985,0.15522388059701492,221,23,67,131,214,7,0.10407239819004525,0.3031674208144796,0.5927601809954751,0.9683257918552036,0.03167420814479638
8850,141,133,8,109,32,0.9432624113475178,0.05673758865248227,0.7730496453900709,0.22695035460992907,1,0,0,1,1,0,0.0,0.0,1.0,1.0,0.0
8851,375,279,96,325,50,0.744,0.256,0.8666666666666667,0.13333333333333333,193,23,56,114,185,8,0.11917098445595854,0.29015544041450775,0.5906735751295337,0.9585492227979274,0.04145077720207254
8852,371,279,92,319,52,0.7520215633423181,0.24797843665768193,0.8598382749326146,0.14016172506738545,191,19,60,112,185,6,0.09947643979057591,0.31413612565445026,0.5863874345549738,0.9685863874345549,0.031413612565445025
8853,803,747,56,619,184,0.9302615193026152,0.06973848069738481,0.7708592777085927,0.22914072229140722,750,113,117,520,728,22,0.15066666666666667,0.156,0.6933333333333334,0.9706666666666667,0.029333333333333333
8854,321,228,93,271,50,0.7102803738317757,0.2897196261682243,0.8442367601246106,0.1557632398753894,161,21,58,82,158,3,0.13043478260869565,0.36024844720496896,0.5093167701863354,0.9813664596273292,0.018633540372670808
8855,740,640,100,570,170,0.8648648648648649,0.13513513513513514,0.7702702702702703,0.22972972972972974,242,47,25,170,231,11,0.19421487603305784,0.10330578512396695,0.7024793388429752,0.9545454545454546,0.045454545454545456
8856,389,304,85,283,106,0.781491002570694,0.2185089974293059,0.7275064267352185,0.27249357326478146,153,15,28,110,150,3,0.09803921568627451,0.1830065359477124,0.7189542483660131,0.9803921568627451,0.0196078431372549
8857,339,286,53,270,69,0.8436578171091446,0.15634218289085547,0.7964601769911505,0.20353982300884957,99,2,3,94,93,6,0.020202020202020204,0.030303030303030304,0.9494949494949495,0.9393939393939394,0.06060606060606061
8858,159,139,20,114,45,0.8742138364779874,0.12578616352201258,0.7169811320754716,0.2830188679245283,290,124,16,150,278,12,0.42758620689655175,0.05517241379310345,0.5172413793103449,0.9586206896551724,0.041379310344827586
8859,334,240,94,284,50,0.718562874251497,0.281437125748503,0.8502994011976048,0.1497005988023952,193,23,56,114,185,8,0.11917098445595854,0.29015544041450775,0.5906735751295337,0.9585492227979274,0.04145077720207254
8860,370,304,66,277,93,0.8216216216216217,0.1783783783783784,0.7486486486486487,0.25135135135135134,92,13,25,54,85,7,0.14130434782608695,0.2717391304347826,0.5869565217391305,0.9239130434782609,0.07608695652173914
8861,293,222,71,250,43,0.757679180887372,0.24232081911262798,0.8532423208191127,0.14675767918088736,161,21,58,82,158,3,0.13043478260869565,0.36024844720496896,0.5093167701863354,0.9813664596273292,0.018633540372670808
8862,361,249,112,312,49,0.6897506925207756,0.31024930747922436,0.8642659279778393,0.13573407202216067,191,19,60,112,185,6,0.09947643979057591,0.31413612565445026,0.5863874345549738,0.9685863874345549,0.031413612565445025
8863,325,247,78,278,47,0.76,0.24,0.8553846153846154,0.14461538461538462,191,19,60,112,185,6,0.09947643979057591,0.31413612565445026,0.5863874345549738,0.9685863874345549,0.031413612565445025
8864,244,202,42,185,59,0.8278688524590164,0.1721311475409836,0.7581967213114754,0.24180327868852458,176,16,36,124,169,7,0.09090909090909091,0.20454545454545456,0.7045454545454546,0.9602272727272727,0.03977272727272727
8865,284,242,42,238,46,0.852112676056338,0.14788732394366197,0.8380281690140845,0.1619718309859155,191,19,60,112,185,6,0.09947643979057591,0.31413612565445026,0.5863874345549738,0.9685863874345549,0.031413612565445025
8866,480,268,212,362,118,0.5583333333333333,0.44166666666666665,0.7541666666666667,0.24583333333333332,454,14,255,185,448,6,0.030837004405286344,0.5616740088105727,0.40748898678414097,0.986784140969163,0.013215859030837005
8867,1165,1008,157,914,251,0.8652360515021459,0.13476394849785409,0.784549356223176,0.21545064377682405,53,10,8,35,48,5,0.18867924528301888,0.1509433962264151,0.660377358490566,0.9056603773584906,0.09433962264150944
8868,162,138,24,122,40,0.8518518518518519,0.14814814814814814,0.7530864197530864,0.24691358024691357,411,30,37,344,395,16,0.072992700729927,0.09002433090024331,0.8369829683698297,0.9610705596107056,0.038929440389294405
8869,175,150,25,133,42,0.8571428571428571,0.14285714285714285,0.76,0.24,165,26,38,101,152,13,0.15757575757575756,0.23030303030303031,0.6121212121212121,0.9212121212121213,0.07878787878787878
8870,208,159,49,137,71,0.7644230769230769,0.23557692307692307,0.6586538461538461,0.34134615384615385,238,1,179,58,236,2,0.004201680672268907,0.7521008403361344,0.24369747899159663,0.9915966386554622,0.008403361344537815
8871,541,453,88,431,110,0.8373382624768947,0.16266173752310537,0.7966728280961183,0.2033271719038817,70,15,25,30,69,1,0.21428571428571427,0.35714285714285715,0.42857142857142855,0.9857142857142858,0.014285714285714285
8872,4926,4024,902,4271,655,0.8168899715793747,0.18311002842062526,0.8670320747056435,0.13296792529435647,1556,183,387,986,1351,205,0.11760925449871465,0.2487146529562982,0.6336760925449871,0.8682519280205655,0.13174807197943444
8873,350,245,105,295,55,0.7,0.3,0.8428571428571429,0.15714285714285714,221,23,67,131,214,7,0.10407239819004525,0.3031674208144796,0.5927601809954751,0.9683257918552036,0.03167420814479638
8874,281,227,54,228,53,0.8078291814946619,0.19217081850533807,0.8113879003558719,0.18861209964412812,212,23,64,125,205,7,0.10849056603773585,0.3018867924528302,0.589622641509434,0.9669811320754716,0.0330188679245283
8875,185,149,36,141,44,0.8054054054054054,0.1945945945945946,0.7621621621621621,0.23783783783783785,67,15,18,34,63,4,0.22388059701492538,0.26865671641791045,0.5074626865671642,0.9402985074626866,0.05970149253731343
8876,328,259,69,281,47,0.7896341463414634,0.21036585365853658,0.8567073170731707,0.14329268292682926,191,19,60,112,185,6,0.09947643979057591,0.31413612565445026,0.5863874345549738,0.9685863874345549,0.031413612565445025
8877,296,243,53,251,45,0.8209459459459459,0.17905405405405406,0.847972972972973,0.15202702702702703,191,19,60,112,185,6,0.09947643979057591,0.31413612565445026,0.5863874345549738,0.9685863874345549,0.031413612565445025
8878,310,255,55,261,49,0.8225806451612904,0.1774193548387097,0.8419354838709677,0.15806451612903225,191,19,60,112,185,6,0.09947643979057591,0.31413612565445026,0.5863874345549738,0.9685863874345549,0.031413612565445025
8879,377,267,110,330,47,0.7082228116710876,0.2917771883289125,0.8753315649867374,0.1246684350132626,191,19,60,112,185,6,0.09947643979057591,0.31413612565445026,0.5863874345549738,0.9685863874345549,0.031413612565445025
8880,366,254,112,314,52,0.6939890710382514,0.30601092896174864,0.8579234972677595,0.14207650273224043,191,19,60,112,185,6,0.09947643979057591,0.31413612565445026,0.5863874345549738,0.9685863874345549,0.031413612565445025
8881,309,259,50,259,50,0.8381877022653722,0.16181229773462782,0.8381877022653722,0.16181229773462782,191,19,60,112,185,6,0.09947643979057591,0.31413612565445026,0.5863874345549738,0.9685863874345549,0.031413612565445025
8882,296,251,45,246,50,0.847972972972973,0.15202702702702703,0.831081081081081,0.16891891891891891,191,19,60,112,185,6,0.09947643979057591,0.31413612565445026,0.5863874345549738,0.9685863874345549,0.031413612565445025
8883,303,259,44,250,53,0.8547854785478548,0.14521452145214522,0.8250825082508251,0.17491749174917492,191,19,60,112,185,6,0.09947643979057591,0.31413612565445026,0.5863874345549738,0.9685863874345549,0.031413612565445025
8884,364,255,109,312,52,0.7005494505494505,0.29945054945054944,0.8571428571428571,0.14285714285714285,212,23,64,125,205,7,0.10849056603773585,0.3018867924528302,0.589622641509434,0.9669811320754716,0.0330188679245283
8885,179,163,16,136,43,0.9106145251396648,0.0893854748603352,0.7597765363128491,0.24022346368715083,263,91,78,94,247,16,0.34600760456273766,0.2965779467680608,0.3574144486692015,0.9391634980988594,0.060836501901140684
8886,328,234,94,279,49,0.7134146341463414,0.2865853658536585,0.850609756097561,0.14939024390243902,161,21,58,82,158,3,0.13043478260869565,0.36024844720496896,0.5093167701863354,0.9813664596273292,0.018633540372670808
8887,197,164,33,147,50,0.8324873096446701,0.16751269035532995,0.7461928934010152,0.25380710659898476,151,44,56,51,148,3,0.2913907284768212,0.3708609271523179,0.33774834437086093,0.9801324503311258,0.019867549668874173
8888,2718,2164,554,2389,329,0.7961736571008095,0.20382634289919058,0.8789551140544518,0.1210448859455482,1056,128,330,598,991,65,0.12121212121212122,0.3125,0.5662878787878788,0.9384469696969697,0.061553030303030304
8889,329,250,79,281,48,0.7598784194528876,0.24012158054711247,0.8541033434650456,0.1458966565349544,191,19,60,112,185,6,0.09947643979057591,0.31413612565445026,0.5863874345549738,0.9685863874345549,0.031413612565445025
8890,304,230,74,256,48,0.756578947368421,0.24342105263157895,0.8421052631578947,0.15789473684210525,161,21,58,82,158,3,0.13043478260869565,0.36024844720496896,0.5093167701863354,0.9813664596273292,0.018633540372670808
8891,356,244,112,309,47,0.6853932584269663,0.3146067415730337,0.8679775280898876,0.13202247191011235,191,19,60,112,185,6,0.09947643979057591,0.31413612565445026,0.5863874345549738,0.9685863874345549,0.031413612565445025
8892,293,247,46,240,53,0.8430034129692833,0.15699658703071673,0.8191126279863481,0.18088737201365188,193,23,56,114,185,8,0.11917098445595854,0.29015544041450775,0.5906735751295337,0.9585492227979274,0.04145077720207254
8893,367,255,112,317,50,0.6948228882833788,0.30517711171662126,0.8637602179836512,0.1362397820163488,191,19,60,112,185,6,0.09947643979057591,0.31413612565445026,0.5863874345549738,0.9685863874345549,0.031413612565445025
8894,354,244,110,306,48,0.6892655367231638,0.3107344632768362,0.864406779661017,0.13559322033898305,191,19,60,112,185,6,0.09947643979057591,0.31413612565445026,0.5863874345549738,0.9685863874345549,0.031413612565445025
8895,463,396,67,334,129,0.8552915766738661,0.1447084233261339,0.7213822894168467,0.2786177105831533,160,41,59,60,156,4,0.25625,0.36875,0.375,0.975,0.025
8896,134,113,21,109,25,0.8432835820895522,0.15671641791044777,0.8134328358208955,0.1865671641791045,244,2,31,211,228,16,0.00819672131147541,0.12704918032786885,0.8647540983606558,0.9344262295081968,0.06557377049180328
8897,340,236,104,290,50,0.6941176470588235,0.3058823529411765,0.8529411764705882,0.14705882352941177,221,23,67,131,214,7,0.10407239819004525,0.3031674208144796,0.5927601809954751,0.9683257918552036,0.03167420814479638
8898,283,230,53,238,45,0.8127208480565371,0.1872791519434629,0.8409893992932862,0.15901060070671377,193,23,56,114,185,8,0.11917098445595854,0.29015544041450775,0.5906735751295337,0.9585492227979274,0.04145077720207254
8899,322,254,68,271,51,0.7888198757763976,0.2111801242236025,0.8416149068322981,0.15838509316770186,191,19,60,112,185,6,0.09947643979057591,0.31413612565445026,0.5863874345549738,0.9685863874345549,0.031413612565445025
8900,368,256,112,319,49,0.6956521739130435,0.30434782608695654,0.8668478260869565,0.1331521739130435,191,19,60,112,185,6,0.09947643979057591,0.31413612565445026,0.5863874345549738,0.9685863874345549,0.031413612565445025
8901,359,245,114,312,47,0.6824512534818942,0.31754874651810583,0.8690807799442897,0.1309192200557103,191,19,60,112,185,6,0.09947643979057591,0.31413612565445026,0.5863874345549738,0.9685863874345549,0.031413612565445025
8902,336,250,86,287,49,0.7440476190476191,0.25595238095238093,0.8541666666666666,0.14583333333333334,191,19,60,112,185,6,0.09947643979057591,0.31413612565445026,0.5863874345549738,0.9685863874345549,0.031413612565445025
8903,364,253,111,312,52,0.695054945054945,0.30494505494505497,0.8571428571428571,0.14285714285714285,191,19,60,112,185,6,0.09947643979057591,0.31413612565445026,0.5863874345549738,0.9685863874345549,0.031413612565445025
8904,316,227,89,270,46,0.7183544303797469,0.28164556962025317,0.8544303797468354,0.14556962025316456,161,21,58,82,158,3,0.13043478260869565,0.36024844720496896,0.5093167701863354,0.9813664596273292,0.018633540372670808
8905,806,750,56,603,203,0.9305210918114144,0.06947890818858561,0.7481389578163772,0.2518610421836228,750,112,119,519,730,20,0.14933333333333335,0.15866666666666668,0.692,0.9733333333333334,0.02666666666666667
8906,365,255,110,311,54,0.6986301369863014,0.3013698630136986,0.852054794520548,0.14794520547945206,191,19,60,112,185,6,0.09947643979057591,0.31413612565445026,0.5863874345549738,0.9685863874345549,0.031413612565445025
8907,170,139,31,124,46,0.8176470588235294,0.18235294117647058,0.7294117647058823,0.27058823529411763,370,124,149,97,340,30,0.33513513513513515,0.4027027027027027,0.26216216216216215,0.918918918918919,0.08108108108108109
8908,36,36,0,19,17,1.0,0.0,0.5277777777777778,0.4722222222222222,7,0,0,7,6,1,0.0,0.0,1.0,0.8571428571428571,0.14285714285714285
8909,286,230,56,232,54,0.8041958041958042,0.1958041958041958,0.8111888111888111,0.1888111888111888,212,23,64,125,205,7,0.10849056603773585,0.3018867924528302,0.589622641509434,0.9669811320754716,0.0330188679245283
8910,297,246,51,250,47,0.8282828282828283,0.1717171717171717,0.8417508417508418,0.15824915824915825,191,19,60,112,185,6,0.09947643979057591,0.31413612565445026,0.5863874345549738,0.9685863874345549,0.031413612565445025
8911,373,261,112,319,54,0.6997319034852547,0.3002680965147453,0.8552278820375335,0.1447721179624665,191,19,60,112,185,6,0.09947643979057591,0.31413612565445026,0.5863874345549738,0.9685863874345549,0.031413612565445025
8912,358,249,109,311,47,0.6955307262569832,0.30446927374301674,0.8687150837988827,0.13128491620111732,191,19,60,112,185,6,0.09947643979057591,0.31413612565445026,0.5863874345549738,0.9685863874345549,0.031413612565445025
8913,561,475,86,441,120,0.8467023172905526,0.1532976827094474,0.786096256684492,0.21390374331550802,69,14,25,30,68,1,0.2028985507246377,0.36231884057971014,0.43478260869565216,0.9855072463768116,0.014492753623188406
8914,381,279,102,334,47,0.7322834645669292,0.2677165354330709,0.8766404199475065,0.12335958005249344,221,23,67,131,214,7,0.10407239819004525,0.3031674208144796,0.5927601809954751,0.9683257918552036,0.03167420814479638
8915,357,280,77,300,57,0.7843137254901961,0.21568627450980393,0.8403361344537815,0.15966386554621848,221,23,67,131,214,7,0.10407239819004525,0.3031674208144796,0.5927601809954751,0.9683257918552036,0.03167420814479638
8916,395,287,108,350,45,0.7265822784810126,0.27341772151898736,0.8860759493670886,0.11392405063291139,113,15,19,79,111,2,0.13274336283185842,0.168141592920354,0.6991150442477876,0.9823008849557522,0.017699115044247787
8917,301,254,47,247,54,0.8438538205980066,0.15614617940199335,0.8205980066445183,0.17940199335548174,191,19,60,112,185,6,0.09947643979057591,0.31413612565445026,0.5863874345549738,0.9685863874345549,0.031413612565445025
8918,158,134,24,117,41,0.8481012658227848,0.1518987341772152,0.740506329113924,0.25949367088607594,843,114,137,592,580,263,0.13523131672597866,0.16251482799525505,0.7022538552787663,0.6880189798339265,0.31198102016607354
8919,356,244,112,311,45,0.6853932584269663,0.3146067415730337,0.8735955056179775,0.12640449438202248,191,19,60,112,185,6,0.09947643979057591,0.31413612565445026,0.5863874345549738,0.9685863874345549,0.031413612565445025
8920,306,247,59,262,44,0.8071895424836601,0.19281045751633988,0.8562091503267973,0.1437908496732026,191,19,60,112,185,6,0.09947643979057591,0.31413612565445026,0.5863874345549738,0.9685863874345549,0.031413612565445025
8921,127,111,16,98,29,0.8740157480314961,0.12598425196850394,0.7716535433070866,0.2283464566929134,20,0,3,17,15,5,0.0,0.15,0.85,0.75,0.25
8922,1685,1572,113,1637,48,0.9329376854599406,0.06706231454005934,0.971513353115727,0.028486646884272996,191,19,60,112,185,6,0.09947643979057591,0.31413612565445026,0.5863874345549738,0.9685863874345549,0.031413612565445025
8923,354,247,107,306,48,0.6977401129943502,0.3022598870056497,0.864406779661017,0.13559322033898305,191,19,60,112,185,6,0.09947643979057591,0.31413612565445026,0.5863874345549738,0.9685863874345549,0.031413612565445025
8924,362,250,112,313,49,0.6906077348066298,0.30939226519337015,0.8646408839779005,0.13535911602209943,191,19,60,112,185,6,0.09947643979057591,0.31413612565445026,0.5863874345549738,0.9685863874345549,0.031413612565445025
8925,328,247,81,282,46,0.7530487804878049,0.24695121951219512,0.8597560975609756,0.1402439024390244,191,19,60,112,185,6,0.09947643979057591,0.31413612565445026,0.5863874345549738,0.9685863874345549,0.031413612565445025
8926,338,249,89,295,43,0.7366863905325444,0.26331360946745563,0.8727810650887574,0.12721893491124261,193,23,56,114,185,8,0.11917098445595854,0.29015544041450775,0.5906735751295337,0.9585492227979274,0.04145077720207254
8927,320,243,77,272,48,0.759375,0.240625,0.85,0.15,191,19,60,112,185,6,0.09947643979057591,0.31413612565445026,0.5863874345549738,0.9685863874345549,0.031413612565445025
8928,299,249,50,252,47,0.8327759197324415,0.16722408026755853,0.842809364548495,0.15719063545150502,191,19,60,112,185,6,0.09947643979057591,0.31413612565445026,0.5863874345549738,0.9685863874345549,0.031413612565445025
8929,139,117,22,106,33,0.841726618705036,0.15827338129496402,0.762589928057554,0.23741007194244604,291,29,54,208,279,12,0.09965635738831616,0.18556701030927836,0.7147766323024055,0.9587628865979382,0.041237113402061855
8930,203,172,31,150,53,0.8472906403940886,0.15270935960591134,0.7389162561576355,0.26108374384236455,143,43,42,58,138,5,0.3006993006993007,0.2937062937062937,0.40559440559440557,0.965034965034965,0.03496503496503497
8931,295,252,43,245,50,0.8542372881355932,0.14576271186440679,0.8305084745762712,0.1694915254237288,191,19,60,112,185,6,0.09947643979057591,0.31413612565445026,0.5863874345549738,0.9685863874345549,0.031413612565445025
8932,294,252,42,245,49,0.8571428571428571,0.14285714285714285,0.8333333333333334,0.16666666666666666,191,19,60,112,185,6,0.09947643979057591,0.31413612565445026,0.5863874345549738,0.9685863874345549,0.031413612565445025
8933,358,246,112,311,47,0.6871508379888268,0.3128491620111732,0.8687150837988827,0.13128491620111732,191,19,60,112,185,6,0.09947643979057591,0.31413612565445026,0.5863874345549738,0.9685863874345549,0.031413612565445025
8934,85,85,0,68,17,1.0,0.0,0.8,0.2,3,0,0,3,3,0,0.0,0.0,1.0,1.0,0.0
8935,288,239,49,235,53,0.8298611111111112,0.1701388888888889,0.8159722222222222,0.1840277777777778,221,23,67,131,214,7,0.10407239819004525,0.3031674208144796,0.5927601809954751,0.9683257918552036,0.03167420814479638
8936,337,252,85,290,47,0.7477744807121661,0.2522255192878338,0.8605341246290801,0.1394658753709199,191,19,60,112,185,6,0.09947643979057591,0.31413612565445026,0.5863874345549738,0.9685863874345549,0.031413612565445025
8937,385,282,103,333,52,0.7324675324675325,0.2675324675324675,0.8649350649350649,0.13506493506493505,221,23,67,131,214,7,0.10407239819004525,0.3031674208144796,0.5927601809954751,0.9683257918552036,0.03167420814479638
8938,36,36,0,19,17,1.0,0.0,0.5277777777777778,0.4722222222222222,7,0,0,7,6,1,0.0,0.0,1.0,0.8571428571428571,0.14285714285714285
8939,315,249,66,268,47,0.7904761904761904,0.20952380952380953,0.8507936507936508,0.1492063492063492,191,19,60,112,185,6,0.09947643979057591,0.31413612565445026,0.5863874345549738,0.9685863874345549,0.031413612565445025
8940,4770,3696,1074,3886,884,0.7748427672955975,0.22515723270440252,0.8146750524109014,0.18532494758909854,1708,93,306,1309,1213,495,0.05444964871194379,0.1791569086651054,0.7663934426229508,0.7101873536299765,0.2898126463700234
8941,135,114,21,108,27,0.8444444444444444,0.15555555555555556,0.8,0.2,188,2,13,173,174,14,0.010638297872340425,0.06914893617021277,0.9202127659574468,0.925531914893617,0.07446808510638298
8942,336,260,76,285,51,0.7738095238095238,0.2261904761904762,0.8482142857142857,0.15178571428571427,191,19,60,112,185,6,0.09947643979057591,0.31413612565445026,0.5863874345549738,0.9685863874345549,0.031413612565445025
8943,38,38,0,20,18,1.0,0.0,0.5263157894736842,0.47368421052631576,27,0,0,27,25,2,0.0,0.0,1.0,0.9259259259259259,0.07407407407407407
8944,309,255,54,258,51,0.8252427184466019,0.17475728155339806,0.8349514563106796,0.1650485436893204,221,23,67,131,214,7,0.10407239819004525,0.3031674208144796,0.5927601809954751,0.9683257918552036,0.03167420814479638
8945,1541,1307,234,1222,319,0.8481505515898767,0.1518494484101233,0.7929915639195327,0.20700843608046723,83,18,19,46,75,8,0.21686746987951808,0.2289156626506024,0.5542168674698795,0.9036144578313253,0.0963855421686747
8946,364,253,111,315,49,0.695054945054945,0.30494505494505497,0.8653846153846154,0.1346153846153846,191,19,60,112,185,6,0.09947643979057591,0.31413612565445026,0.5863874345549738,0.9685863874345549,0.031413612565445025
8947,1931,1912,19,1416,515,0.9901605385810461,0.00983946141895391,0.7332988089073019,0.2667011910926981,292,116,22,154,281,11,0.3972602739726027,0.07534246575342465,0.5273972602739726,0.9623287671232876,0.03767123287671233
8948,40,1,39,21,19,0.025,0.975,0.525,0.475,376,94,63,219,318,58,0.25,0.1675531914893617,0.5824468085106383,0.8457446808510638,0.15425531914893617
8949,385,273,112,329,56,0.7090909090909091,0.2909090909090909,0.8545454545454545,0.14545454545454545,191,19,60,112,185,6,0.09947643979057591,0.31413612565445026,0.5863874345549738,0.9685863874345549,0.031413612565445025
8950,1161,1031,130,976,185,0.8880275624461671,0.1119724375538329,0.8406546080964685,0.15934539190353145,179,16,30,133,171,8,0.0893854748603352,0.16759776536312848,0.7430167597765364,0.9553072625698324,0.0446927374301676
8951,172,150,22,126,46,0.872093023255814,0.12790697674418605,0.7325581395348837,0.26744186046511625,291,27,56,208,280,11,0.09278350515463918,0.19243986254295534,0.7147766323024055,0.9621993127147767,0.037800687285223365
8952,216,167,49,144,72,0.7731481481481481,0.22685185185185186,0.6666666666666666,0.3333333333333333,348,0,268,80,324,24,0.0,0.7701149425287356,0.22988505747126436,0.9310344827586207,0.06896551724137931
8953,4378,3294,1084,2492,1886,0.7523983554134308,0.24760164458656922,0.5692096847875743,0.4307903152124258,1752,61,400,1291,1638,114,0.034817351598173514,0.228310502283105,0.7368721461187214,0.934931506849315,0.06506849315068493
8954,340,243,97,288,52,0.7147058823529412,0.2852941176470588,0.8470588235294118,0.15294117647058825,221,23,67,131,214,7,0.10407239819004525,0.3031674208144796,0.5927601809954751,0.9683257918552036,0.03167420814479638
8955,480,268,212,362,118,0.5583333333333333,0.44166666666666665,0.7541666666666667,0.24583333333333332,454,14,255,185,448,6,0.030837004405286344,0.5616740088105727,0.40748898678414097,0.986784140969163,0.013215859030837005
8956,332,226,106,283,49,0.6807228915662651,0.3192771084337349,0.8524096385542169,0.14759036144578314,212,23,64,125,205,7,0.10849056603773585,0.3018867924528302,0.589622641509434,0.9669811320754716,0.0330188679245283
8957,201,159,42,157,44,0.7910447761194029,0.208955223880597,0.7810945273631841,0.21890547263681592,177,16,36,125,170,7,0.0903954802259887,0.2033898305084746,0.7062146892655368,0.96045197740113,0.03954802259887006
8958,708,502,206,546,162,0.7090395480225988,0.2909604519774011,0.7711864406779662,0.2288135593220339,98,18,22,58,90,8,0.1836734693877551,0.22448979591836735,0.5918367346938775,0.9183673469387755,0.08163265306122448
8959,299,244,55,255,44,0.8160535117056856,0.18394648829431437,0.8528428093645485,0.14715719063545152,191,19,60,112,185,6,0.09947643979057591,0.31413612565445026,0.5863874345549738,0.9685863874345549,0.031413612565445025
8960,273,249,24,195,78,0.9120879120879121,0.08791208791208792,0.7142857142857143,0.2857142857142857,395,136,226,33,393,2,0.34430379746835443,0.5721518987341773,0.08354430379746836,0.9949367088607595,0.005063291139240506
8961,155,128,27,122,33,0.8258064516129032,0.17419354838709677,0.7870967741935484,0.2129032258064516,145,17,26,102,141,4,0.11724137931034483,0.1793103448275862,0.7034482758620689,0.9724137931034482,0.027586206896551724
8962,172,145,27,123,49,0.8430232558139535,0.1569767441860465,0.7151162790697675,0.28488372093023256,188,28,34,126,176,12,0.14893617021276595,0.18085106382978725,0.6702127659574468,0.9361702127659575,0.06382978723404255
8963,294,251,43,246,48,0.8537414965986394,0.14625850340136054,0.8367346938775511,0.16326530612244897,191,19,60,112,185,6,0.09947643979057591,0.31413612565445026,0.5863874345549738,0.9685863874345549,0.031413612565445025
8964,352,255,97,298,54,0.7244318181818182,0.2755681818181818,0.8465909090909091,0.1534090909090909,191,19,60,112,185,6,0.09947643979057591,0.31413612565445026,0.5863874345549738,0.9685863874345549,0.031413612565445025
8965,412,302,110,358,54,0.7330097087378641,0.2669902912621359,0.8689320388349514,0.13106796116504854,191,19,60,112,185,6,0.09947643979057591,0.31413612565445026,0.5863874345549738,0.9685863874345549,0.031413612565445025
8966,330,242,88,285,45,0.7333333333333333,0.26666666666666666,0.8636363636363636,0.13636363636363635,191,19,60,112,185,6,0.09947643979057591,0.31413612565445026,0.5863874345549738,0.9685863874345549,0.031413612565445025
8967,170,146,24,123,47,0.8588235294117647,0.1411764705882353,0.7235294117647059,0.27647058823529413,358,29,61,268,343,15,0.08100558659217877,0.17039106145251395,0.7486033519553073,0.9581005586592178,0.04189944134078212
8968,315,259,56,271,44,0.8222222222222222,0.17777777777777778,0.8603174603174604,0.13968253968253969,161,21,58,82,158,3,0.13043478260869565,0.36024844720496896,0.5093167701863354,0.9813664596273292,0.018633540372670808
8969,307,223,84,258,49,0.7263843648208469,0.2736156351791531,0.8403908794788274,0.15960912052117263,212,23,64,125,205,7,0.10849056603773585,0.3018867924528302,0.589622641509434,0.9669811320754716,0.0330188679245283
8970,288,244,44,242,46,0.8472222222222222,0.1527777777777778,0.8402777777777778,0.1597222222222222,191,19,60,112,185,6,0.09947643979057591,0.31413612565445026,0.5863874345549738,0.9685863874345549,0.031413612565445025
8971,386,287,99,336,50,0.7435233160621761,0.25647668393782386,0.8704663212435233,0.12953367875647667,221,23,67,131,214,7,0.10407239819004525,0.3031674208144796,0.5927601809954751,0.9683257918552036,0.03167420814479638
8972,758,661,97,610,148,0.8720316622691293,0.1279683377308707,0.8047493403693932,0.19525065963060687,75,15,16,44,68,7,0.2,0.21333333333333335,0.5866666666666667,0.9066666666666666,0.09333333333333334
8973,371,261,110,315,56,0.7035040431266847,0.29649595687331537,0.8490566037735849,0.1509433962264151,191,19,60,112,185,6,0.09947643979057591,0.31413612565445026,0.5863874345549738,0.9685863874345549,0.031413612565445025
8974,337,234,103,286,51,0.6943620178041543,0.3056379821958457,0.8486646884272997,0.1513353115727003,221,23,67,131,214,7,0.10407239819004525,0.3031674208144796,0.5927601809954751,0.9683257918552036,0.03167420814479638
8975,326,289,37,266,60,0.8865030674846626,0.11349693251533742,0.8159509202453987,0.18404907975460122,126,1,13,112,122,4,0.007936507936507936,0.10317460317460317,0.8888888888888888,0.9682539682539683,0.031746031746031744
8976,41,41,0,22,19,1.0,0.0,0.5365853658536586,0.4634146341463415,7,0,0,7,6,1,0.0,0.0,1.0,0.8571428571428571,0.14285714285714285
8977,2718,2164,554,2389,329,0.7961736571008095,0.20382634289919058,0.8789551140544518,0.1210448859455482,1056,128,330,598,991,65,0.12121212121212122,0.3125,0.5662878787878788,0.9384469696969697,0.061553030303030304
8978,170,142,28,128,42,0.8352941176470589,0.16470588235294117,0.7529411764705882,0.24705882352941178,389,28,56,305,369,20,0.07197943444730077,0.14395886889460155,0.7840616966580977,0.9485861182519281,0.05141388174807198
8979,155,127,28,120,35,0.8193548387096774,0.18064516129032257,0.7741935483870968,0.22580645161290322,185,30,27,128,173,12,0.16216216216216217,0.14594594594594595,0.6918918918918919,0.9351351351351351,0.06486486486486487
8980,355,245,110,311,44,0.6901408450704225,0.30985915492957744,0.8760563380281691,0.12394366197183099,191,19,60,112,185,6,0.09947643979057591,0.31413612565445026,0.5863874345549738,0.9685863874345549,0.031413612565445025
8981,324,233,91,273,51,0.7191358024691358,0.2808641975308642,0.8425925925925926,0.1574074074074074,161,21,58,82,158,3,0.13043478260869565,0.36024844720496896,0.5093167701863354,0.9813664596273292,0.018633540372670808
8982,321,250,71,270,51,0.778816199376947,0.22118380062305296,0.8411214953271028,0.1588785046728972,191,19,60,112,185,6,0.09947643979057591,0.31413612565445026,0.5863874345549738,0.9685863874345549,0.031413612565445025
8983,369,255,114,319,50,0.6910569105691057,0.3089430894308943,0.8644986449864499,0.13550135501355012,191,19,60,112,185,6,0.09947643979057591,0.31413612565445026,0.5863874345549738,0.9685863874345549,0.031413612565445025
8984,386,280,106,335,51,0.7253886010362695,0.27461139896373055,0.8678756476683938,0.13212435233160622,191,19,60,112,185,6,0.09947643979057591,0.31413612565445026,0.5863874345549738,0.9685863874345549,0.031413612565445025
8985,394,315,79,320,74,0.799492385786802,0.20050761421319796,0.8121827411167513,0.18781725888324874,90,15,22,53,85,5,0.16666666666666666,0.24444444444444444,0.5888888888888889,0.9444444444444444,0.05555555555555555
8986,1535,1301,234,1223,312,0.847557003257329,0.152442996742671,0.796742671009772,0.20325732899022803,107,18,20,69,100,7,0.16822429906542055,0.18691588785046728,0.6448598130841121,0.9345794392523364,0.06542056074766354
8987,327,223,104,279,48,0.6819571865443425,0.3180428134556575,0.8532110091743119,0.14678899082568808,212,23,64,125,205,7,0.10849056603773585,0.3018867924528302,0.589622641509434,0.9669811320754716,0.0330188679245283
8988,942,799,143,728,214,0.8481953290870489,0.15180467091295116,0.772823779193206,0.22717622080679406,143,48,68,27,143,0,0.3356643356643357,0.4755244755244755,0.1888111888111888,1.0,0.0
8989,202,177,25,160,42,0.8762376237623762,0.12376237623762376,0.7920792079207921,0.2079207920792079,135,14,85,36,132,3,0.1037037037037037,0.6296296296296297,0.26666666666666666,0.9777777777777777,0.022222222222222223
8990,290,245,45,242,48,0.8448275862068966,0.15517241379310345,0.8344827586206897,0.16551724137931034,191,19,60,112,185,6,0.09947643979057591,0.31413612565445026,0.5863874345549738,0.9685863874345549,0.031413612565445025
8991,215,164,51,143,72,0.7627906976744186,0.2372093023255814,0.6651162790697674,0.33488372093023255,295,0,230,65,267,28,0.0,0.7796610169491526,0.22033898305084745,0.9050847457627119,0.09491525423728814
8992,364,257,107,312,52,0.7060439560439561,0.29395604395604397,0.8571428571428571,0.14285714285714285,221,23,67,131,214,7,0.10407239819004525,0.3031674208144796,0.5927601809954751,0.9683257918552036,0.03167420814479638
8993,383,279,104,343,40,0.7284595300261096,0.27154046997389036,0.8955613577023499,0.10443864229765012,112,16,19,77,110,2,0.14285714285714285,0.16964285714285715,0.6875,0.9821428571428571,0.017857142857142856
8994,181,157,24,134,47,0.8674033149171271,0.13259668508287292,0.7403314917127072,0.2596685082872928,356,34,55,267,341,15,0.09550561797752809,0.1544943820224719,0.75,0.9578651685393258,0.042134831460674156
8995,340,262,78,286,54,0.7705882352941177,0.22941176470588234,0.8411764705882353,0.1588235294117647,191,19,60,112,185,6,0.09947643979057591,0.31413612565445026,0.5863874345549738,0.9685863874345549,0.031413612565445025
8996,1115,959,156,902,213,0.8600896860986547,0.13991031390134528,0.8089686098654708,0.19103139013452916,52,10,8,34,48,4,0.19230769230769232,0.15384615384615385,0.6538461538461539,0.9230769230769231,0.07692307692307693
8997,355,245,110,310,45,0.6901408450704225,0.30985915492957744,0.8732394366197183,0.1267605633802817,191,19,60,112,185,6,0.09947643979057591,0.31413612565445026,0.5863874345549738,0.9685863874345549,0.031413612565445025
8998,325,236,89,275,50,0.7261538461538461,0.27384615384615385,0.8461538461538461,0.15384615384615385,193,23,56,114,185,8,0.11917098445595854,0.29015544041450775,0.5906735751295337,0.9585492227979274,0.04145077720207254
8999,419,308,111,367,52,0.7350835322195705,0.2649164677804296,0.8758949880668258,0.12410501193317422,191,19,60,112,185,6,0.09947643979057591,0.31413612565445026,0.5863874345549738,0.9685863874345549,0.031413612565445025
9000,36,36,0,19,17,1.0,0.0,0.5277777777777778,0.4722222222222222,7,0,0,7,6,1,0.0,0.0,1.0,0.8571428571428571,0.14285714285714285
9001,341,244,97,286,55,0.7155425219941349,0.2844574780058651,0.8387096774193549,0.16129032258064516,221,23,67,131,214,7,0.10407239819004525,0.3031674208144796,0.5927601809954751,0.9683257918552036,0.03167420814479638
9002,898,800,98,727,171,0.89086859688196,0.1091314031180401,0.8095768374164811,0.19042316258351893,147,42,85,20,146,1,0.2857142857142857,0.5782312925170068,0.1360544217687075,0.9931972789115646,0.006802721088435374
9003,127,108,19,95,32,0.8503937007874016,0.14960629921259844,0.7480314960629921,0.25196850393700787,260,2,25,233,240,20,0.007692307692307693,0.09615384615384616,0.8961538461538462,0.9230769230769231,0.07692307692307693
9004,335,229,106,290,45,0.6835820895522388,0.3164179104477612,0.8656716417910447,0.13432835820895522,221,23,67,131,214,7,0.10407239819004525,0.3031674208144796,0.5927601809954751,0.9683257918552036,0.03167420814479638
9005,360,249,111,313,47,0.6916666666666667,0.30833333333333335,0.8694444444444445,0.13055555555555556,191,19,60,112,185,6,0.09947643979057591,0.31413612565445026,0.5863874345549738,0.9685863874345549,0.031413612565445025
9006,321,246,75,278,43,0.7663551401869159,0.2336448598130841,0.8660436137071651,0.13395638629283488,191,19,60,112,185,6,0.09947643979057591,0.31413612565445026,0.5863874345549738,0.9685863874345549,0.031413612565445025
9007,299,250,49,249,50,0.8361204013377926,0.16387959866220736,0.8327759197324415,0.16722408026755853,191,19,60,112,185,6,0.09947643979057591,0.31413612565445026,0.5863874345549738,0.9685863874345549,0.031413612565445025
9008,427,400,27,388,39,0.936768149882904,0.06323185011709602,0.9086651053864169,0.09133489461358314,1038,210,469,359,991,47,0.2023121387283237,0.45183044315992293,0.34585741811175336,0.9547206165703276,0.04527938342967245
9009,359,247,112,313,46,0.6880222841225627,0.31197771587743733,0.871866295264624,0.12813370473537605,191,19,60,112,185,6,0.09947643979057591,0.31413612565445026,0.5863874345549738,0.9685863874345549,0.031413612565445025
9010,396,300,96,347,49,0.7575757575757576,0.24242424242424243,0.8762626262626263,0.12373737373737374,191,19,60,112,185,6,0.09947643979057591,0.31413612565445026,0.5863874345549738,0.9685863874345549,0.031413612565445025
9011,14398,11576,2822,10424,3974,0.8040005556327268,0.19599944436727323,0.7239894429781915,0.2760105570218086,7439,308,1402,5729,6836,603,0.04140341443742439,0.18846619169243178,0.7701303938701438,0.9189407178384191,0.08105928216158086
9012,294,247,47,246,48,0.8401360544217688,0.1598639455782313,0.8367346938775511,0.16326530612244897,191,19,60,112,185,6,0.09947643979057591,0.31413612565445026,0.5863874345549738,0.9685863874345549,0.031413612565445025
9013,853,692,161,651,202,0.8112543962485346,0.18874560375146543,0.7631887456037515,0.23681125439624853,99,15,18,66,91,8,0.15151515151515152,0.18181818181818182,0.6666666666666666,0.9191919191919192,0.08080808080808081
9014,350,311,39,282,68,0.8885714285714286,0.11142857142857143,0.8057142857142857,0.19428571428571428,60,1,4,55,48,12,0.016666666666666666,0.06666666666666667,0.9166666666666666,0.8,0.2
9015,358,249,109,308,50,0.6955307262569832,0.30446927374301674,0.8603351955307262,0.13966480446927373,191,19,60,112,185,6,0.09947643979057591,0.31413612565445026,0.5863874345549738,0.9685863874345549,0.031413612565445025
9016,335,230,105,288,47,0.6865671641791045,0.31343283582089554,0.8597014925373134,0.14029850746268657,221,23,67,131,214,7,0.10407239819004525,0.3031674208144796,0.5927601809954751,0.9683257918552036,0.03167420814479638
9017,341,237,104,291,50,0.6950146627565983,0.30498533724340177,0.8533724340175953,0.1466275659824047,221,23,67,131,214,7,0.10407239819004525,0.3031674208144796,0.5927601809954751,0.9683257918552036,0.03167420814479638
9018,380,280,100,341,39,0.7368421052631579,0.2631578947368421,0.8973684210526316,0.10263157894736842,113,3,3,107,109,4,0.02654867256637168,0.02654867256637168,0.9469026548672567,0.9646017699115044,0.035398230088495575
9019,312,221,91,270,42,0.7083333333333334,0.2916666666666667,0.8653846153846154,0.1346153846153846,161,21,58,82,158,3,0.13043478260869565,0.36024844720496896,0.5093167701863354,0.9813664596273292,0.018633540372670808
9020,305,241,64,261,44,0.7901639344262295,0.2098360655737705,0.8557377049180328,0.14426229508196722,191,19,60,112,185,6,0.09947643979057591,0.31413612565445026,0.5863874345549738,0.9685863874345549,0.031413612565445025
9021,336,253,83,287,49,0.7529761904761905,0.24702380952380953,0.8541666666666666,0.14583333333333334,191,19,60,112,185,6,0.09947643979057591,0.31413612565445026,0.5863874345549738,0.9685863874345549,0.031413612565445025
9022,1139,1125,14,1132,7,0.9877085162423178,0.012291483757682178,0.9938542581211589,0.006145741878841089,318,3,86,229,189,129,0.009433962264150943,0.27044025157232704,0.720125786163522,0.5943396226415094,0.4056603773584906
9023,360,250,110,305,55,0.6944444444444444,0.3055555555555556,0.8472222222222222,0.1527777777777778,191,19,60,112,185,6,0.09947643979057591,0.31413612565445026,0.5863874345549738,0.9685863874345549,0.031413612565445025
9024,325,247,78,279,46,0.76,0.24,0.8584615384615385,0.14153846153846153,191,19,60,112,185,6,0.09947643979057591,0.31413612565445026,0.5863874345549738,0.9685863874345549,0.031413612565445025
9025,274,236,38,222,52,0.8613138686131386,0.1386861313868613,0.8102189781021898,0.1897810218978102,221,23,67,131,214,7,0.10407239819004525,0.3031674208144796,0.5927601809954751,0.9683257918552036,0.03167420814479638
9026,351,258,93,297,54,0.7350427350427351,0.26495726495726496,0.8461538461538461,0.15384615384615385,191,19,60,112,185,6,0.09947643979057591,0.31413612565445026,0.5863874345549738,0.9685863874345549,0.031413612565445025
9027,387,277,110,321,66,0.7157622739018088,0.2842377260981912,0.8294573643410853,0.17054263565891473,191,19,60,112,185,6,0.09947643979057591,0.31413612565445026,0.5863874345549738,0.9685863874345549,0.031413612565445025
9028,266,225,41,218,48,0.8458646616541353,0.15413533834586465,0.8195488721804511,0.18045112781954886,161,21,58,82,158,3,0.13043478260869565,0.36024844720496896,0.5093167701863354,0.9813664596273292,0.018633540372670808
9029,357,306,51,308,49,0.8571428571428571,0.14285714285714285,0.8627450980392157,0.13725490196078433,191,19,60,112,185,6,0.09947643979057591,0.31413612565445026,0.5863874345549738,0.9685863874345549,0.031413612565445025
9030,357,245,112,312,45,0.6862745098039216,0.3137254901960784,0.8739495798319328,0.12605042016806722,191,19,60,112,185,6,0.09947643979057591,0.31413612565445026,0.5863874345549738,0.9685863874345549,0.031413612565445025
9031,4782,3966,816,3987,795,0.8293601003764115,0.17063989962358847,0.8337515683814304,0.16624843161856964,1375,123,274,978,1027,348,0.08945454545454545,0.19927272727272727,0.7112727272727273,0.7469090909090909,0.2530909090909091
9032,405,297,108,354,51,0.7333333333333333,0.26666666666666666,0.8740740740740741,0.1259259259259259,113,16,19,78,109,4,0.1415929203539823,0.168141592920354,0.6902654867256637,0.9646017699115044,0.035398230088495575
9033,3573,2597,976,2078,1495,0.7268401903162608,0.27315980968373915,0.5815841029946823,0.41841589700531767,1626,25,384,1217,1489,137,0.015375153751537515,0.23616236162361623,0.7484624846248462,0.9157441574415744,0.08425584255842558
9034,382,59,323,228,154,0.1544502617801047,0.8455497382198953,0.5968586387434555,0.4031413612565445,49,0,2,47,37,12,0.0,0.04081632653061224,0.9591836734693877,0.7551020408163265,0.24489795918367346
9035,299,250,49,251,48,0.8361204013377926,0.16387959866220736,0.8394648829431438,0.1605351170568562,191,19,60,112,185,6,0.09947643979057591,0.31413612565445026,0.5863874345549738,0.9685863874345549,0.031413612565445025
9036,141,119,22,111,30,0.8439716312056738,0.15602836879432624,0.7872340425531915,0.2127659574468085,177,2,24,151,162,15,0.011299435028248588,0.13559322033898305,0.8531073446327684,0.9152542372881356,0.0847457627118644
9037,337,233,104,286,51,0.6913946587537092,0.3086053412462908,0.8486646884272997,0.1513353115727003,221,23,67,131,214,7,0.10407239819004525,0.3031674208144796,0.5927601809954751,0.9683257918552036,0.03167420814479638
9038,351,278,73,285,66,0.792022792022792,0.20797720797720798,0.811965811965812,0.18803418803418803,189,19,64,106,182,7,0.10052910052910052,0.3386243386243386,0.5608465608465608,0.9629629629629629,0.037037037037037035
9039,348,246,102,292,56,0.7068965517241379,0.29310344827586204,0.8390804597701149,0.16091954022988506,221,23,67,131,214,7,0.10407239819004525,0.3031674208144796,0.5927601809954751,0.9683257918552036,0.03167420814479638
9040,302,245,57,256,46,0.8112582781456954,0.18874172185430463,0.847682119205298,0.152317880794702,191,19,60,112,185,6,0.09947643979057591,0.31413612565445026,0.5863874345549738,0.9685863874345549,0.031413612565445025
9041,132,111,21,105,27,0.8409090909090909,0.1590909090909091,0.7954545454545454,0.20454545454545456,258,2,25,231,240,18,0.007751937984496124,0.09689922480620156,0.8953488372093024,0.9302325581395349,0.06976744186046512
9042,176,153,23,137,39,0.8693181818181818,0.13068181818181818,0.7784090909090909,0.2215909090909091,325,113,106,106,307,18,0.3476923076923077,0.3261538461538461,0.3261538461538461,0.9446153846153846,0.055384615384615386
9043,363,252,111,315,48,0.6942148760330579,0.30578512396694213,0.8677685950413223,0.1322314049586777,191,19,60,112,185,6,0.09947643979057591,0.31413612565445026,0.5863874345549738,0.9685863874345549,0.031413612565445025
9044,345,263,82,293,52,0.7623188405797101,0.23768115942028986,0.8492753623188406,0.15072463768115943,221,23,67,131,214,7,0.10407239819004525,0.3031674208144796,0.5927601809954751,0.9683257918552036,0.03167420814479638
9045,758,450,308,437,321,0.5936675461741425,0.40633245382585753,0.5765171503957783,0.4234828496042216,4278,237,1328,2713,3063,1215,0.05539971949509116,0.31042543244506776,0.634174848059841,0.7159887798036466,0.28401122019635344
9046,359,247,112,311,48,0.6880222841225627,0.31197771587743733,0.8662952646239555,0.13370473537604458,191,19,60,112,185,6,0.09947643979057591,0.31413612565445026,0.5863874345549738,0.9685863874345549,0.031413612565445025
9047,394,323,71,305,89,0.8197969543147208,0.1802030456852792,0.7741116751269036,0.22588832487309646,86,16,48,22,85,1,0.18604651162790697,0.5581395348837209,0.2558139534883721,0.9883720930232558,0.011627906976744186
9048,304,265,39,248,56,0.8717105263157895,0.12828947368421054,0.8157894736842105,0.18421052631578946,221,23,67,131,214,7,0.10407239819004525,0.3031674208144796,0.5927601809954751,0.9683257918552036,0.03167420814479638
9049,321,229,92,271,50,0.7133956386292835,0.2866043613707165,0.8442367601246106,0.1557632398753894,161,21,58,82,158,3,0.13043478260869565,0.36024844720496896,0.5093167701863354,0.9813664596273292,0.018633540372670808
9050,3705,3701,4,3702,3,0.9989203778677462,0.0010796221322537112,0.9991902834008097,0.0008097165991902834,206,0,73,133,107,99,0.0,0.35436893203883496,0.6456310679611651,0.5194174757281553,0.48058252427184467
9051,689,602,87,660,29,0.8737300435413643,0.1262699564586357,0.9579100145137881,0.0420899854862119,344,101,92,151,324,20,0.2936046511627907,0.26744186046511625,0.438953488372093,0.9418604651162791,0.05813953488372093
9052,1859,1857,2,1856,3,0.9989241527703067,0.0010758472296933835,0.9983862291554599,0.0016137708445400753,333,0,77,256,196,137,0.0,0.23123123123123124,0.7687687687687688,0.5885885885885885,0.4114114114114114
9053,168,148,20,119,49,0.8809523809523809,0.11904761904761904,0.7083333333333334,0.2916666666666667,284,131,38,115,276,8,0.4612676056338028,0.13380281690140844,0.40492957746478875,0.971830985915493,0.028169014084507043
9054,302,249,53,245,57,0.8245033112582781,0.17549668874172186,0.8112582781456954,0.18874172185430463,221,23,67,131,214,7,0.10407239819004525,0.3031674208144796,0.5927601809954751,0.9683257918552036,0.03167420814479638
9055,360,250,110,311,49,0.6944444444444444,0.3055555555555556,0.8638888888888889,0.1361111111111111,191,19,60,112,185,6,0.09947643979057591,0.31413612565445026,0.5863874345549738,0.9685863874345549,0.031413612565445025
9056,1597,1486,111,1549,48,0.9304946775203506,0.06950532247964934,0.9699436443331246,0.03005635566687539,191,19,60,112,185,6,0.09947643979057591,0.31413612565445026,0.5863874345549738,0.9685863874345549,0.031413612565445025
9057,466,385,81,340,126,0.8261802575107297,0.17381974248927037,0.7296137339055794,0.2703862660944206,138,12,19,107,125,13,0.08695652173913043,0.13768115942028986,0.7753623188405797,0.9057971014492754,0.09420289855072464
9058,899,858,41,839,60,0.9543937708565072,0.04560622914349277,0.9332591768631813,0.06674082313681869,221,23,67,131,214,7,0.10407239819004525,0.3031674208144796,0.5927601809954751,0.9683257918552036,0.03167420814479638
9059,850,688,162,659,191,0.8094117647058824,0.19058823529411764,0.7752941176470588,0.22470588235294117,78,15,18,45,71,7,0.19230769230769232,0.23076923076923078,0.5769230769230769,0.9102564102564102,0.08974358974358974
9060,398,293,105,349,49,0.7361809045226131,0.2638190954773869,0.8768844221105527,0.12311557788944724,221,23,67,131,214,7,0.10407239819004525,0.3031674208144796,0.5927601809954751,0.9683257918552036,0.03167420814479638
9061,1249,1014,235,928,321,0.8118494795836669,0.18815052041633307,0.7429943955164131,0.2570056044835869,139,37,43,59,135,4,0.26618705035971224,0.30935251798561153,0.4244604316546763,0.9712230215827338,0.02877697841726619
9062,356,245,111,309,47,0.6882022471910112,0.31179775280898875,0.8679775280898876,0.13202247191011235,191,19,60,112,185,6,0.09947643979057591,0.31413612565445026,0.5863874345549738,0.9685863874345549,0.031413612565445025
9063,339,234,105,290,49,0.6902654867256637,0.30973451327433627,0.855457227138643,0.14454277286135694,221,23,67,131,214,7,0.10407239819004525,0.3031674208144796,0.5927601809954751,0.9683257918552036,0.03167420814479638
9064,364,252,112,315,49,0.6923076923076923,0.3076923076923077,0.8653846153846154,0.1346153846153846,191,19,60,112,185,6,0.09947643979057591,0.31413612565445026,0.5863874345549738,0.9685863874345549,0.031413612565445025
9065,318,226,92,269,49,0.710691823899371,0.2893081761006289,0.8459119496855346,0.1540880503144654,161,21,58,82,158,3,0.13043478260869565,0.36024844720496896,0.5093167701863354,0.9813664596273292,0.018633540372670808
9066,414,302,112,365,49,0.7294685990338164,0.27053140096618356,0.8816425120772947,0.11835748792270531,191,19,60,112,185,6,0.09947643979057591,0.31413612565445026,0.5863874345549738,0.9685863874345549,0.031413612565445025
9067,425,353,72,359,66,0.8305882352941176,0.16941176470588235,0.8447058823529412,0.15529411764705883,132,4,40,88,123,9,0.030303030303030304,0.30303030303030304,0.6666666666666666,0.9318181818181818,0.06818181818181818
9068,81,81,0,65,16,1.0,0.0,0.8024691358024691,0.19753086419753085,3,0,0,3,3,0,0.0,0.0,1.0,1.0,0.0
9069,366,261,105,311,55,0.7131147540983607,0.28688524590163933,0.8497267759562842,0.15027322404371585,221,23,67,131,214,7,0.10407239819004525,0.3031674208144796,0.5927601809954751,0.9683257918552036,0.03167420814479638
9070,688,556,132,536,152,0.8081395348837209,0.19186046511627908,0.7790697674418605,0.22093023255813954,137,41,76,20,136,1,0.29927007299270075,0.5547445255474452,0.145985401459854,0.9927007299270073,0.0072992700729927005
9071,411,347,64,301,110,0.8442822384428224,0.15571776155717762,0.732360097323601,0.26763990267639903,91,19,40,32,90,1,0.2087912087912088,0.43956043956043955,0.3516483516483517,0.989010989010989,0.01098901098901099
9072,7248,6641,607,4582,2666,0.9162527593818984,0.08374724061810154,0.6321743929359823,0.3678256070640177,2582,400,308,1874,2092,490,0.15491866769945778,0.1192873741285825,0.7257939581719597,0.8102246320681642,0.18977536793183578
9073,323,228,95,274,49,0.7058823529411765,0.29411764705882354,0.848297213622291,0.15170278637770898,161,21,58,82,158,3,0.13043478260869565,0.36024844720496896,0.5093167701863354,0.9813664596273292,0.018633540372670808
9074,1131,975,156,902,229,0.8620689655172413,0.13793103448275862,0.7975243147656941,0.20247568523430592,79,18,19,42,72,7,0.22784810126582278,0.24050632911392406,0.5316455696202531,0.9113924050632911,0.08860759493670886
9075,322,230,92,275,47,0.7142857142857143,0.2857142857142857,0.8540372670807453,0.14596273291925466,161,21,58,82,158,3,0.13043478260869565,0.36024844720496896,0.5093167701863354,0.9813664596273292,0.018633540372670808
9076,343,238,105,292,51,0.6938775510204082,0.30612244897959184,0.8513119533527697,0.14868804664723032,221,23,67,131,214,7,0.10407239819004525,0.3031674208144796,0.5927601809954751,0.9683257918552036,0.03167420814479638
9077,320,249,71,270,50,0.778125,0.221875,0.84375,0.15625,191,19,60,112,185,6,0.09947643979057591,0.31413612565445026,0.5863874345549738,0.9685863874345549,0.031413612565445025
9078,365,257,108,315,50,0.7041095890410959,0.2958904109589041,0.863013698630137,0.136986301369863,191,19,60,112,185,6,0.09947643979057591,0.31413612565445026,0.5863874345549738,0.9685863874345549,0.031413612565445025
9079,480,268,212,362,118,0.5583333333333333,0.44166666666666665,0.7541666666666667,0.24583333333333332,454,14,255,185,448,6,0.030837004405286344,0.5616740088105727,0.40748898678414097,0.986784140969163,0.013215859030837005
9080,347,244,103,292,55,0.7031700288184438,0.2968299711815562,0.8414985590778098,0.1585014409221902,221,23,67,131,214,7,0.10407239819004525,0.3031674208144796,0.5927601809954751,0.9683257918552036,0.03167420814479638
9081,370,257,113,319,51,0.6945945945945946,0.3054054054054054,0.8621621621621621,0.13783783783783785,191,19,60,112,185,6,0.09947643979057591,0.31413612565445026,0.5863874345549738,0.9685863874345549,0.031413612565445025
9082,341,240,101,290,51,0.7038123167155426,0.2961876832844575,0.8504398826979472,0.1495601173020528,221,23,67,131,214,7,0.10407239819004525,0.3031674208144796,0.5927601809954751,0.9683257918552036,0.03167420814479638
9083,366,321,45,316,50,0.8770491803278688,0.12295081967213115,0.8633879781420765,0.1366120218579235,191,19,60,112,185,6,0.09947643979057591,0.31413612565445026,0.5863874345549738,0.9685863874345549,0.031413612565445025
9084,2937,2242,695,2020,917,0.7633639768471229,0.23663602315287707,0.6877766428328226,0.3122233571671774,1735,99,399,1237,1386,349,0.057060518731988474,0.22997118155619597,0.7129682997118155,0.7988472622478386,0.2011527377521614
9085,285,245,40,239,46,0.8596491228070176,0.14035087719298245,0.8385964912280702,0.16140350877192983,191,19,60,112,185,6,0.09947643979057591,0.31413612565445026,0.5863874345549738,0.9685863874345549,0.031413612565445025
9086,359,246,113,314,45,0.6852367688022284,0.3147632311977716,0.8746518105849582,0.12534818941504178,191,19,60,112,185,6,0.09947643979057591,0.31413612565445026,0.5863874345549738,0.9685863874345549,0.031413612565445025
9087,334,239,95,290,44,0.7155688622754491,0.2844311377245509,0.8682634730538922,0.1317365269461078,193,23,56,114,185,8,0.11917098445595854,0.29015544041450775,0.5906735751295337,0.9585492227979274,0.04145077720207254
9088,342,238,104,293,49,0.695906432748538,0.30409356725146197,0.8567251461988304,0.14327485380116958,221,23,67,131,214,7,0.10407239819004525,0.3031674208144796,0.5927601809954751,0.9683257918552036,0.03167420814479638
9089,190,142,48,121,69,0.7473684210526316,0.25263157894736843,0.6368421052631579,0.3631578947368421,133,3,83,47,116,17,0.022556390977443608,0.6240601503759399,0.3533834586466165,0.8721804511278195,0.12781954887218044
9090,385,274,111,338,47,0.7116883116883117,0.2883116883116883,0.8779220779220779,0.12207792207792208,192,19,60,113,185,7,0.09895833333333333,0.3125,0.5885416666666666,0.9635416666666666,0.036458333333333336
9091,902,739,163,606,296,0.8192904656319291,0.18070953436807094,0.6718403547671841,0.328159645232816,127,37,60,30,126,1,0.29133858267716534,0.47244094488188976,0.23622047244094488,0.9921259842519685,0.007874015748031496
9092,382,270,112,335,47,0.7068062827225131,0.2931937172774869,0.8769633507853403,0.12303664921465969,191,19,60,112,185,6,0.09947643979057591,0.31413612565445026,0.5863874345549738,0.9685863874345549,0.031413612565445025
9093,126,105,21,101,25,0.8333333333333334,0.16666666666666666,0.8015873015873016,0.1984126984126984,259,2,23,234,239,20,0.007722007722007722,0.0888030888030888,0.9034749034749034,0.9227799227799228,0.07722007722007722
9094,364,252,112,316,48,0.6923076923076923,0.3076923076923077,0.8681318681318682,0.13186813186813187,191,19,60,112,185,6,0.09947643979057591,0.31413612565445026,0.5863874345549738,0.9685863874345549,0.031413612565445025
9095,372,316,56,325,47,0.8494623655913979,0.15053763440860216,0.8736559139784946,0.12634408602150538,191,19,60,112,185,6,0.09947643979057591,0.31413612565445026,0.5863874345549738,0.9685863874345549,0.031413612565445025
9096,355,251,104,310,45,0.7070422535211267,0.29295774647887324,0.8732394366197183,0.1267605633802817,191,19,60,112,185,6,0.09947643979057591,0.31413612565445026,0.5863874345549738,0.9685863874345549,0.031413612565445025
9097,352,261,91,303,49,0.7414772727272727,0.2585227272727273,0.8607954545454546,0.13920454545454544,191,19,60,112,185,6,0.09947643979057591,0.31413612565445026,0.5863874345549738,0.9685863874345549,0.031413612565445025
9098,0,0,0,0,0,0.0,0.0,0.0,0.0,0,0,0,0,0,0,0.0,0.0,0.0,0.0,0.0
9099,190,163,27,145,45,0.8578947368421053,0.14210526315789473,0.7631578947368421,0.23684210526315788,152,40,45,67,148,4,0.2631578947368421,0.29605263157894735,0.4407894736842105,0.9736842105263158,0.02631578947368421
9100,340,238,102,287,53,0.7,0.3,0.8441176470588235,0.15588235294117647,221,23,67,131,214,7,0.10407239819004525,0.3031674208144796,0.5927601809954751,0.9683257918552036,0.03167420814479638
9101,291,251,40,242,49,0.8625429553264605,0.13745704467353953,0.8316151202749141,0.16838487972508592,191,19,60,112,185,6,0.09947643979057591,0.31413612565445026,0.5863874345549738,0.9685863874345549,0.031413612565445025
9102,344,239,105,290,54,0.6947674418604651,0.30523255813953487,0.8430232558139535,0.1569767441860465,221,23,67,131,214,7,0.10407239819004525,0.3031674208144796,0.5927601809954751,0.9683257918552036,0.03167420814479638
9103,299,248,51,254,45,0.8294314381270903,0.1705685618729097,0.8494983277591973,0.1505016722408027,191,19,60,112,185,6,0.09947643979057591,0.31413612565445026,0.5863874345549738,0.9685863874345549,0.031413612565445025
9104,172,151,21,138,34,0.877906976744186,0.12209302325581395,0.8023255813953488,0.19767441860465115,237,41,162,34,236,1,0.1729957805907173,0.6835443037974683,0.14345991561181434,0.9957805907172996,0.004219409282700422
9105,284,224,60,237,47,0.7887323943661971,0.2112676056338028,0.8345070422535211,0.16549295774647887,212,23,64,125,205,7,0.10849056603773585,0.3018867924528302,0.589622641509434,0.9669811320754716,0.0330188679245283
9106,279,225,54,230,49,0.8064516129032258,0.1935483870967742,0.8243727598566308,0.17562724014336917,212,23,64,125,205,7,0.10849056603773585,0.3018867924528302,0.589622641509434,0.9669811320754716,0.0330188679245283
9107,361,250,111,312,49,0.6925207756232687,0.3074792243767313,0.8642659279778393,0.13573407202216067,191,19,60,112,185,6,0.09947643979057591,0.31413612565445026,0.5863874345549738,0.9685863874345549,0.031413612565445025
9108,158,138,20,117,41,0.8734177215189873,0.12658227848101267,0.740506329113924,0.25949367088607594,291,124,16,151,277,14,0.4261168384879725,0.054982817869415807,0.5189003436426117,0.9518900343642611,0.048109965635738834
9109,281,226,55,234,47,0.8042704626334519,0.19572953736654805,0.8327402135231317,0.16725978647686832,161,21,58,82,158,3,0.13043478260869565,0.36024844720496896,0.5093167701863354,0.9813664596273292,0.018633540372670808
9110,362,312,50,315,47,0.861878453038674,0.13812154696132597,0.8701657458563536,0.1298342541436464,191,19,60,112,185,6,0.09947643979057591,0.31413612565445026,0.5863874345549738,0.9685863874345549,0.031413612565445025
9111,368,264,104,323,45,0.717391304347826,0.2826086956521739,0.8777173913043478,0.12228260869565218,221,23,67,131,214,7,0.10407239819004525,0.3031674208144796,0.5927601809954751,0.9683257918552036,0.03167420814479638
9112,329,239,90,282,47,0.7264437689969605,0.2735562310030395,0.8571428571428571,0.14285714285714285,161,21,58,82,158,3,0.13043478260869565,0.36024844720496896,0.5093167701863354,0.9813664596273292,0.018633540372670808
9113,778,639,139,582,196,0.8213367609254498,0.17866323907455012,0.7480719794344473,0.2519280205655527,179,46,57,76,174,5,0.2569832402234637,0.31843575418994413,0.4245810055865922,0.9720670391061452,0.027932960893854747
9114,457,348,109,412,45,0.7614879649890591,0.23851203501094093,0.9015317286652079,0.09846827133479212,191,19,60,112,185,6,0.09947643979057591,0.31413612565445026,0.5863874345549738,0.9685863874345549,0.031413612565445025
9115,331,247,84,286,45,0.7462235649546828,0.2537764350453172,0.8640483383685801,0.13595166163141995,191,19,60,112,185,6,0.09947643979057591,0.31413612565445026,0.5863874345549738,0.9685863874345549,0.031413612565445025
9116,356,246,110,310,46,0.6910112359550562,0.3089887640449438,0.8707865168539326,0.12921348314606743,191,19,60,112,185,6,0.09947643979057591,0.31413612565445026,0.5863874345549738,0.9685863874345549,0.031413612565445025
9117,345,254,91,297,48,0.736231884057971,0.263768115942029,0.8608695652173913,0.1391304347826087,193,23,56,114,185,8,0.11917098445595854,0.29015544041450775,0.5906735751295337,0.9585492227979274,0.04145077720207254
9118,323,231,92,276,47,0.7151702786377709,0.2848297213622291,0.8544891640866873,0.14551083591331268,161,21,58,82,158,3,0.13043478260869565,0.36024844720496896,0.5093167701863354,0.9813664596273292,0.018633540372670808
9119,321,226,95,277,44,0.7040498442367601,0.29595015576323985,0.8629283489096573,0.13707165109034267,161,21,58,82,158,3,0.13043478260869565,0.36024844720496896,0.5093167701863354,0.9813664596273292,0.018633540372670808
9120,296,256,40,247,49,0.8648648648648649,0.13513513513513514,0.8344594594594594,0.16554054054054054,191,19,60,112,185,6,0.09947643979057591,0.31413612565445026,0.5863874345549738,0.9685863874345549,0.031413612565445025
9121,354,242,112,308,46,0.6836158192090396,0.3163841807909605,0.8700564971751412,0.12994350282485875,191,19,60,112,185,6,0.09947643979057591,0.31413612565445026,0.5863874345549738,0.9685863874345549,0.031413612565445025
9122,283,241,42,240,43,0.8515901060070671,0.14840989399293286,0.8480565371024735,0.1519434628975265,191,19,60,112,185,6,0.09947643979057591,0.31413612565445026,0.5863874345549738,0.9685863874345549,0.031413612565445025
9123,22,1,21,15,7,0.045454545454545456,0.9545454545454546,0.6818181818181818,0.3181818181818182,250,55,45,150,241,9,0.22,0.18,0.6,0.964,0.036
9124,296,247,49,250,46,0.8344594594594594,0.16554054054054054,0.8445945945945946,0.1554054054054054,191,19,60,112,185,6,0.09947643979057591,0.31413612565445026,0.5863874345549738,0.9685863874345549,0.031413612565445025
9125,226,154,72,189,37,0.6814159292035398,0.3185840707964602,0.8362831858407079,0.16371681415929204,273,4,157,112,272,1,0.014652014652014652,0.575091575091575,0.41025641025641024,0.9963369963369964,0.003663003663003663
9126,336,261,75,288,48,0.7767857142857143,0.22321428571428573,0.8571428571428571,0.14285714285714285,191,19,60,112,185,6,0.09947643979057591,0.31413612565445026,0.5863874345549738,0.9685863874345549,0.031413612565445025
9127,310,221,89,267,43,0.7129032258064516,0.2870967741935484,0.8612903225806452,0.13870967741935483,161,21,58,82,158,3,0.13043478260869565,0.36024844720496896,0.5093167701863354,0.9813664596273292,0.018633540372670808
9128,295,247,48,248,47,0.8372881355932204,0.16271186440677965,0.8406779661016949,0.15932203389830507,191,19,60,112,185,6,0.09947643979057591,0.31413612565445026,0.5863874345549738,0.9685863874345549,0.031413612565445025
9129,399,291,108,352,47,0.7293233082706767,0.2706766917293233,0.8822055137844611,0.11779448621553884,112,15,20,77,109,3,0.13392857142857142,0.17857142857142858,0.6875,0.9732142857142857,0.026785714285714284
9130,312,246,66,265,47,0.7884615384615384,0.21153846153846154,0.8493589743589743,0.15064102564102563,191,19,60,112,185,6,0.09947643979057591,0.31413612565445026,0.5863874345549738,0.9685863874345549,0.031413612565445025
9131,320,244,76,272,48,0.7625,0.2375,0.85,0.15,191,19,60,112,185,6,0.09947643979057591,0.31413612565445026,0.5863874345549738,0.9685863874345549,0.031413612565445025
9132,374,265,109,328,46,0.7085561497326203,0.2914438502673797,0.8770053475935828,0.12299465240641712,191,19,60,112,185,6,0.09947643979057591,0.31413612565445026,0.5863874345549738,0.9685863874345549,0.031413612565445025
9133,29,1,28,22,7,0.034482758620689655,0.9655172413793104,0.7586206896551724,0.2413793103448276,269,73,57,139,261,8,0.27137546468401486,0.21189591078066913,0.516728624535316,0.9702602230483272,0.02973977695167286
9134,496,396,100,396,100,0.7983870967741935,0.20161290322580644,0.7983870967741935,0.20161290322580644,381,40,85,256,361,20,0.10498687664041995,0.2230971128608924,0.6719160104986877,0.94750656167979,0.05249343832020997
9135,336,231,105,289,47,0.6875,0.3125,0.8601190476190477,0.13988095238095238,221,23,67,131,214,7,0.10407239819004525,0.3031674208144796,0.5927601809954751,0.9683257918552036,0.03167420814479638
9136,342,248,94,293,49,0.7251461988304093,0.27485380116959063,0.8567251461988304,0.14327485380116958,161,21,58,82,158,3,0.13043478260869565,0.36024844720496896,0.5093167701863354,0.9813664596273292,0.018633540372670808
9137,415,304,111,370,45,0.7325301204819277,0.2674698795180723,0.891566265060241,0.10843373493975904,191,19,60,112,185,6,0.09947643979057591,0.31413612565445026,0.5863874345549738,0.9685863874345549,0.031413612565445025
9138,294,238,56,245,49,0.8095238095238095,0.19047619047619047,0.8333333333333334,0.16666666666666666,221,23,67,131,214,7,0.10407239819004525,0.3031674208144796,0.5927601809954751,0.9683257918552036,0.03167420814479638
9139,206,173,33,155,51,0.8398058252427184,0.16019417475728157,0.7524271844660194,0.24757281553398058,151,44,55,52,148,3,0.2913907284768212,0.36423841059602646,0.3443708609271523,0.9801324503311258,0.019867549668874173
9140,364,254,110,316,48,0.6978021978021978,0.3021978021978022,0.8681318681318682,0.13186813186813187,191,19,60,112,185,6,0.09947643979057591,0.31413612565445026,0.5863874345549738,0.9685863874345549,0.031413612565445025
9141,462,363,99,373,89,0.7857142857142857,0.21428571428571427,0.8073593073593074,0.19264069264069264,306,41,53,212,290,16,0.13398692810457516,0.17320261437908496,0.6928104575163399,0.9477124183006536,0.05228758169934641
9142,359,246,113,314,45,0.6852367688022284,0.3147632311977716,0.8746518105849582,0.12534818941504178,191,19,60,112,185,6,0.09947643979057591,0.31413612565445026,0.5863874345549738,0.9685863874345549,0.031413612565445025
9143,308,245,63,261,47,0.7954545454545454,0.20454545454545456,0.8474025974025974,0.1525974025974026,191,19,60,112,185,6,0.09947643979057591,0.31413612565445026,0.5863874345549738,0.9685863874345549,0.031413612565445025
9144,198,163,35,150,48,0.8232323232323232,0.17676767676767677,0.7575757575757576,0.24242424242424243,122,31,45,46,120,2,0.2540983606557377,0.36885245901639346,0.3770491803278688,0.9836065573770492,0.01639344262295082
9145,779,545,234,544,235,0.699614890885751,0.30038510911424904,0.6983311938382541,0.30166880616174585,106,8,18,80,102,4,0.07547169811320754,0.16981132075471697,0.7547169811320755,0.9622641509433962,0.03773584905660377
9146,303,253,50,235,68,0.834983498349835,0.16501650165016502,0.7755775577557755,0.22442244224422442,199,70,37,92,188,11,0.35175879396984927,0.18592964824120603,0.4623115577889447,0.9447236180904522,0.05527638190954774
9147,26,13,13,8,18,0.5,0.5,0.3076923076923077,0.6923076923076923,272,81,60,131,247,25,0.2977941176470588,0.22058823529411764,0.48161764705882354,0.9080882352941176,0.09191176470588236
9148,346,252,94,296,50,0.7283236994219653,0.27167630057803466,0.8554913294797688,0.14450867052023122,221,23,67,131,214,7,0.10407239819004525,0.3031674208144796,0.5927601809954751,0.9683257918552036,0.03167420814479638
9149,283,243,40,237,46,0.8586572438162544,0.1413427561837456,0.8374558303886925,0.1625441696113074,191,19,60,112,185,6,0.09947643979057591,0.31413612565445026,0.5863874345549738,0.9685863874345549,0.031413612565445025
9150,400,290,110,358,42,0.725,0.275,0.895,0.105,191,19,60,112,185,6,0.09947643979057591,0.31413612565445026,0.5863874345549738,0.9685863874345549,0.031413612565445025
9151,405,299,106,353,52,0.7382716049382716,0.2617283950617284,0.8716049382716049,0.12839506172839507,221,23,67,131,214,7,0.10407239819004525,0.3031674208144796,0.5927601809954751,0.9683257918552036,0.03167420814479638
9152,364,284,80,316,48,0.7802197802197802,0.21978021978021978,0.8681318681318682,0.13186813186813187,193,23,56,114,185,8,0.11917098445595854,0.29015544041450775,0.5906735751295337,0.9585492227979274,0.04145077720207254
9153,9439,7636,1803,7663,1776,0.8089840025426422,0.19101599745735778,0.8118444750503231,0.18815552494967688,2838,202,484,2152,1815,1023,0.0711768851303735,0.17054263565891473,0.7582804792107117,0.6395348837209303,0.36046511627906974
9154,858,700,158,680,178,0.8158508158508159,0.18414918414918416,0.7925407925407926,0.20745920745920746,85,13,19,53,78,7,0.15294117647058825,0.2235294117647059,0.6235294117647059,0.9176470588235294,0.08235294117647059
9155,361,251,110,314,47,0.6952908587257618,0.3047091412742382,0.8698060941828255,0.13019390581717452,191,19,60,112,185,6,0.09947643979057591,0.31413612565445026,0.5863874345549738,0.9685863874345549,0.031413612565445025
9156,352,245,107,307,45,0.6960227272727273,0.3039772727272727,0.8721590909090909,0.1278409090909091,191,19,60,112,185,6,0.09947643979057591,0.31413612565445026,0.5863874345549738,0.9685863874345549,0.031413612565445025
9157,198,163,35,152,46,0.8232323232323232,0.17676767676767677,0.7676767676767676,0.23232323232323232,122,33,43,46,119,3,0.27049180327868855,0.3524590163934426,0.3770491803278688,0.9754098360655737,0.02459016393442623
9158,710,627,83,650,60,0.8830985915492958,0.11690140845070422,0.9154929577464789,0.08450704225352113,1333,59,545,729,1270,63,0.04426106526631658,0.4088522130532633,0.5468867216804201,0.9527381845461366,0.047261815453863466
9159,379,277,102,332,47,0.7308707124010554,0.2691292875989446,0.8759894459102903,0.12401055408970976,221,23,67,131,214,7,0.10407239819004525,0.3031674208144796,0.5927601809954751,0.9683257918552036,0.03167420814479638
9160,436,369,67,312,124,0.8463302752293578,0.1536697247706422,0.7155963302752294,0.28440366972477066,163,46,56,61,159,4,0.2822085889570552,0.34355828220858897,0.37423312883435583,0.9754601226993865,0.024539877300613498
9161,424,313,111,365,59,0.7382075471698113,0.2617924528301887,0.8608490566037735,0.1391509433962264,191,19,60,112,185,6,0.09947643979057591,0.31413612565445026,0.5863874345549738,0.9685863874345549,0.031413612565445025
9162,318,227,91,272,46,0.7138364779874213,0.2861635220125786,0.8553459119496856,0.14465408805031446,161,21,58,82,158,3,0.13043478260869565,0.36024844720496896,0.5093167701863354,0.9813664596273292,0.018633540372670808
9163,315,222,93,271,44,0.7047619047619048,0.29523809523809524,0.8603174603174604,0.13968253968253969,161,21,58,82,158,3,0.13043478260869565,0.36024844720496896,0.5093167701863354,0.9813664596273292,0.018633540372670808
9164,452,386,66,325,127,0.8539823008849557,0.14601769911504425,0.7190265486725663,0.2809734513274336,162,44,58,60,159,3,0.2716049382716049,0.35802469135802467,0.37037037037037035,0.9814814814814815,0.018518518518518517
9165,983,980,3,981,2,0.9969481180061037,0.003051881993896236,0.9979654120040692,0.002034587995930824,490,0,106,384,295,195,0.0,0.2163265306122449,0.7836734693877551,0.6020408163265306,0.3979591836734694
9166,467,373,94,350,117,0.7987152034261242,0.2012847965738758,0.7494646680942184,0.2505353319057816,354,17,196,141,180,174,0.0480225988700565,0.5536723163841808,0.3983050847457627,0.5084745762711864,0.4915254237288136
9167,334,267,67,275,59,0.7994011976047904,0.20059880239520958,0.8233532934131736,0.17664670658682635,193,23,56,114,185,8,0.11917098445595854,0.29015544041450775,0.5906735751295337,0.9585492227979274,0.04145077720207254
9168,346,249,97,300,46,0.7196531791907514,0.28034682080924855,0.8670520231213873,0.1329479768786127,191,19,60,112,185,6,0.09947643979057591,0.31413612565445026,0.5863874345549738,0.9685863874345549,0.031413612565445025
9169,384,273,111,336,48,0.7109375,0.2890625,0.875,0.125,212,23,64,125,205,7,0.10849056603773585,0.3018867924528302,0.589622641509434,0.9669811320754716,0.0330188679245283
9170,209,188,21,160,49,0.8995215311004785,0.10047846889952153,0.7655502392344498,0.23444976076555024,276,122,82,72,263,13,0.4420289855072464,0.2971014492753623,0.2608695652173913,0.9528985507246377,0.04710144927536232
9171,153,126,27,119,34,0.8235294117647058,0.17647058823529413,0.7777777777777778,0.2222222222222222,150,17,35,98,143,7,0.11333333333333333,0.23333333333333334,0.6533333333333333,0.9533333333333334,0.04666666666666667
9172,357,244,113,312,45,0.6834733893557423,0.3165266106442577,0.8739495798319328,0.12605042016806722,191,19,60,112,185,6,0.09947643979057591,0.31413612565445026,0.5863874345549738,0.9685863874345549,0.031413612565445025
9173,1331,945,386,878,453,0.709992486851991,0.290007513148009,0.6596543951915853,0.34034560480841475,57,1,4,52,48,9,0.017543859649122806,0.07017543859649122,0.9122807017543859,0.8421052631578947,0.15789473684210525
9174,342,239,103,290,52,0.6988304093567251,0.30116959064327486,0.847953216374269,0.15204678362573099,221,23,67,131,214,7,0.10407239819004525,0.3031674208144796,0.5927601809954751,0.9683257918552036,0.03167420814479638
9175,350,264,86,299,51,0.7542857142857143,0.24571428571428572,0.8542857142857143,0.1457142857142857,191,19,60,112,185,6,0.09947643979057591,0.31413612565445026,0.5863874345549738,0.9685863874345549,0.031413612565445025
9176,1780,1381,399,1284,496,0.7758426966292135,0.22415730337078651,0.7213483146067415,0.2786516853932584,455,47,132,276,295,160,0.10329670329670329,0.29010989010989013,0.6065934065934065,0.6483516483516484,0.3516483516483517
9177,134,113,21,106,28,0.8432835820895522,0.15671641791044777,0.7910447761194029,0.208955223880597,203,2,20,181,190,13,0.009852216748768473,0.09852216748768473,0.8916256157635468,0.9359605911330049,0.06403940886699508
9178,315,259,56,260,55,0.8222222222222222,0.17777777777777778,0.8253968253968254,0.1746031746031746,191,19,60,112,185,6,0.09947643979057591,0.31413612565445026,0.5863874345549738,0.9685863874345549,0.031413612565445025
9179,379,271,108,333,46,0.7150395778364116,0.2849604221635884,0.8786279683377308,0.12137203166226913,191,19,60,112,185,6,0.09947643979057591,0.31413612565445026,0.5863874345549738,0.9685863874345549,0.031413612565445025
9180,356,245,111,313,43,0.6882022471910112,0.31179775280898875,0.8792134831460674,0.12078651685393259,191,19,60,112,185,6,0.09947643979057591,0.31413612565445026,0.5863874345549738,0.9685863874345549,0.031413612565445025
9181,308,245,63,263,45,0.7954545454545454,0.20454545454545456,0.8538961038961039,0.1461038961038961,191,19,60,112,185,6,0.09947643979057591,0.31413612565445026,0.5863874345549738,0.9685863874345549,0.031413612565445025
9182,1250,1015,235,920,330,0.812,0.188,0.736,0.264,139,32,48,59,135,4,0.2302158273381295,0.34532374100719426,0.4244604316546763,0.9712230215827338,0.02877697841726619
9183,212,166,46,144,68,0.7830188679245284,0.2169811320754717,0.6792452830188679,0.32075471698113206,66,1,12,53,53,13,0.015151515151515152,0.18181818181818182,0.803030303030303,0.803030303030303,0.19696969696969696
9184,230,203,27,170,60,0.8826086956521739,0.11739130434782609,0.7391304347826086,0.2608695652173913,574,133,416,25,572,2,0.23170731707317074,0.7247386759581882,0.04355400696864112,0.9965156794425087,0.003484320557491289
9185,309,233,76,255,54,0.7540453074433657,0.2459546925566343,0.8252427184466019,0.17475728155339806,161,21,58,82,158,3,0.13043478260869565,0.36024844720496896,0.5093167701863354,0.9813664596273292,0.018633540372670808
9186,324,232,92,275,49,0.7160493827160493,0.2839506172839506,0.8487654320987654,0.15123456790123457,161,21,58,82,158,3,0.13043478260869565,0.36024844720496896,0.5093167701863354,0.9813664596273292,0.018633540372670808
9187,361,251,110,311,50,0.6952908587257618,0.3047091412742382,0.8614958448753463,0.13850415512465375,191,19,60,112,185,6,0.09947643979057591,0.31413612565445026,0.5863874345549738,0.9685863874345549,0.031413612565445025
9188,347,244,103,290,57,0.7031700288184438,0.2968299711815562,0.8357348703170029,0.1642651296829971,221,23,67,131,214,7,0.10407239819004525,0.3031674208144796,0.5927601809954751,0.9683257918552036,0.03167420814479638
9189,353,244,109,306,47,0.6912181303116147,0.3087818696883853,0.8668555240793201,0.13314447592067988,191,19,60,112,185,6,0.09947643979057591,0.31413612565445026,0.5863874345549738,0.9685863874345549,0.031413612565445025
9190,277,234,43,227,50,0.8447653429602888,0.1552346570397112,0.8194945848375451,0.18050541516245489,221,23,67,131,214,7,0.10407239819004525,0.3031674208144796,0.5927601809954751,0.9683257918552036,0.03167420814479638
9191,344,234,110,299,45,0.6802325581395349,0.31976744186046513,0.8691860465116279,0.1308139534883721,212,23,64,125,205,7,0.10849056603773585,0.3018867924528302,0.589622641509434,0.9669811320754716,0.0330188679245283
9192,371,260,111,320,51,0.7008086253369272,0.2991913746630728,0.862533692722372,0.13746630727762804,191,19,60,112,185,6,0.09947643979057591,0.31413612565445026,0.5863874345549738,0.9685863874345549,0.031413612565445025
9193,346,242,104,291,55,0.6994219653179191,0.30057803468208094,0.8410404624277457,0.15895953757225434,221,23,67,131,214,7,0.10407239819004525,0.3031674208144796,0.5927601809954751,0.9683257918552036,0.03167420814479638
9194,356,243,113,311,45,0.6825842696629213,0.31741573033707865,0.8735955056179775,0.12640449438202248,191,19,60,112,185,6,0.09947643979057591,0.31413612565445026,0.5863874345549738,0.9685863874345549,0.031413612565445025
9195,358,248,110,315,43,0.6927374301675978,0.30726256983240224,0.8798882681564246,0.12011173184357542,191,19,60,112,185,6,0.09947643979057591,0.31413612565445026,0.5863874345549738,0.9685863874345549,0.031413612565445025
9196,393,288,105,347,46,0.732824427480916,0.26717557251908397,0.8829516539440203,0.11704834605597965,221,23,67,131,214,7,0.10407239819004525,0.3031674208144796,0.5927601809954751,0.9683257918552036,0.03167420814479638
9197,395,327,68,298,97,0.8278481012658228,0.17215189873417722,0.7544303797468355,0.24556962025316456,122,17,79,26,121,1,0.13934426229508196,0.6475409836065574,0.21311475409836064,0.9918032786885246,0.00819672131147541
9198,163,145,18,113,50,0.8895705521472392,0.11042944785276074,0.6932515337423313,0.3067484662576687,336,115,20,201,317,19,0.34226190476190477,0.05952380952380952,0.5982142857142857,0.9434523809523809,0.05654761904761905
9199,293,245,48,246,47,0.8361774744027304,0.16382252559726962,0.8395904436860068,0.16040955631399317,191,19,60,112,185,6,0.09947643979057591,0.31413612565445026,0.5863874345549738,0.9685863874345549,0.031413612565445025
9200,847,652,195,665,182,0.7697756788665879,0.23022432113341204,0.7851239669421488,0.21487603305785125,431,41,60,330,411,20,0.0951276102088167,0.13921113689095127,0.765661252900232,0.9535962877030162,0.04640371229698376
9201,341,237,104,289,52,0.6950146627565983,0.30498533724340177,0.8475073313782991,0.15249266862170088,221,23,67,131,214,7,0.10407239819004525,0.3031674208144796,0.5927601809954751,0.9683257918552036,0.03167420814479638
9202,358,246,112,312,46,0.6871508379888268,0.3128491620111732,0.8715083798882681,0.12849162011173185,191,19,60,112,185,6,0.09947643979057591,0.31413612565445026,0.5863874345549738,0.9685863874345549,0.031413612565445025
9203,348,255,93,297,51,0.7327586206896551,0.2672413793103448,0.853448275862069,0.14655172413793102,161,21,58,82,158,3,0.13043478260869565,0.36024844720496896,0.5093167701863354,0.9813664596273292,0.018633540372670808
9204,320,252,68,270,50,0.7875,0.2125,0.84375,0.15625,191,19,60,112,185,6,0.09947643979057591,0.31413612565445026,0.5863874345549738,0.9685863874345549,0.031413612565445025
9205,1134,1121,13,1127,7,0.9885361552028219,0.01146384479717813,0.9938271604938271,0.006172839506172839,326,3,99,224,179,147,0.009202453987730062,0.30368098159509205,0.6871165644171779,0.549079754601227,0.450920245398773
9206,385,274,111,336,49,0.7116883116883117,0.2883116883116883,0.8727272727272727,0.12727272727272726,191,19,60,112,185,6,0.09947643979057591,0.31413612565445026,0.5863874345549738,0.9685863874345549,0.031413612565445025
9207,212,164,48,140,72,0.7735849056603774,0.22641509433962265,0.660377358490566,0.33962264150943394,143,0,44,99,140,3,0.0,0.3076923076923077,0.6923076923076923,0.9790209790209791,0.02097902097902098
9208,432,376,56,356,76,0.8703703703703703,0.12962962962962962,0.8240740740740741,0.17592592592592593,81,31,18,32,78,3,0.38271604938271603,0.2222222222222222,0.3950617283950617,0.9629629629629629,0.037037037037037035
9209,1795,1781,14,1786,9,0.9922005571030641,0.007799442896935933,0.9949860724233983,0.005013927576601671,363,4,101,258,214,149,0.011019283746556474,0.27823691460055094,0.7107438016528925,0.5895316804407713,0.41046831955922863
9210,358,247,111,306,52,0.6899441340782123,0.3100558659217877,0.8547486033519553,0.1452513966480447,191,19,60,112,185,6,0.09947643979057591,0.31413612565445026,0.5863874345549738,0.9685863874345549,0.031413612565445025
9211,358,250,108,311,47,0.6983240223463687,0.3016759776536313,0.8687150837988827,0.13128491620111732,191,19,60,112,185,6,0.09947643979057591,0.31413612565445026,0.5863874345549738,0.9685863874345549,0.031413612565445025
9212,393,280,113,335,58,0.712468193384224,0.2875318066157761,0.8524173027989822,0.1475826972010178,191,19,60,112,185,6,0.09947643979057591,0.31413612565445026,0.5863874345549738,0.9685863874345549,0.031413612565445025
9213,159,135,24,121,38,0.8490566037735849,0.1509433962264151,0.7610062893081762,0.2389937106918239,356,30,59,267,342,14,0.08426966292134831,0.16573033707865167,0.75,0.9606741573033708,0.03932584269662921
9214,362,251,111,311,51,0.6933701657458563,0.30662983425414364,0.8591160220994475,0.1408839779005525,191,19,60,112,185,6,0.09947643979057591,0.31413612565445026,0.5863874345549738,0.9685863874345549,0.031413612565445025
9215,324,241,83,282,42,0.7438271604938271,0.25617283950617287,0.8703703703703703,0.12962962962962962,191,19,60,112,185,6,0.09947643979057591,0.31413612565445026,0.5863874345549738,0.9685863874345549,0.031413612565445025
9216,168,140,28,132,36,0.8333333333333334,0.16666666666666666,0.7857142857142857,0.21428571428571427,346,36,69,241,332,14,0.10404624277456648,0.1994219653179191,0.6965317919075145,0.9595375722543352,0.04046242774566474
9217,333,238,95,288,45,0.7147147147147147,0.2852852852852853,0.8648648648648649,0.13513513513513514,193,23,56,114,185,8,0.11917098445595854,0.29015544041450775,0.5906735751295337,0.9585492227979274,0.04145077720207254
9218,278,239,39,231,47,0.8597122302158273,0.14028776978417265,0.8309352517985612,0.16906474820143885,193,23,56,114,185,8,0.11917098445595854,0.29015544041450775,0.5906735751295337,0.9585492227979274,0.04145077720207254
9219,386,274,112,334,52,0.7098445595854922,0.29015544041450775,0.8652849740932642,0.13471502590673576,191,19,60,112,185,6,0.09947643979057591,0.31413612565445026,0.5863874345549738,0.9685863874345549,0.031413612565445025
9220,57,43,14,25,32,0.7543859649122807,0.24561403508771928,0.43859649122807015,0.5614035087719298,135,75,49,11,123,12,0.5555555555555556,0.362962962962963,0.08148148148148149,0.9111111111111111,0.08888888888888889
9221,357,253,104,299,58,0.7086834733893558,0.2913165266106443,0.8375350140056023,0.16246498599439776,221,23,67,131,214,7,0.10407239819004525,0.3031674208144796,0.5927601809954751,0.9683257918552036,0.03167420814479638
9222,278,224,54,235,43,0.8057553956834532,0.19424460431654678,0.8453237410071942,0.15467625899280577,161,21,58,82,158,3,0.13043478260869565,0.36024844720496896,0.5093167701863354,0.9813664596273292,0.018633540372670808
9223,376,264,112,320,56,0.7021276595744681,0.2978723404255319,0.851063829787234,0.14893617021276595,191,19,60,112,185,6,0.09947643979057591,0.31413612565445026,0.5863874345549738,0.9685863874345549,0.031413612565445025
9224,418,307,111,363,55,0.7344497607655502,0.26555023923444976,0.868421052631579,0.13157894736842105,191,19,60,112,185,6,0.09947643979057591,0.31413612565445026,0.5863874345549738,0.9685863874345549,0.031413612565445025
9225,491,396,95,368,123,0.8065173116089613,0.1934826883910387,0.7494908350305499,0.2505091649694501,320,16,188,116,158,162,0.05,0.5875,0.3625,0.49375,0.50625
9226,298,254,44,247,51,0.8523489932885906,0.1476510067114094,0.8288590604026845,0.17114093959731544,191,19,60,112,185,6,0.09947643979057591,0.31413612565445026,0.5863874345549738,0.9685863874345549,0.031413612565445025
9227,2942,2324,618,2550,392,0.7899388171312033,0.21006118286879674,0.8667573079537729,0.13324269204622705,1227,140,322,765,1113,114,0.11409942950285248,0.2624286878565607,0.6234718826405868,0.9070904645476773,0.09290953545232274
9228,135,114,21,100,35,0.8444444444444444,0.15555555555555556,0.7407407407407407,0.25925925925925924,259,1,23,235,238,21,0.003861003861003861,0.0888030888030888,0.9073359073359073,0.918918918918919,0.08108108108108109
9229,372,260,112,322,50,0.6989247311827957,0.3010752688172043,0.8655913978494624,0.13440860215053763,191,19,60,112,185,6,0.09947643979057591,0.31413612565445026,0.5863874345549738,0.9685863874345549,0.031413612565445025
9230,330,252,78,282,48,0.7636363636363637,0.23636363636363636,0.8545454545454545,0.14545454545454545,191,19,60,112,185,6,0.09947643979057591,0.31413612565445026,0.5863874345549738,0.9685863874345549,0.031413612565445025
9231,320,228,92,276,44,0.7125,0.2875,0.8625,0.1375,193,23,56,114,185,8,0.11917098445595854,0.29015544041450775,0.5906735751295337,0.9585492227979274,0.04145077720207254
9232,425,398,27,387,38,0.9364705882352942,0.06352941176470588,0.9105882352941177,0.08941176470588236,1038,210,469,359,991,47,0.2023121387283237,0.45183044315992293,0.34585741811175336,0.9547206165703276,0.04527938342967245
9233,297,242,55,244,53,0.8148148148148148,0.18518518518518517,0.8215488215488216,0.17845117845117844,221,23,67,131,214,7,0.10407239819004525,0.3031674208144796,0.5927601809954751,0.9683257918552036,0.03167420814479638
9234,357,246,111,310,47,0.6890756302521008,0.31092436974789917,0.8683473389355743,0.13165266106442577,191,19,60,112,185,6,0.09947643979057591,0.31413612565445026,0.5863874345549738,0.9685863874345549,0.031413612565445025
9235,321,243,78,275,46,0.7570093457943925,0.24299065420560748,0.8566978193146417,0.14330218068535824,191,19,60,112,185,6,0.09947643979057591,0.31413612565445026,0.5863874345549738,0.9685863874345549,0.031413612565445025
9236,436,370,66,319,117,0.8486238532110092,0.15137614678899083,0.731651376146789,0.268348623853211,115,34,56,25,115,0,0.2956521739130435,0.48695652173913045,0.21739130434782608,1.0,0.0
9237,359,250,109,315,44,0.6963788300835655,0.30362116991643456,0.8774373259052924,0.12256267409470752,191,19,60,112,185,6,0.09947643979057591,0.31413612565445026,0.5863874345549738,0.9685863874345549,0.031413612565445025
9238,326,286,40,280,46,0.8773006134969326,0.12269938650306748,0.8588957055214724,0.1411042944785276,191,19,60,112,185,6,0.09947643979057591,0.31413612565445026,0.5863874345549738,0.9685863874345549,0.031413612565445025
9239,342,239,103,288,54,0.6988304093567251,0.30116959064327486,0.8421052631578947,0.15789473684210525,221,23,67,131,214,7,0.10407239819004525,0.3031674208144796,0.5927601809954751,0.9683257918552036,0.03167420814479638
9240,1642,1549,93,1596,46,0.9433617539585871,0.05663824604141291,0.9719853836784409,0.028014616321559074,191,19,60,112,185,6,0.09947643979057591,0.31413612565445026,0.5863874345549738,0.9685863874345549,0.031413612565445025
9241,2718,2164,554,2389,329,0.7961736571008095,0.20382634289919058,0.8789551140544518,0.1210448859455482,1056,128,330,598,991,65,0.12121212121212122,0.3125,0.5662878787878788,0.9384469696969697,0.061553030303030304
9242,184,155,29,145,39,0.842391304347826,0.15760869565217392,0.7880434782608695,0.21195652173913043,62,13,18,31,60,2,0.20967741935483872,0.2903225806451613,0.5,0.967741935483871,0.03225806451612903
9243,359,248,111,312,47,0.6908077994428969,0.30919220055710306,0.8690807799442897,0.1309192200557103,191,19,60,112,185,6,0.09947643979057591,0.31413612565445026,0.5863874345549738,0.9685863874345549,0.031413612565445025
9244,407,292,115,362,45,0.7174447174447175,0.28255528255528256,0.8894348894348895,0.11056511056511056,191,19,60,112,185,6,0.09947643979057591,0.31413612565445026,0.5863874345549738,0.9685863874345549,0.031413612565445025
9245,432,318,114,379,53,0.7361111111111112,0.2638888888888889,0.8773148148148148,0.12268518518518519,191,19,60,112,185,6,0.09947643979057591,0.31413612565445026,0.5863874345549738,0.9685863874345549,0.031413612565445025
9246,317,247,70,264,53,0.7791798107255521,0.22082018927444794,0.832807570977918,0.167192429022082,221,23,67,131,214,7,0.10407239819004525,0.3031674208144796,0.5927601809954751,0.9683257918552036,0.03167420814479638
9247,250,227,23,186,64,0.908,0.092,0.744,0.256,395,134,227,34,393,2,0.3392405063291139,0.5746835443037974,0.08607594936708861,0.9949367088607595,0.005063291139240506
9248,277,236,41,231,46,0.851985559566787,0.148014440433213,0.8339350180505415,0.16606498194945848,193,23,56,114,185,8,0.11917098445595854,0.29015544041450775,0.5906735751295337,0.9585492227979274,0.04145077720207254
9249,366,253,113,321,45,0.6912568306010929,0.3087431693989071,0.8770491803278688,0.12295081967213115,191,19,60,112,185,6,0.09947643979057591,0.31413612565445026,0.5863874345549738,0.9685863874345549,0.031413612565445025
9250,328,219,109,280,48,0.6676829268292683,0.3323170731707317,0.8536585365853658,0.14634146341463414,212,23,64,125,205,7,0.10849056603773585,0.3018867924528302,0.589622641509434,0.9669811320754716,0.0330188679245283
9251,321,230,91,275,46,0.7165109034267912,0.2834890965732087,0.8566978193146417,0.14330218068535824,161,21,58,82,158,3,0.13043478260869565,0.36024844720496896,0.5093167701863354,0.9813664596273292,0.018633540372670808
9252,2908,2205,703,1982,926,0.7582530949105915,0.24174690508940852,0.6815680880330124,0.3184319119669876,1758,106,394,1258,1414,344,0.06029579067121729,0.2241183162684869,0.7155858930602957,0.8043230944254836,0.1956769055745165
9253,326,234,92,276,50,0.7177914110429447,0.2822085889570552,0.8466257668711656,0.15337423312883436,161,21,58,82,158,3,0.13043478260869565,0.36024844720496896,0.5093167701863354,0.9813664596273292,0.018633540372670808
9254,281,241,40,234,47,0.8576512455516014,0.1423487544483986,0.8327402135231317,0.16725978647686832,191,19,60,112,185,6,0.09947643979057591,0.31413612565445026,0.5863874345549738,0.9685863874345549,0.031413612565445025
9255,351,246,105,296,55,0.7008547008547008,0.29914529914529914,0.8433048433048433,0.15669515669515668,221,23,67,131,214,7,0.10407239819004525,0.3031674208144796,0.5927601809954751,0.9683257918552036,0.03167420814479638
9256,456,375,81,334,122,0.8223684210526315,0.17763157894736842,0.7324561403508771,0.2675438596491228,95,9,21,65,85,10,0.09473684210526316,0.22105263157894736,0.6842105263157895,0.8947368421052632,0.10526315789473684
9257,362,252,110,311,51,0.6961325966850829,0.30386740331491713,0.8591160220994475,0.1408839779005525,191,19,60,112,185,6,0.09947643979057591,0.31413612565445026,0.5863874345549738,0.9685863874345549,0.031413612565445025
9258,353,242,111,309,44,0.6855524079320113,0.31444759206798867,0.8753541076487252,0.12464589235127478,191,19,60,112,185,6,0.09947643979057591,0.31413612565445026,0.5863874345549738,0.9685863874345549,0.031413612565445025
9259,354,254,100,296,58,0.7175141242937854,0.2824858757062147,0.8361581920903954,0.1638418079096045,221,23,67,131,214,7,0.10407239819004525,0.3031674208144796,0.5927601809954751,0.9683257918552036,0.03167420814479638
9260,408,302,106,360,48,0.7401960784313726,0.25980392156862747,0.8823529411764706,0.11764705882352941,191,19,60,112,185,6,0.09947643979057591,0.31413612565445026,0.5863874345549738,0.9685863874345549,0.031413612565445025
9261,274,236,38,224,50,0.8613138686131386,0.1386861313868613,0.8175182481751825,0.18248175182481752,221,23,67,131,214,7,0.10407239819004525,0.3031674208144796,0.5927601809954751,0.9683257918552036,0.03167420814479638
9262,1143,1013,130,967,176,0.8862642169728784,0.1137357830271216,0.8460192475940508,0.15398075240594924,183,16,34,133,175,8,0.08743169398907104,0.18579234972677597,0.726775956284153,0.9562841530054644,0.04371584699453552
9263,360,257,103,306,54,0.7138888888888889,0.2861111111111111,0.85,0.15,221,23,67,131,214,7,0.10407239819004525,0.3031674208144796,0.5927601809954751,0.9683257918552036,0.03167420814479638
9264,421,358,63,349,72,0.850356294536817,0.1496437054631829,0.828978622327791,0.171021377672209,125,4,32,89,94,31,0.032,0.256,0.712,0.752,0.248
9265,317,235,82,266,51,0.7413249211356467,0.2586750788643533,0.8391167192429022,0.1608832807570978,221,23,67,131,214,7,0.10407239819004525,0.3031674208144796,0.5927601809954751,0.9683257918552036,0.03167420814479638
9266,308,248,60,262,46,0.8051948051948052,0.19480519480519481,0.8506493506493507,0.14935064935064934,191,19,60,112,185,6,0.09947643979057591,0.31413612565445026,0.5863874345549738,0.9685863874345549,0.031413612565445025
9267,363,253,110,311,52,0.696969696969697,0.30303030303030304,0.8567493112947658,0.14325068870523416,191,19,60,112,185,6,0.09947643979057591,0.31413612565445026,0.5863874345549738,0.9685863874345549,0.031413612565445025
9268,147,123,24,106,41,0.8367346938775511,0.16326530612244897,0.7210884353741497,0.2789115646258503,362,115,134,113,340,22,0.31767955801104975,0.3701657458563536,0.31215469613259667,0.9392265193370166,0.06077348066298342
9269,776,636,140,587,189,0.8195876288659794,0.18041237113402062,0.7564432989690721,0.24355670103092783,178,48,52,78,172,6,0.2696629213483146,0.29213483146067415,0.43820224719101125,0.9662921348314607,0.033707865168539325
9270,366,254,112,318,48,0.6939890710382514,0.30601092896174864,0.8688524590163934,0.13114754098360656,191,19,60,112,185,6,0.09947643979057591,0.31413612565445026,0.5863874345549738,0.9685863874345549,0.031413612565445025
9271,346,259,87,295,51,0.7485549132947977,0.2514450867052023,0.8526011560693642,0.14739884393063585,191,19,60,112,185,6,0.09947643979057591,0.31413612565445026,0.5863874345549738,0.9685863874345549,0.031413612565445025
9272,315,195,120,226,89,0.6190476190476191,0.38095238095238093,0.7174603174603175,0.28253968253968254,140,3,58,79,120,20,0.02142857142857143,0.4142857142857143,0.5642857142857143,0.8571428571428571,0.14285714285714285
9273,322,301,21,289,33,0.9347826086956522,0.06521739130434782,0.8975155279503105,0.10248447204968944,279,105,100,74,267,12,0.3763440860215054,0.35842293906810035,0.26523297491039427,0.956989247311828,0.043010752688172046
9274,10063,8624,1439,8334,1729,0.8570008943654973,0.14299910563450263,0.8281824505614628,0.17181754943853722,2407,267,512,1628,1849,558,0.11092646447860408,0.21271292064810968,0.6763606148732862,0.7681761528874117,0.23182384711258827
9275,343,238,105,295,48,0.6938775510204082,0.30612244897959184,0.8600583090379009,0.13994169096209913,221,23,67,131,214,7,0.10407239819004525,0.3031674208144796,0.5927601809954751,0.9683257918552036,0.03167420814479638
9276,308,242,66,264,44,0.7857142857142857,0.21428571428571427,0.8571428571428571,0.14285714285714285,191,19,60,112,185,6,0.09947643979057591,0.31413612565445026,0.5863874345549738,0.9685863874345549,0.031413612565445025
9277,282,236,46,235,47,0.8368794326241135,0.16312056737588654,0.8333333333333334,0.16666666666666666,221,23,67,131,214,7,0.10407239819004525,0.3031674208144796,0.5927601809954751,0.9683257918552036,0.03167420814479638
9278,162,139,23,119,43,0.8580246913580247,0.1419753086419753,0.7345679012345679,0.2654320987654321,360,25,46,289,350,10,0.06944444444444445,0.12777777777777777,0.8027777777777778,0.9722222222222222,0.027777777777777776
9279,187,163,24,132,55,0.8716577540106952,0.12834224598930483,0.7058823529411765,0.29411764705882354,356,29,58,269,341,15,0.08146067415730338,0.16292134831460675,0.7556179775280899,0.9578651685393258,0.042134831460674156
9280,357,250,107,309,48,0.7002801120448179,0.29971988795518206,0.865546218487395,0.13445378151260504,191,19,60,112,185,6,0.09947643979057591,0.31413612565445026,0.5863874345549738,0.9685863874345549,0.031413612565445025
9281,445,380,65,325,120,0.8539325842696629,0.14606741573033707,0.7303370786516854,0.2696629213483146,134,37,71,26,134,0,0.27611940298507465,0.5298507462686567,0.19402985074626866,1.0,0.0
9282,492,397,95,366,126,0.806910569105691,0.19308943089430894,0.7439024390243902,0.25609756097560976,319,17,187,115,157,162,0.05329153605015674,0.5862068965517241,0.3605015673981191,0.49216300940438873,0.5078369905956113
9283,1580,1346,234,1244,336,0.8518987341772152,0.14810126582278482,0.7873417721518987,0.21265822784810126,108,19,19,70,99,9,0.17592592592592593,0.17592592592592593,0.6481481481481481,0.9166666666666666,0.08333333333333333
9284,30,30,0,14,16,1.0,0.0,0.4666666666666667,0.5333333333333333,4,0,0,4,3,1,0.0,0.0,1.0,0.75,0.25
9285,357,245,112,311,46,0.6862745098039216,0.3137254901960784,0.8711484593837535,0.12885154061624648,191,19,60,112,185,6,0.09947643979057591,0.31413612565445026,0.5863874345549738,0.9685863874345549,0.031413612565445025
9286,1124,1111,13,1116,8,0.9884341637010676,0.011565836298932384,0.9928825622775801,0.0071174377224199285,335,3,101,231,190,145,0.008955223880597015,0.30149253731343284,0.6895522388059702,0.5671641791044776,0.43283582089552236
9287,226,180,46,172,54,0.7964601769911505,0.20353982300884957,0.7610619469026548,0.23893805309734514,644,65,83,496,484,160,0.10093167701863354,0.12888198757763975,0.7701863354037267,0.7515527950310559,0.2484472049689441
9288,354,243,111,308,46,0.6864406779661016,0.3135593220338983,0.8700564971751412,0.12994350282485875,191,19,60,112,185,6,0.09947643979057591,0.31413612565445026,0.5863874345549738,0.9685863874345549,0.031413612565445025
9289,334,248,86,278,56,0.7425149700598802,0.25748502994011974,0.8323353293413174,0.16766467065868262,221,23,67,131,214,7,0.10407239819004525,0.3031674208144796,0.5927601809954751,0.9683257918552036,0.03167420814479638
9290,186,162,24,137,49,0.8709677419354839,0.12903225806451613,0.7365591397849462,0.26344086021505375,355,33,54,268,340,15,0.09295774647887324,0.15211267605633802,0.7549295774647887,0.9577464788732394,0.04225352112676056
9291,291,235,56,240,51,0.8075601374570447,0.19243986254295534,0.8247422680412371,0.17525773195876287,221,23,67,131,214,7,0.10407239819004525,0.3031674208144796,0.5927601809954751,0.9683257918552036,0.03167420814479638
9292,8588,5823,2765,4899,3689,0.6780391243595715,0.3219608756404285,0.5704471355379599,0.42955286446204005,2717,65,659,1993,2688,29,0.023923444976076555,0.24254692675745307,0.7335296282664704,0.9893264630106735,0.010673536989326464
9293,313,241,72,264,49,0.7699680511182109,0.23003194888178913,0.8434504792332268,0.15654952076677317,193,23,56,114,185,8,0.11917098445595854,0.29015544041450775,0.5906735751295337,0.9585492227979274,0.04145077720207254
9294,1253,1240,13,1246,7,0.9896249002394254,0.010375099760574621,0.994413407821229,0.00558659217877095,472,3,104,365,279,193,0.006355932203389831,0.22033898305084745,0.7733050847457628,0.5911016949152542,0.4088983050847458
9295,297,221,76,252,45,0.7441077441077442,0.2558922558922559,0.8484848484848485,0.15151515151515152,212,23,64,125,205,7,0.10849056603773585,0.3018867924528302,0.589622641509434,0.9669811320754716,0.0330188679245283
9296,411,355,56,321,90,0.8637469586374696,0.1362530413625304,0.781021897810219,0.21897810218978103,139,15,34,90,130,9,0.1079136690647482,0.2446043165467626,0.6474820143884892,0.935251798561151,0.06474820143884892
9297,448,382,66,327,121,0.8526785714285714,0.14732142857142858,0.7299107142857143,0.2700892857142857,142,39,79,24,142,0,0.2746478873239437,0.5563380281690141,0.16901408450704225,1.0,0.0
9298,342,252,90,290,52,0.7368421052631579,0.2631578947368421,0.847953216374269,0.15204678362573099,191,19,60,112,185,6,0.09947643979057591,0.31413612565445026,0.5863874345549738,0.9685863874345549,0.031413612565445025
9299,364,253,111,317,47,0.695054945054945,0.30494505494505497,0.8708791208791209,0.12912087912087913,191,19,60,112,185,6,0.09947643979057591,0.31413612565445026,0.5863874345549738,0.9685863874345549,0.031413612565445025
9300,378,333,45,318,60,0.8809523809523809,0.11904761904761904,0.8412698412698413,0.15873015873015872,81,2,14,65,62,19,0.024691358024691357,0.1728395061728395,0.8024691358024691,0.7654320987654321,0.2345679012345679
9301,333,244,89,287,46,0.7327327327327328,0.2672672672672673,0.8618618618618619,0.13813813813813813,191,19,60,112,185,6,0.09947643979057591,0.31413612565445026,0.5863874345549738,0.9685863874345549,0.031413612565445025
9302,105,89,16,76,29,0.8476190476190476,0.1523809523809524,0.7238095238095238,0.2761904761904762,190,2,6,182,186,4,0.010526315789473684,0.031578947368421054,0.9578947368421052,0.9789473684210527,0.021052631578947368
9303,330,235,95,283,47,0.7121212121212122,0.2878787878787879,0.8575757575757575,0.14242424242424243,193,23,56,114,185,8,0.11917098445595854,0.29015544041450775,0.5906735751295337,0.9585492227979274,0.04145077720207254
9304,243,204,39,172,71,0.8395061728395061,0.16049382716049382,0.7078189300411523,0.29218106995884774,695,287,211,197,602,93,0.41294964028776976,0.3035971223021583,0.28345323741007195,0.8661870503597122,0.13381294964028778
9305,0,0,0,0,0,0.0,0.0,0.0,0.0,0,0,0,0,0,0,0.0,0.0,0.0,0.0,0.0
9306,325,232,93,277,48,0.7138461538461538,0.28615384615384615,0.8523076923076923,0.1476923076923077,161,21,58,82,158,3,0.13043478260869565,0.36024844720496896,0.5093167701863354,0.9813664596273292,0.018633540372670808
9307,314,224,90,269,45,0.7133757961783439,0.28662420382165604,0.856687898089172,0.14331210191082802,161,21,58,82,158,3,0.13043478260869565,0.36024844720496896,0.5093167701863354,0.9813664596273292,0.018633540372670808
9308,651,560,91,510,141,0.8602150537634409,0.13978494623655913,0.783410138248848,0.21658986175115208,570,93,111,366,548,22,0.1631578947368421,0.19473684210526315,0.6421052631578947,0.9614035087719298,0.03859649122807018
9309,305,242,63,218,87,0.7934426229508197,0.20655737704918034,0.7147540983606557,0.28524590163934427,248,16,28,204,241,7,0.06451612903225806,0.11290322580645161,0.8225806451612904,0.9717741935483871,0.028225806451612902
9310,881,821,60,809,72,0.9318955732122588,0.0681044267877412,0.9182746878547106,0.08172531214528944,160,41,50,69,157,3,0.25625,0.3125,0.43125,0.98125,0.01875
9311,442,377,65,333,109,0.8529411764705882,0.14705882352941177,0.753393665158371,0.24660633484162897,142,36,82,24,142,0,0.2535211267605634,0.5774647887323944,0.16901408450704225,1.0,0.0
9312,498,403,95,363,135,0.8092369477911646,0.19076305220883535,0.7289156626506024,0.2710843373493976,321,16,188,117,158,163,0.04984423676012461,0.5856697819314641,0.3644859813084112,0.49221183800623053,0.5077881619937694
9313,332,252,80,282,50,0.7590361445783133,0.24096385542168675,0.8493975903614458,0.15060240963855423,191,19,60,112,185,6,0.09947643979057591,0.31413612565445026,0.5863874345549738,0.9685863874345549,0.031413612565445025
9314,361,252,109,311,50,0.6980609418282548,0.30193905817174516,0.8614958448753463,0.13850415512465375,191,19,60,112,185,6,0.09947643979057591,0.31413612565445026,0.5863874345549738,0.9685863874345549,0.031413612565445025
9315,337,252,85,290,47,0.7477744807121661,0.2522255192878338,0.8605341246290801,0.1394658753709199,191,19,60,112,185,6,0.09947643979057591,0.31413612565445026,0.5863874345549738,0.9685863874345549,0.031413612565445025
9316,328,233,95,279,49,0.7103658536585366,0.2896341463414634,0.850609756097561,0.14939024390243902,161,21,58,82,158,3,0.13043478260869565,0.36024844720496896,0.5093167701863354,0.9813664596273292,0.018633540372670808
9317,344,241,103,301,43,0.7005813953488372,0.29941860465116277,0.875,0.125,191,19,60,112,185,6,0.09947643979057591,0.31413612565445026,0.5863874345549738,0.9685863874345549,0.031413612565445025
9318,382,271,111,326,56,0.7094240837696335,0.2905759162303665,0.8534031413612565,0.14659685863874344,191,19,60,112,185,6,0.09947643979057591,0.31413612565445026,0.5863874345549738,0.9685863874345549,0.031413612565445025
9319,535,436,99,442,93,0.8149532710280374,0.18504672897196262,0.8261682242990654,0.17383177570093458,495,41,48,406,477,18,0.08282828282828283,0.09696969696969697,0.8202020202020202,0.9636363636363636,0.03636363636363636
9320,132,111,21,105,27,0.8409090909090909,0.1590909090909091,0.7954545454545454,0.20454545454545456,260,2,25,233,240,20,0.007692307692307693,0.09615384615384616,0.8961538461538462,0.9230769230769231,0.07692307692307693
9321,9439,7636,1803,7663,1776,0.8089840025426422,0.19101599745735778,0.8118444750503231,0.18815552494967688,2838,202,484,2152,1815,1023,0.0711768851303735,0.17054263565891473,0.7582804792107117,0.6395348837209303,0.36046511627906974
9322,439,397,42,375,64,0.9043280182232346,0.09567198177676538,0.8542141230068337,0.14578587699316628,191,19,60,112,185,6,0.09947643979057591,0.31413612565445026,0.5863874345549738,0.9685863874345549,0.031413612565445025
9323,163,137,26,120,43,0.8404907975460123,0.15950920245398773,0.7361963190184049,0.26380368098159507,233,31,49,153,226,7,0.13304721030042918,0.21030042918454936,0.6566523605150214,0.9699570815450643,0.030042918454935622
9324,354,249,105,303,51,0.7033898305084746,0.2966101694915254,0.8559322033898306,0.1440677966101695,191,19,60,112,185,6,0.09947643979057591,0.31413612565445026,0.5863874345549738,0.9685863874345549,0.031413612565445025
9325,310,235,75,264,46,0.7580645161290323,0.24193548387096775,0.8516129032258064,0.14838709677419354,221,23,67,131,214,7,0.10407239819004525,0.3031674208144796,0.5927601809954751,0.9683257918552036,0.03167420814479638
9326,398,285,113,351,47,0.7160804020100503,0.28391959798994976,0.8819095477386935,0.11809045226130653,191,19,60,112,185,6,0.09947643979057591,0.31413612565445026,0.5863874345549738,0.9685863874345549,0.031413612565445025
9327,676,585,91,525,151,0.8653846153846154,0.1346153846153846,0.7766272189349113,0.22337278106508876,569,94,108,367,548,21,0.16520210896309315,0.18980667838312829,0.6449912126537786,0.9630931458699473,0.03690685413005272
9328,363,255,108,315,48,0.7024793388429752,0.2975206611570248,0.8677685950413223,0.1322314049586777,191,19,60,112,185,6,0.09947643979057591,0.31413612565445026,0.5863874345549738,0.9685863874345549,0.031413612565445025
9329,846,734,112,781,65,0.8676122931442081,0.13238770685579196,0.9231678486997635,0.0768321513002364,108,15,24,69,99,9,0.1388888888888889,0.2222222222222222,0.6388888888888888,0.9166666666666666,0.08333333333333333
9330,457,388,69,333,124,0.849015317286652,0.15098468271334792,0.7286652078774617,0.2713347921225383,153,40,52,61,148,5,0.26143790849673204,0.33986928104575165,0.39869281045751637,0.9673202614379085,0.032679738562091505
9331,327,233,94,277,50,0.7125382262996942,0.2874617737003058,0.8470948012232415,0.1529051987767584,161,21,58,82,158,3,0.13043478260869565,0.36024844720496896,0.5093167701863354,0.9813664596273292,0.018633540372670808
9332,404,294,110,350,54,0.7277227722772277,0.2722772277227723,0.8663366336633663,0.13366336633663367,191,19,60,112,185,6,0.09947643979057591,0.31413612565445026,0.5863874345549738,0.9685863874345549,0.031413612565445025
9333,330,237,93,276,54,0.7181818181818181,0.2818181818181818,0.8363636363636363,0.16363636363636364,212,23,64,125,205,7,0.10849056603773585,0.3018867924528302,0.589622641509434,0.9669811320754716,0.0330188679245283
9334,301,253,48,252,49,0.840531561461794,0.15946843853820597,0.8372093023255814,0.16279069767441862,191,19,60,112,185,6,0.09947643979057591,0.31413612565445026,0.5863874345549738,0.9685863874345549,0.031413612565445025
9335,323,230,93,274,49,0.7120743034055728,0.28792569659442724,0.848297213622291,0.15170278637770898,161,21,58,82,158,3,0.13043478260869565,0.36024844720496896,0.5093167701863354,0.9813664596273292,0.018633540372670808
9336,340,232,108,289,51,0.6823529411764706,0.3176470588235294,0.85,0.15,212,23,64,125,205,7,0.10849056603773585,0.3018867924528302,0.589622641509434,0.9669811320754716,0.0330188679245283
9337,369,304,65,315,54,0.8238482384823849,0.17615176151761516,0.8536585365853658,0.14634146341463414,221,23,67,131,214,7,0.10407239819004525,0.3031674208144796,0.5927601809954751,0.9683257918552036,0.03167420814479638
9338,157,130,27,128,29,0.8280254777070064,0.17197452229299362,0.8152866242038217,0.18471337579617833,148,17,33,98,143,5,0.11486486486486487,0.22297297297297297,0.6621621621621622,0.9662162162162162,0.033783783783783786
9339,365,251,114,318,47,0.6876712328767123,0.31232876712328766,0.8712328767123287,0.12876712328767123,191,19,60,112,185,6,0.09947643979057591,0.31413612565445026,0.5863874345549738,0.9685863874345549,0.031413612565445025
9340,378,265,113,322,56,0.701058201058201,0.29894179894179895,0.8518518518518519,0.14814814814814814,191,19,60,112,185,6,0.09947643979057591,0.31413612565445026,0.5863874345549738,0.9685863874345549,0.031413612565445025
9341,350,247,103,294,56,0.7057142857142857,0.29428571428571426,0.84,0.16,221,23,67,131,214,7,0.10407239819004525,0.3031674208144796,0.5927601809954751,0.9683257918552036,0.03167420814479638
9342,336,230,106,288,48,0.6845238095238095,0.31547619047619047,0.8571428571428571,0.14285714285714285,221,23,67,131,214,7,0.10407239819004525,0.3031674208144796,0.5927601809954751,0.9683257918552036,0.03167420814479638
9343,366,255,111,324,42,0.6967213114754098,0.30327868852459017,0.8852459016393442,0.11475409836065574,191,19,60,112,185,6,0.09947643979057591,0.31413612565445026,0.5863874345549738,0.9685863874345549,0.031413612565445025
9344,0,0,0,0,0,0.0,0.0,0.0,0.0,0,0,0,0,0,0,0.0,0.0,0.0,0.0,0.0
9345,354,247,107,311,43,0.6977401129943502,0.3022598870056497,0.8785310734463276,0.12146892655367232,191,19,60,112,185,6,0.09947643979057591,0.31413612565445026,0.5863874345549738,0.9685863874345549,0.031413612565445025
9346,177,157,20,134,43,0.8870056497175142,0.11299435028248588,0.7570621468926554,0.24293785310734464,281,113,86,82,266,15,0.40213523131672596,0.30604982206405695,0.2918149466192171,0.9466192170818505,0.05338078291814947
9347,327,223,104,280,47,0.6819571865443425,0.3180428134556575,0.8562691131498471,0.1437308868501529,212,23,64,125,205,7,0.10849056603773585,0.3018867924528302,0.589622641509434,0.9669811320754716,0.0330188679245283
9348,327,233,94,278,49,0.7125382262996942,0.2874617737003058,0.8501529051987767,0.14984709480122324,161,21,58,82,158,3,0.13043478260869565,0.36024844720496896,0.5093167701863354,0.9813664596273292,0.018633540372670808
9349,329,242,87,286,43,0.7355623100303952,0.26443768996960487,0.8693009118541033,0.13069908814589665,191,19,60,112,185,6,0.09947643979057591,0.31413612565445026,0.5863874345549738,0.9685863874345549,0.031413612565445025
9350,401,295,106,350,51,0.7356608478802993,0.26433915211970077,0.8728179551122195,0.12718204488778054,221,23,67,131,214,7,0.10407239819004525,0.3031674208144796,0.5927601809954751,0.9683257918552036,0.03167420814479638
9351,8409,5750,2659,4483,3926,0.683791176120823,0.3162088238791771,0.5331192769651564,0.4668807230348436,2735,27,586,2122,2551,184,0.009872029250457038,0.21425959780621573,0.7758683729433272,0.9327239488117002,0.06727605118829982
9352,319,245,74,275,44,0.768025078369906,0.23197492163009403,0.8620689655172413,0.13793103448275862,191,19,60,112,185,6,0.09947643979057591,0.31413612565445026,0.5863874345549738,0.9685863874345549,0.031413612565445025
9353,387,278,109,341,46,0.7183462532299741,0.28165374677002586,0.8811369509043928,0.11886304909560723,191,19,60,112,185,6,0.09947643979057591,0.31413612565445026,0.5863874345549738,0.9685863874345549,0.031413612565445025
9354,381,270,111,321,60,0.7086614173228346,0.29133858267716534,0.84251968503937,0.15748031496062992,191,19,60,112,185,6,0.09947643979057591,0.31413612565445026,0.5863874345549738,0.9685863874345549,0.031413612565445025
9355,356,245,111,309,47,0.6882022471910112,0.31179775280898875,0.8679775280898876,0.13202247191011235,191,19,60,112,185,6,0.09947643979057591,0.31413612565445026,0.5863874345549738,0.9685863874345549,0.031413612565445025
9356,356,243,113,310,46,0.6825842696629213,0.31741573033707865,0.8707865168539326,0.12921348314606743,191,19,60,112,185,6,0.09947643979057591,0.31413612565445026,0.5863874345549738,0.9685863874345549,0.031413612565445025
9357,278,242,36,226,52,0.8705035971223022,0.12949640287769784,0.8129496402877698,0.18705035971223022,193,23,56,114,185,8,0.11917098445595854,0.29015544041450775,0.5906735751295337,0.9585492227979274,0.04145077720207254
9358,404,313,91,356,48,0.7747524752475248,0.22524752475247525,0.8811881188118812,0.1188118811881188,161,21,58,82,158,3,0.13043478260869565,0.36024844720496896,0.5093167701863354,0.9813664596273292,0.018633540372670808
9359,309,253,56,257,52,0.8187702265372169,0.18122977346278318,0.8317152103559871,0.16828478964401294,191,19,60,112,185,6,0.09947643979057591,0.31413612565445026,0.5863874345549738,0.9685863874345549,0.031413612565445025
9360,161,135,26,127,34,0.8385093167701864,0.16149068322981366,0.7888198757763976,0.2111801242236025,149,17,34,98,143,6,0.11409395973154363,0.22818791946308725,0.6577181208053692,0.959731543624161,0.040268456375838924
9361,282,234,48,234,48,0.8297872340425532,0.1702127659574468,0.8297872340425532,0.1702127659574468,161,21,58,82,158,3,0.13043478260869565,0.36024844720496896,0.5093167701863354,0.9813664596273292,0.018633540372670808
9362,312,249,63,266,46,0.7980769230769231,0.20192307692307693,0.8525641025641025,0.14743589743589744,191,19,60,112,185,6,0.09947643979057591,0.31413612565445026,0.5863874345549738,0.9685863874345549,0.031413612565445025
9363,327,234,93,280,47,0.7155963302752294,0.28440366972477066,0.8562691131498471,0.1437308868501529,193,23,56,114,185,8,0.11917098445595854,0.29015544041450775,0.5906735751295337,0.9585492227979274,0.04145077720207254
9364,349,245,104,299,50,0.7020057306590258,0.2979942693409742,0.8567335243553008,0.14326647564469913,221,23,67,131,214,7,0.10407239819004525,0.3031674208144796,0.5927601809954751,0.9683257918552036,0.03167420814479638
9365,1177,1164,13,1168,9,0.9889549702633815,0.011045029736618521,0.9923534409515717,0.0076465590484282074,279,3,95,181,155,124,0.010752688172043012,0.34050179211469533,0.6487455197132617,0.5555555555555556,0.4444444444444444
9366,354,249,105,306,48,0.7033898305084746,0.2966101694915254,0.864406779661017,0.13559322033898305,191,19,60,112,185,6,0.09947643979057591,0.31413612565445026,0.5863874345549738,0.9685863874345549,0.031413612565445025
9367,170,145,25,129,41,0.8529411764705882,0.14705882352941177,0.7588235294117647,0.2411764705882353,165,26,38,101,152,13,0.15757575757575756,0.23030303030303031,0.6121212121212121,0.9212121212121213,0.07878787878787878
9368,302,255,47,253,49,0.8443708609271523,0.15562913907284767,0.8377483443708609,0.16225165562913907,191,19,60,112,185,6,0.09947643979057591,0.31413612565445026,0.5863874345549738,0.9685863874345549,0.031413612565445025
9369,167,143,24,128,39,0.8562874251497006,0.1437125748502994,0.7664670658682635,0.23353293413173654,357,31,59,267,343,14,0.08683473389355742,0.16526610644257703,0.7478991596638656,0.9607843137254902,0.0392156862745098
9370,292,251,41,241,51,0.8595890410958904,0.1404109589041096,0.8253424657534246,0.17465753424657535,191,19,60,112,185,6,0.09947643979057591,0.31413612565445026,0.5863874345549738,0.9685863874345549,0.031413612565445025
9371,1961,1942,19,1438,523,0.9903110657827638,0.009688934217236104,0.7332993370729219,0.266700662927078,292,116,20,156,280,12,0.3972602739726027,0.0684931506849315,0.5342465753424658,0.958904109589041,0.0410958904109589
9372,209,174,35,153,56,0.8325358851674641,0.1674641148325359,0.7320574162679426,0.2679425837320574,122,34,43,45,120,2,0.2786885245901639,0.3524590163934426,0.36885245901639346,0.9836065573770492,0.01639344262295082
9373,172,143,29,127,45,0.8313953488372093,0.1686046511627907,0.7383720930232558,0.2616279069767442,62,13,18,31,59,3,0.20967741935483872,0.2903225806451613,0.5,0.9516129032258065,0.04838709677419355
9374,380,273,107,326,54,0.718421052631579,0.28157894736842104,0.8578947368421053,0.14210526315789473,221,23,67,131,214,7,0.10407239819004525,0.3031674208144796,0.5927601809954751,0.9683257918552036,0.03167420814479638
9375,293,253,40,244,49,0.863481228668942,0.13651877133105803,0.8327645051194539,0.16723549488054607,191,19,60,112,185,6,0.09947643979057591,0.31413612565445026,0.5863874345549738,0.9685863874345549,0.031413612565445025
9376,354,253,101,308,46,0.7146892655367232,0.2853107344632768,0.8700564971751412,0.12994350282485875,191,19,60,112,185,6,0.09947643979057591,0.31413612565445026,0.5863874345549738,0.9685863874345549,0.031413612565445025
9377,363,250,113,316,47,0.6887052341597796,0.31129476584022037,0.8705234159779615,0.12947658402203857,191,19,60,112,185,6,0.09947643979057591,0.31413612565445026,0.5863874345549738,0.9685863874345549,0.031413612565445025
9378,357,244,113,310,47,0.6834733893557423,0.3165266106442577,0.8683473389355743,0.13165266106442577,191,19,60,112,185,6,0.09947643979057591,0.31413612565445026,0.5863874345549738,0.9685863874345549,0.031413612565445025
9379,195,164,31,147,48,0.841025641025641,0.15897435897435896,0.7538461538461538,0.24615384615384617,143,41,45,57,138,5,0.2867132867132867,0.3146853146853147,0.3986013986013986,0.965034965034965,0.03496503496503497
9380,386,282,104,342,44,0.7305699481865285,0.2694300518134715,0.8860103626943006,0.11398963730569948,68,13,17,38,65,3,0.19117647058823528,0.25,0.5588235294117647,0.9558823529411765,0.04411764705882353
9381,362,251,111,313,49,0.6933701657458563,0.30662983425414364,0.8646408839779005,0.13535911602209943,191,19,60,112,185,6,0.09947643979057591,0.31413612565445026,0.5863874345549738,0.9685863874345549,0.031413612565445025
9382,196,161,35,149,47,0.8214285714285714,0.17857142857142858,0.7602040816326531,0.23979591836734693,139,32,48,59,135,4,0.2302158273381295,0.34532374100719426,0.4244604316546763,0.9712230215827338,0.02877697841726619
9383,221,186,35,174,47,0.8416289592760181,0.1583710407239819,0.7873303167420814,0.21266968325791855,141,40,75,26,140,1,0.28368794326241137,0.5319148936170213,0.18439716312056736,0.9929078014184397,0.0070921985815602835
9384,356,244,112,312,44,0.6853932584269663,0.3146067415730337,0.8764044943820225,0.12359550561797752,191,19,60,112,185,6,0.09947643979057591,0.31413612565445026,0.5863874345549738,0.9685863874345549,0.031413612565445025
9385,420,307,113,377,43,0.7309523809523809,0.26904761904761904,0.8976190476190476,0.10238095238095238,191,19,60,112,185,6,0.09947643979057591,0.31413612565445026,0.5863874345549738,0.9685863874345549,0.031413612565445025
9386,434,323,111,379,55,0.7442396313364056,0.2557603686635945,0.8732718894009217,0.12672811059907835,191,19,60,112,185,6,0.09947643979057591,0.31413612565445026,0.5863874345549738,0.9685863874345549,0.031413612565445025
9387,2956,2380,576,2588,368,0.8051420838971584,0.19485791610284167,0.8755074424898511,0.12449255751014884,1079,136,335,608,1015,64,0.12604263206672844,0.31047265987025024,0.5634847080630213,0.9406858202038925,0.05931417979610751
9388,1498,1409,89,1454,44,0.9405874499332443,0.05941255006675567,0.9706275033377837,0.029372496662216287,191,19,60,112,185,6,0.09947643979057591,0.31413612565445026,0.5863874345549738,0.9685863874345549,0.031413612565445025
9389,701,564,137,554,147,0.8045649072753209,0.19543509272467904,0.7902995720399429,0.20970042796005706,137,42,74,21,136,1,0.30656934306569344,0.5401459854014599,0.15328467153284672,0.9927007299270073,0.0072992700729927005
9390,433,368,65,324,109,0.8498845265588915,0.15011547344110854,0.7482678983833718,0.2517321016166282,118,36,59,23,118,0,0.3050847457627119,0.5,0.19491525423728814,1.0,0.0
9391,141,113,28,110,31,0.8014184397163121,0.19858156028368795,0.7801418439716312,0.2198581560283688,210,44,82,84,195,15,0.20952380952380953,0.3904761904761905,0.4,0.9285714285714286,0.07142857142857142
9392,352,241,111,307,45,0.6846590909090909,0.3153409090909091,0.8721590909090909,0.1278409090909091,191,19,60,112,185,6,0.09947643979057591,0.31413612565445026,0.5863874345549738,0.9685863874345549,0.031413612565445025
9393,162,138,24,121,41,0.8518518518518519,0.14814814814814814,0.7469135802469136,0.25308641975308643,357,32,59,266,342,15,0.0896358543417367,0.16526610644257703,0.7450980392156863,0.957983193277311,0.04201680672268908
9394,201,166,35,147,54,0.8258706467661692,0.17412935323383086,0.7313432835820896,0.26865671641791045,122,34,43,45,120,2,0.2786885245901639,0.3524590163934426,0.36885245901639346,0.9836065573770492,0.01639344262295082
9395,158,131,27,126,32,0.8291139240506329,0.17088607594936708,0.7974683544303798,0.20253164556962025,149,17,33,99,142,7,0.11409395973154363,0.2214765100671141,0.6644295302013423,0.9530201342281879,0.04697986577181208
9396,315,239,76,271,44,0.7587301587301587,0.24126984126984127,0.8603174603174604,0.13968253968253969,191,19,60,112,185,6,0.09947643979057591,0.31413612565445026,0.5863874345549738,0.9685863874345549,0.031413612565445025
9397,357,247,110,309,48,0.6918767507002801,0.3081232492997199,0.865546218487395,0.13445378151260504,191,19,60,112,185,6,0.09947643979057591,0.31413612565445026,0.5863874345549738,0.9685863874345549,0.031413612565445025
9398,285,221,64,235,50,0.775438596491228,0.22456140350877193,0.8245614035087719,0.17543859649122806,208,23,64,121,201,7,0.11057692307692307,0.3076923076923077,0.5817307692307693,0.9663461538461539,0.03365384615384615
9399,452,343,109,402,50,0.7588495575221239,0.2411504424778761,0.8893805309734514,0.11061946902654868,191,19,60,112,185,6,0.09947643979057591,0.31413612565445026,0.5863874345549738,0.9685863874345549,0.031413612565445025
9400,213,181,32,148,65,0.8497652582159625,0.15023474178403756,0.6948356807511737,0.3051643192488263,142,41,44,57,137,5,0.2887323943661972,0.30985915492957744,0.4014084507042254,0.9647887323943662,0.035211267605633804
9401,428,401,27,388,40,0.9369158878504673,0.0630841121495327,0.9065420560747663,0.09345794392523364,1038,210,469,359,991,47,0.2023121387283237,0.45183044315992293,0.34585741811175336,0.9547206165703276,0.04527938342967245
9402,164,137,27,127,37,0.8353658536585366,0.16463414634146342,0.774390243902439,0.22560975609756098,149,17,33,99,142,7,0.11409395973154363,0.2214765100671141,0.6644295302013423,0.9530201342281879,0.04697986577181208
9403,1278,936,342,1124,154,0.7323943661971831,0.2676056338028169,0.8794992175273866,0.12050078247261346,636,66,183,387,533,103,0.10377358490566038,0.28773584905660377,0.6084905660377359,0.8380503144654088,0.1619496855345912
9404,317,255,62,266,51,0.804416403785489,0.19558359621451105,0.8391167192429022,0.1608832807570978,191,19,60,112,185,6,0.09947643979057591,0.31413612565445026,0.5863874345549738,0.9685863874345549,0.031413612565445025
9405,336,226,110,286,50,0.6726190476190477,0.3273809523809524,0.8511904761904762,0.1488095238095238,212,23,64,125,205,7,0.10849056603773585,0.3018867924528302,0.589622641509434,0.9669811320754716,0.0330188679245283
9406,308,225,83,261,47,0.7305194805194806,0.2694805194805195,0.8474025974025974,0.1525974025974026,212,23,64,125,205,7,0.10849056603773585,0.3018867924528302,0.589622641509434,0.9669811320754716,0.0330188679245283
9407,1644,1531,113,1594,50,0.931265206812652,0.06873479318734793,0.9695863746958637,0.030413625304136254,191,19,60,112,185,6,0.09947643979057591,0.31413612565445026,0.5863874345549738,0.9685863874345549,0.031413612565445025
9408,364,254,110,308,56,0.6978021978021978,0.3021978021978022,0.8461538461538461,0.15384615384615385,191,19,60,112,185,6,0.09947643979057591,0.31413612565445026,0.5863874345549738,0.9685863874345549,0.031413612565445025
9409,320,244,76,274,46,0.7625,0.2375,0.85625,0.14375,191,19,60,112,185,6,0.09947643979057591,0.31413612565445026,0.5863874345549738,0.9685863874345549,0.031413612565445025
9410,340,248,92,280,60,0.7294117647058823,0.27058823529411763,0.8235294117647058,0.17647058823529413,161,21,58,82,158,3,0.13043478260869565,0.36024844720496896,0.5093167701863354,0.9813664596273292,0.018633540372670808
9411,969,820,149,762,207,0.846233230134159,0.15376676986584106,0.7863777089783281,0.21362229102167182,134,44,63,27,134,0,0.3283582089552239,0.4701492537313433,0.20149253731343283,1.0,0.0
9412,218,167,51,146,72,0.7660550458715596,0.23394495412844038,0.6697247706422018,0.3302752293577982,249,0,183,66,222,27,0.0,0.7349397590361446,0.26506024096385544,0.891566265060241,0.10843373493975904
9413,323,232,91,277,46,0.718266253869969,0.28173374613003094,0.8575851393188855,0.14241486068111456,161,21,58,82,158,3,0.13043478260869565,0.36024844720496896,0.5093167701863354,0.9813664596273292,0.018633540372670808
9414,153,131,22,109,44,0.8562091503267973,0.1437908496732026,0.7124183006535948,0.2875816993464052,225,30,40,155,211,14,0.13333333333333333,0.17777777777777778,0.6888888888888889,0.9377777777777778,0.06222222222222222
9415,169,145,24,122,47,0.8579881656804734,0.14201183431952663,0.7218934911242604,0.2781065088757396,358,31,59,268,342,16,0.08659217877094973,0.164804469273743,0.7486033519553073,0.9553072625698324,0.0446927374301676
9416,46,1,45,22,24,0.021739130434782608,0.9782608695652174,0.4782608695652174,0.5217391304347826,331,115,72,144,307,24,0.3474320241691843,0.2175226586102719,0.4350453172205438,0.9274924471299094,0.07250755287009064
9417,360,311,49,288,72,0.8638888888888889,0.1361111111111111,0.8,0.2,189,19,64,106,182,7,0.10052910052910052,0.3386243386243386,0.5608465608465608,0.9629629629629629,0.037037037037037035
9418,368,258,110,318,50,0.7010869565217391,0.29891304347826086,0.8641304347826086,0.1358695652173913,191,19,60,112,185,6,0.09947643979057591,0.31413612565445026,0.5863874345549738,0.9685863874345549,0.031413612565445025
9419,324,257,67,275,49,0.7932098765432098,0.20679012345679013,0.8487654320987654,0.15123456790123457,191,19,60,112,185,6,0.09947643979057591,0.31413612565445026,0.5863874345549738,0.9685863874345549,0.031413612565445025
9420,167,136,31,121,46,0.8143712574850299,0.18562874251497005,0.7245508982035929,0.2754491017964072,362,121,148,93,333,29,0.3342541436464088,0.4088397790055249,0.2569060773480663,0.919889502762431,0.08011049723756906
9421,358,249,109,312,46,0.6955307262569832,0.30446927374301674,0.8715083798882681,0.12849162011173185,191,19,60,112,185,6,0.09947643979057591,0.31413612565445026,0.5863874345549738,0.9685863874345549,0.031413612565445025
9422,356,243,113,312,44,0.6825842696629213,0.31741573033707865,0.8764044943820225,0.12359550561797752,191,19,60,112,185,6,0.09947643979057591,0.31413612565445026,0.5863874345549738,0.9685863874345549,0.031413612565445025
9423,355,246,109,309,46,0.6929577464788732,0.30704225352112674,0.8704225352112676,0.1295774647887324,191,19,60,112,185,6,0.09947643979057591,0.31413612565445026,0.5863874345549738,0.9685863874345549,0.031413612565445025
9424,352,242,110,306,46,0.6875,0.3125,0.8693181818181818,0.13068181818181818,191,19,60,112,185,6,0.09947643979057591,0.31413612565445026,0.5863874345549738,0.9685863874345549,0.031413612565445025
9425,345,253,92,293,52,0.7333333333333333,0.26666666666666666,0.8492753623188406,0.15072463768115943,161,21,58,82,158,3,0.13043478260869565,0.36024844720496896,0.5093167701863354,0.9813664596273292,0.018633540372670808
9426,353,251,102,302,51,0.7110481586402266,0.28895184135977336,0.8555240793201133,0.14447592067988668,191,19,60,112,185,6,0.09947643979057591,0.31413612565445026,0.5863874345549738,0.9685863874345549,0.031413612565445025
9427,233,199,34,182,51,0.8540772532188842,0.1459227467811159,0.7811158798283262,0.21888412017167383,141,42,73,26,140,1,0.2978723404255319,0.5177304964539007,0.18439716312056736,0.9929078014184397,0.0070921985815602835
9428,319,270,49,270,49,0.8463949843260188,0.1536050156739812,0.8463949843260188,0.1536050156739812,191,19,60,112,185,6,0.09947643979057591,0.31413612565445026,0.5863874345549738,0.9685863874345549,0.031413612565445025
9429,1260,1094,166,1025,235,0.8682539682539683,0.13174603174603175,0.8134920634920635,0.1865079365079365,112,13,31,68,111,1,0.11607142857142858,0.2767857142857143,0.6071428571428571,0.9910714285714286,0.008928571428571428
9430,353,244,109,307,46,0.6912181303116147,0.3087818696883853,0.8696883852691218,0.13031161473087818,191,19,60,112,185,6,0.09947643979057591,0.31413612565445026,0.5863874345549738,0.9685863874345549,0.031413612565445025
9431,315,247,68,266,49,0.7841269841269841,0.21587301587301588,0.8444444444444444,0.15555555555555556,191,19,60,112,185,6,0.09947643979057591,0.31413612565445026,0.5863874345549738,0.9685863874345549,0.031413612565445025
9432,345,251,94,296,49,0.7275362318840579,0.27246376811594203,0.8579710144927536,0.14202898550724638,191,19,60,112,185,6,0.09947643979057591,0.31413612565445026,0.5863874345549738,0.9685863874345549,0.031413612565445025
9433,401,296,105,351,50,0.7381546134663342,0.26184538653366585,0.8753117206982544,0.12468827930174564,221,23,67,131,214,7,0.10407239819004525,0.3031674208144796,0.5927601809954751,0.9683257918552036,0.03167420814479638
9434,876,714,162,669,207,0.815068493150685,0.18493150684931506,0.7636986301369864,0.2363013698630137,79,13,20,46,72,7,0.16455696202531644,0.25316455696202533,0.5822784810126582,0.9113924050632911,0.08860759493670886
9435,214,165,49,141,73,0.7710280373831776,0.22897196261682243,0.6588785046728972,0.3411214953271028,348,0,269,79,324,24,0.0,0.7729885057471264,0.22701149425287356,0.9310344827586207,0.06896551724137931
9436,311,256,55,263,48,0.8231511254019293,0.17684887459807075,0.8456591639871383,0.15434083601286175,191,19,60,112,185,6,0.09947643979057591,0.31413612565445026,0.5863874345549738,0.9685863874345549,0.031413612565445025
9437,298,242,56,254,44,0.8120805369127517,0.18791946308724833,0.8523489932885906,0.1476510067114094,191,19,60,112,185,6,0.09947643979057591,0.31413612565445026,0.5863874345549738,0.9685863874345549,0.031413612565445025
9438,414,360,54,353,61,0.8695652173913043,0.13043478260869565,0.8526570048309179,0.1473429951690821,60,10,13,37,58,2,0.16666666666666666,0.21666666666666667,0.6166666666666667,0.9666666666666667,0.03333333333333333
9439,357,245,112,312,45,0.6862745098039216,0.3137254901960784,0.8739495798319328,0.12605042016806722,191,19,60,112,185,6,0.09947643979057591,0.31413612565445026,0.5863874345549738,0.9685863874345549,0.031413612565445025
9440,352,249,103,302,50,0.7073863636363636,0.29261363636363635,0.8579545454545454,0.14204545454545456,191,19,60,112,185,6,0.09947643979057591,0.31413612565445026,0.5863874345549738,0.9685863874345549,0.031413612565445025
9441,318,267,51,263,55,0.839622641509434,0.16037735849056603,0.8270440251572327,0.17295597484276728,221,23,67,131,214,7,0.10407239819004525,0.3031674208144796,0.5927601809954751,0.9683257918552036,0.03167420814479638
9442,301,252,49,253,48,0.8372093023255814,0.16279069767441862,0.840531561461794,0.15946843853820597,191,19,60,112,185,6,0.09947643979057591,0.31413612565445026,0.5863874345549738,0.9685863874345549,0.031413612565445025
9443,1577,1343,234,1244,333,0.8516169942929613,0.1483830057070387,0.7888395688015218,0.21116043119847813,108,16,22,70,99,9,0.14814814814814814,0.2037037037037037,0.6481481481481481,0.9166666666666666,0.08333333333333333
9444,361,253,108,311,50,0.7008310249307479,0.29916897506925205,0.8614958448753463,0.13850415512465375,191,19,60,112,185,6,0.09947643979057591,0.31413612565445026,0.5863874345549738,0.9685863874345549,0.031413612565445025
9445,313,266,47,265,48,0.8498402555910544,0.1501597444089457,0.8466453674121406,0.15335463258785942,221,23,67,131,214,7,0.10407239819004525,0.3031674208144796,0.5927601809954751,0.9683257918552036,0.03167420814479638
9446,448,335,113,404,44,0.7477678571428571,0.25223214285714285,0.9017857142857143,0.09821428571428571,191,19,60,112,185,6,0.09947643979057591,0.31413612565445026,0.5863874345549738,0.9685863874345549,0.031413612565445025
9447,351,248,103,304,47,0.7065527065527065,0.2934472934472934,0.8660968660968661,0.1339031339031339,191,19,60,112,185,6,0.09947643979057591,0.31413612565445026,0.5863874345549738,0.9685863874345549,0.031413612565445025
9448,41,41,0,21,20,1.0,0.0,0.5121951219512195,0.4878048780487805,7,0,0,7,6,1,0.0,0.0,1.0,0.8571428571428571,0.14285714285714285
9449,724,518,206,562,162,0.7154696132596685,0.2845303867403315,0.7762430939226519,0.22375690607734808,98,16,23,59,90,8,0.16326530612244897,0.23469387755102042,0.6020408163265306,0.9183673469387755,0.08163265306122448
9450,355,302,53,303,52,0.8507042253521127,0.14929577464788732,0.8535211267605634,0.14647887323943662,221,23,67,131,214,7,0.10407239819004525,0.3031674208144796,0.5927601809954751,0.9683257918552036,0.03167420814479638
9451,363,252,111,313,50,0.6942148760330579,0.30578512396694213,0.8622589531680441,0.13774104683195593,191,19,60,112,185,6,0.09947643979057591,0.31413612565445026,0.5863874345549738,0.9685863874345549,0.031413612565445025
9452,1429,1408,21,1044,385,0.9853044086773968,0.01469559132260322,0.7305808257522743,0.26941917424772566,166,2,10,154,151,15,0.012048192771084338,0.060240963855421686,0.927710843373494,0.9096385542168675,0.09036144578313253
9453,346,248,98,298,48,0.7167630057803468,0.2832369942196532,0.861271676300578,0.13872832369942195,191,19,60,112,185,6,0.09947643979057591,0.31413612565445026,0.5863874345549738,0.9685863874345549,0.031413612565445025
9454,343,239,104,291,52,0.6967930029154519,0.3032069970845481,0.8483965014577259,0.15160349854227406,221,23,67,131,214,7,0.10407239819004525,0.3031674208144796,0.5927601809954751,0.9683257918552036,0.03167420814479638
9455,357,247,110,309,48,0.6918767507002801,0.3081232492997199,0.865546218487395,0.13445378151260504,191,19,60,112,185,6,0.09947643979057591,0.31413612565445026,0.5863874345549738,0.9685863874345549,0.031413612565445025
9456,361,251,110,311,50,0.6952908587257618,0.3047091412742382,0.8614958448753463,0.13850415512465375,191,19,60,112,185,6,0.09947643979057591,0.31413612565445026,0.5863874345549738,0.9685863874345549,0.031413612565445025
9457,368,258,110,320,48,0.7010869565217391,0.29891304347826086,0.8695652173913043,0.13043478260869565,191,19,60,112,185,6,0.09947643979057591,0.31413612565445026,0.5863874345549738,0.9685863874345549,0.031413612565445025
9458,449,368,81,332,117,0.8195991091314031,0.18040089086859687,0.7394209354120267,0.26057906458797325,137,12,19,106,123,14,0.08759124087591241,0.1386861313868613,0.7737226277372263,0.8978102189781022,0.10218978102189781
9459,318,223,95,273,45,0.7012578616352201,0.29874213836477986,0.8584905660377359,0.14150943396226415,161,21,58,82,158,3,0.13043478260869565,0.36024844720496896,0.5093167701863354,0.9813664596273292,0.018633540372670808
9460,275,235,40,224,51,0.8545454545454545,0.14545454545454545,0.8145454545454546,0.18545454545454546,161,21,58,82,158,3,0.13043478260869565,0.36024844720496896,0.5093167701863354,0.9813664596273292,0.018633540372670808
9461,358,259,99,312,46,0.723463687150838,0.276536312849162,0.8715083798882681,0.12849162011173185,191,19,60,112,185,6,0.09947643979057591,0.31413612565445026,0.5863874345549738,0.9685863874345549,0.031413612565445025
9462,174,150,24,130,44,0.8620689655172413,0.13793103448275862,0.7471264367816092,0.25287356321839083,357,29,60,268,341,16,0.08123249299719888,0.16806722689075632,0.7507002801120448,0.9551820728291317,0.04481792717086835
9463,328,232,96,283,45,0.7073170731707317,0.2926829268292683,0.8628048780487805,0.13719512195121952,193,23,56,114,185,8,0.11917098445595854,0.29015544041450775,0.5906735751295337,0.9585492227979274,0.04145077720207254
9464,17652,16051,1601,11219,6433,0.9093020620892817,0.09069793791071833,0.6355653750283254,0.3644346249716746,6306,1076,877,4353,4785,1521,0.17063114494132572,0.13907389787503965,0.6902949571836346,0.7588011417697431,0.24119885823025689
9465,371,262,109,310,61,0.706199460916442,0.29380053908355797,0.8355795148247979,0.16442048517520216,191,19,60,112,185,6,0.09947643979057591,0.31413612565445026,0.5863874345549738,0.9685863874345549,0.031413612565445025
9466,327,240,87,285,42,0.7339449541284404,0.26605504587155965,0.8715596330275229,0.12844036697247707,191,19,60,112,185,6,0.09947643979057591,0.31413612565445026,0.5863874345549738,0.9685863874345549,0.031413612565445025
9467,147,127,20,113,34,0.8639455782312925,0.1360544217687075,0.7687074829931972,0.23129251700680273,264,14,48,202,254,10,0.05303030303030303,0.18181818181818182,0.7651515151515151,0.9621212121212122,0.03787878787878788
9468,400,292,108,348,52,0.73,0.27,0.87,0.13,191,19,60,112,185,6,0.09947643979057591,0.31413612565445026,0.5863874345549738,0.9685863874345549,0.031413612565445025
9469,359,250,109,312,47,0.6963788300835655,0.30362116991643456,0.8690807799442897,0.1309192200557103,191,19,60,112,185,6,0.09947643979057591,0.31413612565445026,0.5863874345549738,0.9685863874345549,0.031413612565445025
9470,420,310,110,376,44,0.7380952380952381,0.2619047619047619,0.8952380952380953,0.10476190476190476,191,19,60,112,185,6,0.09947643979057591,0.31413612565445026,0.5863874345549738,0.9685863874345549,0.031413612565445025
9471,359,245,114,316,43,0.6824512534818942,0.31754874651810583,0.8802228412256268,0.11977715877437325,191,19,60,112,185,6,0.09947643979057591,0.31413612565445026,0.5863874345549738,0.9685863874345549,0.031413612565445025
9472,282,232,50,234,48,0.8226950354609929,0.1773049645390071,0.8297872340425532,0.1702127659574468,161,21,58,82,158,3,0.13043478260869565,0.36024844720496896,0.5093167701863354,0.9813664596273292,0.018633540372670808
9473,288,232,56,239,49,0.8055555555555556,0.19444444444444445,0.8298611111111112,0.1701388888888889,221,23,67,131,214,7,0.10407239819004525,0.3031674208144796,0.5927601809954751,0.9683257918552036,0.03167420814479638
9474,485,404,81,348,137,0.8329896907216495,0.1670103092783505,0.7175257731958763,0.2824742268041237,95,13,17,65,85,10,0.1368421052631579,0.17894736842105263,0.6842105263157895,0.8947368421052632,0.10526315789473684
9475,200,170,30,157,43,0.85,0.15,0.785,0.215,192,17,25,150,183,9,0.08854166666666667,0.13020833333333334,0.78125,0.953125,0.046875
9476,364,298,66,319,45,0.8186813186813187,0.1813186813186813,0.8763736263736264,0.12362637362637363,191,19,60,112,185,6,0.09947643979057591,0.31413612565445026,0.5863874345549738,0.9685863874345549,0.031413612565445025
9477,717,598,119,575,142,0.8340306834030683,0.16596931659693165,0.8019525801952581,0.19804741980474197,92,15,23,54,90,2,0.16304347826086957,0.25,0.5869565217391305,0.9782608695652174,0.021739130434782608
9478,368,304,64,319,49,0.8260869565217391,0.17391304347826086,0.8668478260869565,0.1331521739130435,191,19,60,112,185,6,0.09947643979057591,0.31413612565445026,0.5863874345549738,0.9685863874345549,0.031413612565445025
9479,12238,11259,979,7950,4288,0.9200032685079261,0.07999673149207387,0.6496159503186795,0.3503840496813205,4216,349,561,3306,3176,1040,0.08277988614800759,0.13306451612903225,0.7841555977229602,0.7533206831119544,0.24667931688804554
9480,326,252,74,278,48,0.7730061349693251,0.22699386503067484,0.852760736196319,0.147239263803681,221,23,67,131,214,7,0.10407239819004525,0.3031674208144796,0.5927601809954751,0.9683257918552036,0.03167420814479638
9481,335,230,105,288,47,0.6865671641791045,0.31343283582089554,0.8597014925373134,0.14029850746268657,221,23,67,131,214,7,0.10407239819004525,0.3031674208144796,0.5927601809954751,0.9683257918552036,0.03167420814479638
9482,337,235,102,291,46,0.6973293768545994,0.3026706231454006,0.8635014836795252,0.13649851632047477,221,23,67,131,214,7,0.10407239819004525,0.3031674208144796,0.5927601809954751,0.9683257918552036,0.03167420814479638
9483,359,321,38,276,83,0.8941504178272981,0.10584958217270195,0.7688022284122563,0.23119777158774374,189,19,64,106,182,7,0.10052910052910052,0.3386243386243386,0.5608465608465608,0.9629629629629629,0.037037037037037035
9484,939,777,162,694,245,0.8274760383386581,0.17252396166134185,0.739084132055378,0.26091586794462196,78,14,19,45,71,7,0.1794871794871795,0.24358974358974358,0.5769230769230769,0.9102564102564102,0.08974358974358974
9485,322,254,68,271,51,0.7888198757763976,0.2111801242236025,0.8416149068322981,0.15838509316770186,191,19,60,112,185,6,0.09947643979057591,0.31413612565445026,0.5863874345549738,0.9685863874345549,0.031413612565445025
9486,212,164,48,139,73,0.7735849056603774,0.22641509433962265,0.6556603773584906,0.3443396226415094,152,0,48,104,149,3,0.0,0.3157894736842105,0.6842105263157895,0.9802631578947368,0.019736842105263157
9487,313,222,91,269,44,0.7092651757188498,0.29073482428115016,0.8594249201277955,0.14057507987220447,161,21,58,82,158,3,0.13043478260869565,0.36024844720496896,0.5093167701863354,0.9813664596273292,0.018633540372670808
9488,353,249,104,304,49,0.7053824362606232,0.29461756373937675,0.8611898016997167,0.1388101983002833,191,19,60,112,185,6,0.09947643979057591,0.31413612565445026,0.5863874345549738,0.9685863874345549,0.031413612565445025
9489,202,147,55,130,72,0.7277227722772277,0.2722772277227723,0.6435643564356436,0.3564356435643564,200,3,66,131,196,4,0.015,0.33,0.655,0.98,0.02
9490,314,270,44,268,46,0.8598726114649682,0.14012738853503184,0.8535031847133758,0.1464968152866242,191,19,60,112,185,6,0.09947643979057591,0.31413612565445026,0.5863874345549738,0.9685863874345549,0.031413612565445025
9491,360,257,103,310,50,0.7138888888888889,0.2861111111111111,0.8611111111111112,0.1388888888888889,191,19,60,112,185,6,0.09947643979057591,0.31413612565445026,0.5863874345549738,0.9685863874345549,0.031413612565445025
9492,315,252,63,263,52,0.8,0.2,0.834920634920635,0.16507936507936508,191,19,60,112,185,6,0.09947643979057591,0.31413612565445026,0.5863874345549738,0.9685863874345549,0.031413612565445025
9493,384,332,52,302,82,0.8645833333333334,0.13541666666666666,0.7864583333333334,0.21354166666666666,91,10,15,66,89,2,0.10989010989010989,0.16483516483516483,0.7252747252747253,0.978021978021978,0.02197802197802198
9494,431,363,68,313,118,0.8422273781902552,0.15777262180974477,0.7262180974477959,0.2737819025522042,136,38,71,27,136,0,0.27941176470588236,0.5220588235294118,0.19852941176470587,1.0,0.0
9495,362,250,112,310,52,0.6906077348066298,0.30939226519337015,0.856353591160221,0.143646408839779,191,19,60,112,185,6,0.09947643979057591,0.31413612565445026,0.5863874345549738,0.9685863874345549,0.031413612565445025
9496,460,379,81,336,124,0.8239130434782609,0.17608695652173914,0.7304347826086957,0.26956521739130435,98,13,19,66,88,10,0.1326530612244898,0.19387755102040816,0.673469387755102,0.8979591836734694,0.10204081632653061
9497,451,385,66,328,123,0.8536585365853658,0.14634146341463414,0.7272727272727273,0.2727272727272727,136,37,73,26,136,0,0.27205882352941174,0.5367647058823529,0.19117647058823528,1.0,0.0
9498,9817,7028,2789,5312,4505,0.7159009880818987,0.2840990119181013,0.5411021697056128,0.4588978302943873,1938,41,382,1515,1803,135,0.021155830753353973,0.19711042311661506,0.781733746130031,0.9303405572755418,0.0696594427244582
9499,322,267,55,267,55,0.8291925465838509,0.17080745341614906,0.8291925465838509,0.17080745341614906,191,19,60,112,185,6,0.09947643979057591,0.31413612565445026,0.5863874345549738,0.9685863874345549,0.031413612565445025
9500,17852,14220,3632,13904,3948,0.796549406228994,0.20345059377100605,0.7788483083127941,0.22115169168720591,8060,605,698,6757,5508,2552,0.0750620347394541,0.08660049627791563,0.8383374689826303,0.6833746898263028,0.31662531017369727
9501,193,173,20,152,41,0.8963730569948186,0.10362694300518134,0.7875647668393783,0.21243523316062177,273,120,82,71,264,9,0.43956043956043955,0.30036630036630035,0.2600732600732601,0.967032967032967,0.03296703296703297
9502,303,253,50,250,53,0.834983498349835,0.16501650165016502,0.8250825082508251,0.17491749174917492,191,19,60,112,185,6,0.09947643979057591,0.31413612565445026,0.5863874345549738,0.9685863874345549,0.031413612565445025
9503,363,253,110,309,54,0.696969696969697,0.30303030303030304,0.8512396694214877,0.1487603305785124,191,19,60,112,185,6,0.09947643979057591,0.31413612565445026,0.5863874345549738,0.9685863874345549,0.031413612565445025
9504,361,248,113,312,49,0.6869806094182825,0.31301939058171746,0.8642659279778393,0.13573407202216067,191,19,60,112,185,6,0.09947643979057591,0.31413612565445026,0.5863874345549738,0.9685863874345549,0.031413612565445025
9505,365,255,110,316,49,0.6986301369863014,0.3013698630136986,0.8657534246575342,0.13424657534246576,191,19,60,112,185,6,0.09947643979057591,0.31413612565445026,0.5863874345549738,0.9685863874345549,0.031413612565445025
9506,359,264,95,312,47,0.7353760445682451,0.2646239554317549,0.8690807799442897,0.1309192200557103,193,23,56,114,185,8,0.11917098445595854,0.29015544041450775,0.5906735751295337,0.9585492227979274,0.04145077720207254
9507,154,131,23,122,32,0.8506493506493507,0.14935064935064934,0.7922077922077922,0.2077922077922078,601,39,80,482,580,21,0.064891846921797,0.13311148086522462,0.8019966722129783,0.9650582362728786,0.03494176372712146
9508,885,718,167,698,187,0.8112994350282486,0.18870056497175142,0.7887005649717514,0.21129943502824858,96,16,53,27,95,1,0.16666666666666666,0.5520833333333334,0.28125,0.9895833333333334,0.010416666666666666
9509,217,180,37,161,56,0.8294930875576036,0.17050691244239632,0.7419354838709677,0.25806451612903225,122,34,42,46,119,3,0.2786885245901639,0.3442622950819672,0.3770491803278688,0.9754098360655737,0.02459016393442623
9510,321,228,93,274,47,0.7102803738317757,0.2897196261682243,0.8535825545171339,0.14641744548286603,161,21,58,82,158,3,0.13043478260869565,0.36024844720496896,0.5093167701863354,0.9813664596273292,0.018633540372670808
9511,405,293,112,360,45,0.7234567901234568,0.2765432098765432,0.8888888888888888,0.1111111111111111,191,19,60,112,185,6,0.09947643979057591,0.31413612565445026,0.5863874345549738,0.9685863874345549,0.031413612565445025
9512,283,242,41,240,43,0.8551236749116607,0.14487632508833923,0.8480565371024735,0.1519434628975265,191,19,60,112,185,6,0.09947643979057591,0.31413612565445026,0.5863874345549738,0.9685863874345549,0.031413612565445025
9513,42,42,0,22,20,1.0,0.0,0.5238095238095238,0.47619047619047616,3,0,0,3,3,0,0.0,0.0,1.0,1.0,0.0
9514,329,237,92,284,45,0.7203647416413373,0.2796352583586626,0.8632218844984803,0.13677811550151975,193,23,56,114,185,8,0.11917098445595854,0.29015544041450775,0.5906735751295337,0.9585492227979274,0.04145077720207254
9515,219,168,51,147,72,0.7671232876712328,0.2328767123287671,0.6712328767123288,0.3287671232876712,293,0,231,62,267,26,0.0,0.78839590443686,0.21160409556313994,0.9112627986348123,0.08873720136518772
9516,301,249,52,253,48,0.8272425249169435,0.17275747508305647,0.840531561461794,0.15946843853820597,191,19,60,112,185,6,0.09947643979057591,0.31413612565445026,0.5863874345549738,0.9685863874345549,0.031413612565445025
9517,401,298,103,344,57,0.743142144638404,0.256857855361596,0.85785536159601,0.14214463840399003,221,23,67,131,214,7,0.10407239819004525,0.3031674208144796,0.5927601809954751,0.9683257918552036,0.03167420814479638
9518,371,261,110,329,42,0.7035040431266847,0.29649595687331537,0.8867924528301887,0.11320754716981132,191,19,60,112,185,6,0.09947643979057591,0.31413612565445026,0.5863874345549738,0.9685863874345549,0.031413612565445025
9519,330,237,93,279,51,0.7181818181818181,0.2818181818181818,0.8454545454545455,0.15454545454545454,161,21,58,82,158,3,0.13043478260869565,0.36024844720496896,0.5093167701863354,0.9813664596273292,0.018633540372670808
9520,448,378,70,329,119,0.84375,0.15625,0.734375,0.265625,148,39,47,62,144,4,0.2635135135135135,0.31756756756756754,0.4189189189189189,0.972972972972973,0.02702702702702703
9521,315,249,66,263,52,0.7904761904761904,0.20952380952380953,0.834920634920635,0.16507936507936508,221,23,67,131,214,7,0.10407239819004525,0.3031674208144796,0.5927601809954751,0.9683257918552036,0.03167420814479638
9522,325,231,94,275,50,0.7107692307692308,0.28923076923076924,0.8461538461538461,0.15384615384615385,161,21,58,82,158,3,0.13043478260869565,0.36024844720496896,0.5093167701863354,0.9813664596273292,0.018633540372670808
9523,357,248,109,308,49,0.6946778711484594,0.30532212885154064,0.8627450980392157,0.13725490196078433,191,19,60,112,185,6,0.09947643979057591,0.31413612565445026,0.5863874345549738,0.9685863874345549,0.031413612565445025
9524,382,267,115,328,54,0.6989528795811518,0.3010471204188482,0.8586387434554974,0.14136125654450263,191,19,60,112,185,6,0.09947643979057591,0.31413612565445026,0.5863874345549738,0.9685863874345549,0.031413612565445025
9525,1227,1079,148,992,235,0.8793806030969845,0.12061939690301549,0.8084759576202118,0.1915240423797881,232,15,21,196,222,10,0.06465517241379311,0.09051724137931035,0.8448275862068966,0.9568965517241379,0.04310344827586207
9526,294,225,69,254,40,0.7653061224489796,0.23469387755102042,0.8639455782312925,0.1360544217687075,193,23,56,114,185,8,0.11917098445595854,0.29015544041450775,0.5906735751295337,0.9585492227979274,0.04145077720207254
9527,671,580,91,520,151,0.8643815201192251,0.13561847988077497,0.7749627421758569,0.22503725782414308,569,93,111,365,549,20,0.1634446397188049,0.19507908611599298,0.6414762741652021,0.9648506151142355,0.0351493848857645
9528,389,285,104,343,46,0.7326478149100257,0.26735218508997427,0.8817480719794345,0.11825192802056556,69,12,17,40,65,4,0.17391304347826086,0.2463768115942029,0.5797101449275363,0.9420289855072463,0.057971014492753624
9529,197,129,68,179,18,0.6548223350253807,0.34517766497461927,0.9086294416243654,0.09137055837563451,292,35,118,139,283,9,0.11986301369863013,0.4041095890410959,0.476027397260274,0.9691780821917808,0.030821917808219176
9530,416,304,112,372,44,0.7307692307692307,0.2692307692307692,0.8942307692307693,0.10576923076923077,191,19,60,112,185,6,0.09947643979057591,0.31413612565445026,0.5863874345549738,0.9685863874345549,0.031413612565445025
9531,27,1,26,20,7,0.037037037037037035,0.9629629629629629,0.7407407407407407,0.25925925925925924,326,72,46,208,283,43,0.22085889570552147,0.1411042944785276,0.6380368098159509,0.8680981595092024,0.13190184049079753
9532,282,236,46,231,51,0.8368794326241135,0.16312056737588654,0.8191489361702128,0.18085106382978725,221,23,67,131,214,7,0.10407239819004525,0.3031674208144796,0.5927601809954751,0.9683257918552036,0.03167420814479638
9533,145,123,22,118,27,0.8482758620689655,0.15172413793103448,0.8137931034482758,0.18620689655172415,175,2,14,159,157,18,0.011428571428571429,0.08,0.9085714285714286,0.8971428571428571,0.10285714285714286
9534,131,104,27,101,30,0.7938931297709924,0.20610687022900764,0.7709923664122137,0.22900763358778625,172,18,41,113,162,10,0.10465116279069768,0.23837209302325582,0.6569767441860465,0.9418604651162791,0.05813953488372093
9535,581,481,100,461,120,0.8278829604130808,0.1721170395869191,0.7934595524956971,0.20654044750430292,129,17,83,29,128,1,0.13178294573643412,0.6434108527131783,0.2248062015503876,0.9922480620155039,0.007751937984496124
9536,364,253,111,314,50,0.695054945054945,0.30494505494505497,0.8626373626373627,0.13736263736263737,191,19,60,112,185,6,0.09947643979057591,0.31413612565445026,0.5863874345549738,0.9685863874345549,0.031413612565445025
9537,287,240,47,234,53,0.8362369337979094,0.16376306620209058,0.8153310104529616,0.18466898954703834,221,23,67,131,214,7,0.10407239819004525,0.3031674208144796,0.5927601809954751,0.9683257918552036,0.03167420814479638
9538,332,246,86,286,46,0.7409638554216867,0.25903614457831325,0.8614457831325302,0.13855421686746988,191,19,60,112,185,6,0.09947643979057591,0.31413612565445026,0.5863874345549738,0.9685863874345549,0.031413612565445025
9539,363,253,110,311,52,0.696969696969697,0.30303030303030304,0.8567493112947658,0.14325068870523416,191,19,60,112,185,6,0.09947643979057591,0.31413612565445026,0.5863874345549738,0.9685863874345549,0.031413612565445025
9540,412,358,54,358,54,0.8689320388349514,0.13106796116504854,0.8689320388349514,0.13106796116504854,110,11,12,87,107,3,0.1,0.10909090909090909,0.7909090909090909,0.9727272727272728,0.02727272727272727
9541,358,251,107,310,48,0.7011173184357542,0.2988826815642458,0.8659217877094972,0.1340782122905028,191,19,60,112,185,6,0.09947643979057591,0.31413612565445026,0.5863874345549738,0.9685863874345549,0.031413612565445025
9542,210,161,49,138,72,0.7666666666666667,0.23333333333333334,0.6571428571428571,0.34285714285714286,72,1,4,67,61,11,0.013888888888888888,0.05555555555555555,0.9305555555555556,0.8472222222222222,0.1527777777777778
9543,375,271,104,314,61,0.7226666666666667,0.2773333333333333,0.8373333333333334,0.16266666666666665,221,23,67,131,214,7,0.10407239819004525,0.3031674208144796,0.5927601809954751,0.9683257918552036,0.03167420814479638
9544,346,260,86,298,48,0.7514450867052023,0.24855491329479767,0.861271676300578,0.13872832369942195,191,19,60,112,185,6,0.09947643979057591,0.31413612565445026,0.5863874345549738,0.9685863874345549,0.031413612565445025
9545,368,256,112,319,49,0.6956521739130435,0.30434782608695654,0.8668478260869565,0.1331521739130435,191,19,60,112,185,6,0.09947643979057591,0.31413612565445026,0.5863874345549738,0.9685863874345549,0.031413612565445025
9546,672,566,106,523,149,0.8422619047619048,0.15773809523809523,0.7782738095238095,0.22172619047619047,121,16,22,83,111,10,0.1322314049586777,0.18181818181818182,0.6859504132231405,0.9173553719008265,0.08264462809917356
9547,383,272,111,334,49,0.7101827676240209,0.2898172323759791,0.8720626631853786,0.1279373368146214,212,23,64,125,205,7,0.10849056603773585,0.3018867924528302,0.589622641509434,0.9669811320754716,0.0330188679245283
9548,9086,6148,2938,5091,3995,0.6766453885097953,0.3233546114902047,0.5603125687871451,0.4396874312128549,4239,164,919,3156,4186,53,0.03868836989856098,0.21679641424864354,0.7445152158527955,0.9874970511913187,0.012502948808681292
9549,158,130,28,123,35,0.8227848101265823,0.17721518987341772,0.7784810126582279,0.22151898734177214,347,33,75,239,334,13,0.09510086455331412,0.21613832853025935,0.6887608069164265,0.962536023054755,0.037463976945244955
9550,848,687,161,654,194,0.8101415094339622,0.18985849056603774,0.7712264150943396,0.22877358490566038,99,15,18,66,92,7,0.15151515151515152,0.18181818181818182,0.6666666666666666,0.9292929292929293,0.0707070707070707
9551,289,239,50,245,44,0.8269896193771626,0.17301038062283736,0.8477508650519031,0.1522491349480969,191,19,60,112,185,6,0.09947643979057591,0.31413612565445026,0.5863874345549738,0.9685863874345549,0.031413612565445025
9552,592,468,124,563,29,0.7905405405405406,0.20945945945945946,0.9510135135135135,0.048986486486486486,393,75,136,182,378,15,0.19083969465648856,0.3460559796437659,0.4631043256997455,0.9618320610687023,0.03816793893129771
9553,347,241,106,302,45,0.6945244956772334,0.30547550432276654,0.8703170028818443,0.12968299711815562,191,19,60,112,185,6,0.09947643979057591,0.31413612565445026,0.5863874345549738,0.9685863874345549,0.031413612565445025
9554,391,282,109,349,42,0.7212276214833759,0.27877237851662406,0.8925831202046036,0.10741687979539642,191,19,60,112,185,6,0.09947643979057591,0.31413612565445026,0.5863874345549738,0.9685863874345549,0.031413612565445025
9555,352,252,100,299,53,0.7159090909090909,0.2840909090909091,0.8494318181818182,0.15056818181818182,191,19,60,112,185,6,0.09947643979057591,0.31413612565445026,0.5863874345549738,0.9685863874345549,0.031413612565445025
9556,384,336,48,315,69,0.875,0.125,0.8203125,0.1796875,176,4,41,131,125,51,0.022727272727272728,0.23295454545454544,0.7443181818181818,0.7102272727272727,0.2897727272727273
9557,358,245,113,313,45,0.6843575418994413,0.31564245810055863,0.8743016759776536,0.12569832402234637,191,19,60,112,185,6,0.09947643979057591,0.31413612565445026,0.5863874345549738,0.9685863874345549,0.031413612565445025
9558,972,824,148,772,200,0.8477366255144033,0.1522633744855967,0.7942386831275721,0.205761316872428,134,43,64,27,134,0,0.3208955223880597,0.47761194029850745,0.20149253731343283,1.0,0.0
9559,315,265,50,270,45,0.8412698412698413,0.15873015873015872,0.8571428571428571,0.14285714285714285,191,19,60,112,185,6,0.09947643979057591,0.31413612565445026,0.5863874345549738,0.9685863874345549,0.031413612565445025
9560,357,249,108,306,51,0.6974789915966386,0.3025210084033613,0.8571428571428571,0.14285714285714285,191,19,60,112,185,6,0.09947643979057591,0.31413612565445026,0.5863874345549738,0.9685863874345549,0.031413612565445025
9561,338,245,93,282,56,0.7248520710059172,0.27514792899408286,0.834319526627219,0.16568047337278108,221,23,67,131,214,7,0.10407239819004525,0.3031674208144796,0.5927601809954751,0.9683257918552036,0.03167420814479638
9562,277,231,46,229,48,0.8339350180505415,0.16606498194945848,0.8267148014440433,0.17328519855595667,221,23,67,131,214,7,0.10407239819004525,0.3031674208144796,0.5927601809954751,0.9683257918552036,0.03167420814479638
9563,1241,1006,235,917,324,0.8106365834004835,0.18936341659951653,0.7389202256244963,0.2610797743755036,139,36,44,59,135,4,0.2589928057553957,0.31654676258992803,0.4244604316546763,0.9712230215827338,0.02877697841726619
9564,1920,1451,469,1618,302,0.7557291666666667,0.24427083333333333,0.8427083333333333,0.15729166666666666,2251,7,508,1736,1374,877,0.003109729009329187,0.22567747667703242,0.7712127943136384,0.6103953798311862,0.38960462016881386
9565,451,384,67,318,133,0.8514412416851441,0.14855875831485588,0.70509977827051,0.29490022172949004,162,47,54,61,158,4,0.29012345679012347,0.3333333333333333,0.3765432098765432,0.9753086419753086,0.024691358024691357
9566,403,289,114,350,53,0.71712158808933,0.28287841191067,0.8684863523573201,0.1315136476426799,191,19,60,112,185,6,0.09947643979057591,0.31413612565445026,0.5863874345549738,0.9685863874345549,0.031413612565445025
9567,321,229,92,272,49,0.7133956386292835,0.2866043613707165,0.8473520249221184,0.1526479750778816,161,21,58,82,158,3,0.13043478260869565,0.36024844720496896,0.5093167701863354,0.9813664596273292,0.018633540372670808
9568,970,810,160,770,200,0.8350515463917526,0.16494845360824742,0.7938144329896907,0.20618556701030927,99,31,46,22,99,0,0.31313131313131315,0.46464646464646464,0.2222222222222222,1.0,0.0
9569,1234,1085,149,988,246,0.8792544570502431,0.12074554294975688,0.8006482982171799,0.1993517017828201,233,15,21,197,224,9,0.06437768240343347,0.09012875536480687,0.8454935622317596,0.9613733905579399,0.03862660944206009
9570,440,374,66,327,113,0.85,0.15,0.7431818181818182,0.25681818181818183,118,33,62,23,118,0,0.2796610169491525,0.5254237288135594,0.19491525423728814,1.0,0.0
9571,379,273,106,331,48,0.7203166226912929,0.2796833773087071,0.8733509234828496,0.1266490765171504,191,19,60,112,185,6,0.09947643979057591,0.31413612565445026,0.5863874345549738,0.9685863874345549,0.031413612565445025
9572,3867,2885,982,3068,799,0.7460563744504785,0.2539436255495216,0.7933798810447376,0.20662011895526247,824,84,204,536,707,117,0.10194174757281553,0.24757281553398058,0.6504854368932039,0.8580097087378641,0.14199029126213591
9573,152,125,27,121,31,0.8223684210526315,0.17763157894736842,0.7960526315789473,0.20394736842105263,149,17,33,99,142,7,0.11409395973154363,0.2214765100671141,0.6644295302013423,0.9530201342281879,0.04697986577181208
9574,335,229,106,288,47,0.6835820895522388,0.3164179104477612,0.8597014925373134,0.14029850746268657,221,23,67,131,214,7,0.10407239819004525,0.3031674208144796,0.5927601809954751,0.9683257918552036,0.03167420814479638
9575,46,46,0,23,23,1.0,0.0,0.5,0.5,3,0,0,3,3,0,0.0,0.0,1.0,1.0,0.0
9576,324,253,71,272,52,0.7808641975308642,0.2191358024691358,0.8395061728395061,0.16049382716049382,191,19,60,112,185,6,0.09947643979057591,0.31413612565445026,0.5863874345549738,0.9685863874345549,0.031413612565445025
9577,304,251,53,257,47,0.8256578947368421,0.17434210526315788,0.8453947368421053,0.15460526315789475,191,19,60,112,185,6,0.09947643979057591,0.31413612565445026,0.5863874345549738,0.9685863874345549,0.031413612565445025
9578,366,257,109,315,51,0.7021857923497268,0.2978142076502732,0.860655737704918,0.13934426229508196,191,19,60,112,185,6,0.09947643979057591,0.31413612565445026,0.5863874345549738,0.9685863874345549,0.031413612565445025
9579,287,247,40,242,45,0.8606271777003485,0.13937282229965156,0.8432055749128919,0.156794425087108,191,19,60,112,185,6,0.09947643979057591,0.31413612565445026,0.5863874345549738,0.9685863874345549,0.031413612565445025
9580,334,251,83,286,48,0.7514970059880239,0.24850299401197604,0.8562874251497006,0.1437125748502994,191,19,60,112,185,6,0.09947643979057591,0.31413612565445026,0.5863874345549738,0.9685863874345549,0.031413612565445025
9581,83,83,0,65,18,1.0,0.0,0.7831325301204819,0.21686746987951808,4,0,0,4,4,0,0.0,0.0,1.0,1.0,0.0
9582,152,125,27,119,33,0.8223684210526315,0.17763157894736842,0.7828947368421053,0.21710526315789475,150,16,36,98,144,6,0.10666666666666667,0.24,0.6533333333333333,0.96,0.04
9583,350,241,109,307,43,0.6885714285714286,0.31142857142857144,0.8771428571428571,0.12285714285714286,191,19,60,112,185,6,0.09947643979057591,0.31413612565445026,0.5863874345549738,0.9685863874345549,0.031413612565445025
9584,323,233,90,273,50,0.7213622291021672,0.2786377708978328,0.8452012383900929,0.15479876160990713,221,23,67,131,214,7,0.10407239819004525,0.3031674208144796,0.5927601809954751,0.9683257918552036,0.03167420814479638
9585,294,245,49,245,49,0.8333333333333334,0.16666666666666666,0.8333333333333334,0.16666666666666666,193,23,56,114,185,8,0.11917098445595854,0.29015544041450775,0.5906735751295337,0.9585492227979274,0.04145077720207254
9586,317,236,81,269,48,0.7444794952681388,0.2555205047318612,0.8485804416403786,0.15141955835962145,193,23,56,114,185,8,0.11917098445595854,0.29015544041450775,0.5906735751295337,0.9585492227979274,0.04145077720207254
9587,361,253,108,316,45,0.7008310249307479,0.29916897506925205,0.8753462603878116,0.12465373961218837,191,19,60,112,185,6,0.09947643979057591,0.31413612565445026,0.5863874345549738,0.9685863874345549,0.031413612565445025
9588,337,237,100,287,50,0.7032640949554896,0.29673590504451036,0.8516320474777448,0.14836795252225518,221,23,67,131,214,7,0.10407239819004525,0.3031674208144796,0.5927601809954751,0.9683257918552036,0.03167420814479638
9589,875,754,121,761,114,0.8617142857142858,0.1382857142857143,0.8697142857142857,0.13028571428571428,457,135,292,30,455,2,0.29540481400437635,0.6389496717724289,0.06564551422319474,0.9956236323851203,0.00437636761487965
9590,340,251,89,291,49,0.7382352941176471,0.26176470588235295,0.8558823529411764,0.14411764705882352,192,19,60,113,186,6,0.09895833333333333,0.3125,0.5885416666666666,0.96875,0.03125
9591,368,257,111,316,52,0.6983695652173914,0.3016304347826087,0.8586956521739131,0.14130434782608695,191,19,60,112,185,6,0.09947643979057591,0.31413612565445026,0.5863874345549738,0.9685863874345549,0.031413612565445025
9592,293,253,40,240,53,0.863481228668942,0.13651877133105803,0.8191126279863481,0.18088737201365188,191,19,60,112,185,6,0.09947643979057591,0.31413612565445026,0.5863874345549738,0.9685863874345549,0.031413612565445025
9593,187,151,36,145,42,0.8074866310160428,0.1925133689839572,0.7754010695187166,0.22459893048128343,67,15,18,34,62,5,0.22388059701492538,0.26865671641791045,0.5074626865671642,0.9253731343283582,0.07462686567164178
9594,338,231,107,286,52,0.6834319526627219,0.3165680473372781,0.8461538461538461,0.15384615384615385,212,23,64,125,205,7,0.10849056603773585,0.3018867924528302,0.589622641509434,0.9669811320754716,0.0330188679245283
9595,4755,3616,1139,2720,2035,0.7604626708727655,0.2395373291272345,0.5720294426919033,0.42797055730809674,2319,63,521,1735,2156,163,0.027166882276843468,0.22466580422595947,0.7481673134971971,0.9297110823630875,0.07028891763691246
9596,333,273,60,279,54,0.8198198198198198,0.18018018018018017,0.8378378378378378,0.16216216216216217,191,19,60,112,185,6,0.09947643979057591,0.31413612565445026,0.5863874345549738,0.9685863874345549,0.031413612565445025
9597,360,250,110,314,46,0.6944444444444444,0.3055555555555556,0.8722222222222222,0.12777777777777777,191,19,60,112,185,6,0.09947643979057591,0.31413612565445026,0.5863874345549738,0.9685863874345549,0.031413612565445025
9598,356,247,109,310,46,0.6938202247191011,0.3061797752808989,0.8707865168539326,0.12921348314606743,191,19,60,112,185,6,0.09947643979057591,0.31413612565445026,0.5863874345549738,0.9685863874345549,0.031413612565445025
9599,333,248,85,284,49,0.7447447447447447,0.2552552552552553,0.8528528528528528,0.14714714714714713,192,19,60,113,186,6,0.09895833333333333,0.3125,0.5885416666666666,0.96875,0.03125
9600,289,249,40,243,46,0.8615916955017301,0.1384083044982699,0.8408304498269896,0.15916955017301038,191,19,60,112,185,6,0.09947643979057591,0.31413612565445026,0.5863874345549738,0.9685863874345549,0.031413612565445025
9601,314,249,65,264,50,0.7929936305732485,0.2070063694267516,0.8407643312101911,0.1592356687898089,191,19,60,112,185,6,0.09947643979057591,0.31413612565445026,0.5863874345549738,0.9685863874345549,0.031413612565445025
9602,291,250,41,246,45,0.8591065292096219,0.140893470790378,0.845360824742268,0.15463917525773196,192,19,60,113,186,6,0.09895833333333333,0.3125,0.5885416666666666,0.96875,0.03125
9603,1257,1022,235,935,322,0.8130469371519491,0.1869530628480509,0.7438345266507558,0.2561654733492442,139,37,43,59,135,4,0.26618705035971224,0.30935251798561153,0.4244604316546763,0.9712230215827338,0.02877697841726619
9604,4526,3648,878,3971,555,0.8060097216084843,0.1939902783915157,0.8773751657092356,0.12262483429076447,1587,186,409,992,1333,254,0.11720226843100189,0.2577189666036547,0.6250787649653434,0.8399495904221802,0.1600504095778198
9605,319,244,75,275,44,0.7648902821316614,0.23510971786833856,0.8620689655172413,0.13793103448275862,191,19,60,112,185,6,0.09947643979057591,0.31413612565445026,0.5863874345549738,0.9685863874345549,0.031413612565445025
9606,936,759,177,670,266,0.8108974358974359,0.1891025641025641,0.7158119658119658,0.2841880341880342,151,16,42,93,143,8,0.10596026490066225,0.2781456953642384,0.6158940397350994,0.9470198675496688,0.052980132450331126
9607,164,141,23,124,40,0.8597560975609756,0.1402439024390244,0.7560975609756098,0.24390243902439024,289,33,40,216,272,17,0.11418685121107267,0.1384083044982699,0.7474048442906575,0.9411764705882353,0.058823529411764705
9608,323,238,85,277,46,0.7368421052631579,0.2631578947368421,0.8575851393188855,0.14241486068111456,161,21,58,82,158,3,0.13043478260869565,0.36024844720496896,0.5093167701863354,0.9813664596273292,0.018633540372670808
9609,323,228,95,280,43,0.7058823529411765,0.29411764705882354,0.8668730650154799,0.13312693498452013,193,23,56,114,185,8,0.11917098445595854,0.29015544041450775,0.5906735751295337,0.9585492227979274,0.04145077720207254
9610,356,245,111,310,46,0.6882022471910112,0.31179775280898875,0.8707865168539326,0.12921348314606743,191,19,60,112,185,6,0.09947643979057591,0.31413612565445026,0.5863874345549738,0.9685863874345549,0.031413612565445025
9611,232,197,35,161,71,0.8491379310344828,0.15086206896551724,0.6939655172413793,0.30603448275862066,148,31,57,60,143,5,0.20945945945945946,0.38513513513513514,0.40540540540540543,0.9662162162162162,0.033783783783783786
9612,328,236,92,283,45,0.7195121951219512,0.2804878048780488,0.8628048780487805,0.13719512195121952,193,23,56,114,185,8,0.11917098445595854,0.29015544041450775,0.5906735751295337,0.9585492227979274,0.04145077720207254
9613,364,253,111,315,49,0.695054945054945,0.30494505494505497,0.8653846153846154,0.1346153846153846,191,19,60,112,185,6,0.09947643979057591,0.31413612565445026,0.5863874345549738,0.9685863874345549,0.031413612565445025
9614,367,257,110,326,41,0.7002724795640327,0.2997275204359673,0.888283378746594,0.11171662125340599,191,19,60,112,185,6,0.09947643979057591,0.31413612565445026,0.5863874345549738,0.9685863874345549,0.031413612565445025
9615,691,574,117,661,30,0.8306801736613604,0.16931982633863965,0.9565846599131693,0.04341534008683068,369,72,139,158,357,12,0.1951219512195122,0.37669376693766937,0.4281842818428184,0.967479674796748,0.032520325203252036
9616,365,253,112,315,50,0.6931506849315069,0.30684931506849317,0.863013698630137,0.136986301369863,191,19,60,112,185,6,0.09947643979057591,0.31413612565445026,0.5863874345549738,0.9685863874345549,0.031413612565445025
9617,4467,3419,1048,3047,1420,0.7653906424893665,0.23460935751063353,0.6821132751287218,0.3178867248712783,2672,152,556,1964,2171,501,0.05688622754491018,0.20808383233532934,0.7350299401197605,0.8125,0.1875
9618,1948,1929,19,1424,524,0.9902464065708418,0.009753593429158111,0.731006160164271,0.26899383983572894,293,116,21,156,281,12,0.39590443686006827,0.07167235494880546,0.5324232081911263,0.9590443686006825,0.040955631399317405
9619,5442,4302,1140,3789,1653,0.7905181918412348,0.20948180815876516,0.6962513781697905,0.3037486218302095,3684,259,649,2776,3148,536,0.07030401737242128,0.1761672095548317,0.753528773072747,0.8545059717698155,0.1454940282301846
9620,1933,1914,19,1422,511,0.9901707190894982,0.00982928091050181,0.735644076564925,0.264355923435075,218,116,12,90,208,10,0.5321100917431193,0.05504587155963303,0.41284403669724773,0.9541284403669725,0.045871559633027525
9621,328,223,105,279,49,0.6798780487804879,0.3201219512195122,0.850609756097561,0.14939024390243902,212,23,64,125,205,7,0.10849056603773585,0.3018867924528302,0.589622641509434,0.9669811320754716,0.0330188679245283
9622,300,230,70,253,47,0.7666666666666667,0.23333333333333334,0.8433333333333334,0.15666666666666668,161,21,58,82,158,3,0.13043478260869565,0.36024844720496896,0.5093167701863354,0.9813664596273292,0.018633540372670808
9623,423,396,27,386,37,0.9361702127659575,0.06382978723404255,0.9125295508274232,0.08747044917257683,1038,210,469,359,991,47,0.2023121387283237,0.45183044315992293,0.34585741811175336,0.9547206165703276,0.04527938342967245
9624,354,243,111,308,46,0.6864406779661016,0.3135593220338983,0.8700564971751412,0.12994350282485875,191,19,60,112,185,6,0.09947643979057591,0.31413612565445026,0.5863874345549738,0.9685863874345549,0.031413612565445025
9625,1133,977,156,915,218,0.8623124448367167,0.13768755516328332,0.8075904677846425,0.19240953221535745,54,10,8,36,48,6,0.18518518518518517,0.14814814814814814,0.6666666666666666,0.8888888888888888,0.1111111111111111
9626,331,238,93,287,44,0.7190332326283988,0.2809667673716012,0.8670694864048338,0.13293051359516617,193,23,56,114,185,8,0.11917098445595854,0.29015544041450775,0.5906735751295337,0.9585492227979274,0.04145077720207254
9627,0,0,0,0,0,0.0,0.0,0.0,0.0,0,0,0,0,0,0,0.0,0.0,0.0,0.0,0.0
9628,373,267,106,324,49,0.7158176943699732,0.28418230563002683,0.868632707774799,0.13136729222520108,191,19,60,112,185,6,0.09947643979057591,0.31413612565445026,0.5863874345549738,0.9685863874345549,0.031413612565445025
9629,368,258,110,316,52,0.7010869565217391,0.29891304347826086,0.8586956521739131,0.14130434782608695,191,19,60,112,185,6,0.09947643979057591,0.31413612565445026,0.5863874345549738,0.9685863874345549,0.031413612565445025
9630,340,252,88,291,49,0.7411764705882353,0.25882352941176473,0.8558823529411764,0.14411764705882352,191,19,60,112,185,6,0.09947643979057591,0.31413612565445026,0.5863874345549738,0.9685863874345549,0.031413612565445025
9631,292,244,48,242,50,0.8356164383561644,0.1643835616438356,0.8287671232876712,0.17123287671232876,193,23,56,114,185,8,0.11917098445595854,0.29015544041450775,0.5906735751295337,0.9585492227979274,0.04145077720207254
9632,1936,1580,356,1567,369,0.8161157024793388,0.18388429752066116,0.809400826446281,0.190599173553719,1365,11,247,1107,975,390,0.00805860805860806,0.18095238095238095,0.810989010989011,0.7142857142857143,0.2857142857142857
9633,41,41,0,21,20,1.0,0.0,0.5121951219512195,0.4878048780487805,7,0,0,7,6,1,0.0,0.0,1.0,0.8571428571428571,0.14285714285714285
9634,1647,1317,330,1278,369,0.7996357012750456,0.20036429872495445,0.7759562841530054,0.22404371584699453,504,108,31,365,486,18,0.21428571428571427,0.061507936507936505,0.7242063492063492,0.9642857142857143,0.03571428571428571
9635,347,260,87,292,55,0.7492795389048992,0.2507204610951009,0.8414985590778098,0.1585014409221902,191,19,60,112,185,6,0.09947643979057591,0.31413612565445026,0.5863874345549738,0.9685863874345549,0.031413612565445025
9636,1652,1589,63,1594,58,0.961864406779661,0.038135593220338986,0.9648910411622276,0.035108958837772396,191,19,60,112,185,6,0.09947643979057591,0.31413612565445026,0.5863874345549738,0.9685863874345549,0.031413612565445025
9637,362,254,108,315,47,0.7016574585635359,0.2983425414364641,0.8701657458563536,0.1298342541436464,191,19,60,112,185,6,0.09947643979057591,0.31413612565445026,0.5863874345549738,0.9685863874345549,0.031413612565445025
9638,910,813,97,733,177,0.8934065934065935,0.10659340659340659,0.8054945054945055,0.1945054945054945,112,41,50,21,111,1,0.36607142857142855,0.44642857142857145,0.1875,0.9910714285714286,0.008928571428571428
9639,212,163,49,141,71,0.7688679245283019,0.23113207547169812,0.6650943396226415,0.33490566037735847,288,1,217,70,277,11,0.003472222222222222,0.7534722222222222,0.24305555555555555,0.9618055555555556,0.03819444444444445
9640,490,391,99,392,98,0.7979591836734694,0.20204081632653062,0.8,0.2,383,42,84,257,362,21,0.10966057441253264,0.2193211488250653,0.6710182767624021,0.9451697127937336,0.05483028720626632
9641,384,336,48,315,69,0.875,0.125,0.8203125,0.1796875,176,4,41,131,125,51,0.022727272727272728,0.23295454545454544,0.7443181818181818,0.7102272727272727,0.2897727272727273
9642,361,249,112,316,45,0.6897506925207756,0.31024930747922436,0.8753462603878116,0.12465373961218837,191,19,60,112,185,6,0.09947643979057591,0.31413612565445026,0.5863874345549738,0.9685863874345549,0.031413612565445025
9643,320,272,48,266,54,0.85,0.15,0.83125,0.16875,161,21,58,82,158,3,0.13043478260869565,0.36024844720496896,0.5093167701863354,0.9813664596273292,0.018633540372670808
9644,306,228,78,258,48,0.7450980392156863,0.2549019607843137,0.8431372549019608,0.1568627450980392,212,23,64,125,205,7,0.10849056603773585,0.3018867924528302,0.589622641509434,0.9669811320754716,0.0330188679245283
9645,352,241,111,309,43,0.6846590909090909,0.3153409090909091,0.8778409090909091,0.12215909090909091,191,19,60,112,185,6,0.09947643979057591,0.31413612565445026,0.5863874345549738,0.9685863874345549,0.031413612565445025
9646,105,89,16,76,29,0.8476190476190476,0.1523809523809524,0.7238095238095238,0.2761904761904762,190,2,6,182,186,4,0.010526315789473684,0.031578947368421054,0.9578947368421052,0.9789473684210527,0.021052631578947368
9647,285,225,60,238,47,0.7894736842105263,0.21052631578947367,0.8350877192982457,0.1649122807017544,161,21,58,82,158,3,0.13043478260869565,0.36024844720496896,0.5093167701863354,0.9813664596273292,0.018633540372670808
9648,327,247,80,279,48,0.7553516819571865,0.24464831804281345,0.8532110091743119,0.14678899082568808,191,19,60,112,185,6,0.09947643979057591,0.31413612565445026,0.5863874345549738,0.9685863874345549,0.031413612565445025
9649,336,258,78,290,46,0.7678571428571429,0.23214285714285715,0.8630952380952381,0.13690476190476192,191,19,60,112,185,6,0.09947643979057591,0.31413612565445026,0.5863874345549738,0.9685863874345549,0.031413612565445025
9650,424,397,27,386,38,0.9363207547169812,0.06367924528301887,0.910377358490566,0.08962264150943396,1038,210,469,359,991,47,0.2023121387283237,0.45183044315992293,0.34585741811175336,0.9547206165703276,0.04527938342967245
9651,372,287,85,300,72,0.771505376344086,0.22849462365591397,0.8064516129032258,0.1935483870967742,189,19,64,106,182,7,0.10052910052910052,0.3386243386243386,0.5608465608465608,0.9629629629629629,0.037037037037037035
9652,182,133,49,115,67,0.7307692307692307,0.2692307692307692,0.6318681318681318,0.36813186813186816,135,3,94,38,130,5,0.022222222222222223,0.6962962962962963,0.2814814814814815,0.9629629629629629,0.037037037037037035
9653,987,812,175,795,192,0.8226950354609929,0.1773049645390071,0.8054711246200608,0.1945288753799392,149,43,79,27,148,1,0.28859060402684567,0.5302013422818792,0.18120805369127516,0.9932885906040269,0.006711409395973154
9654,312,228,84,264,48,0.7307692307692307,0.2692307692307692,0.8461538461538461,0.15384615384615385,212,23,64,125,205,7,0.10849056603773585,0.3018867924528302,0.589622641509434,0.9669811320754716,0.0330188679245283
9655,334,255,79,286,48,0.7634730538922155,0.23652694610778444,0.8562874251497006,0.1437125748502994,191,19,60,112,185,6,0.09947643979057591,0.31413612565445026,0.5863874345549738,0.9685863874345549,0.031413612565445025
9656,356,244,112,312,44,0.6853932584269663,0.3146067415730337,0.8764044943820225,0.12359550561797752,191,19,60,112,185,6,0.09947643979057591,0.31413612565445026,0.5863874345549738,0.9685863874345549,0.031413612565445025
9657,379,272,107,334,45,0.7176781002638523,0.28232189973614774,0.8812664907651715,0.11873350923482849,191,19,60,112,185,6,0.09947643979057591,0.31413612565445026,0.5863874345549738,0.9685863874345549,0.031413612565445025
9658,592,468,124,563,29,0.7905405405405406,0.20945945945945946,0.9510135135135135,0.048986486486486486,393,75,136,182,378,15,0.19083969465648856,0.3460559796437659,0.4631043256997455,0.9618320610687023,0.03816793893129771
9659,1691,1580,111,1640,51,0.9343583678296866,0.06564163217031342,0.9698403311649911,0.03015966883500887,191,19,60,112,185,6,0.09947643979057591,0.31413612565445026,0.5863874345549738,0.9685863874345549,0.031413612565445025
9660,343,252,91,293,50,0.7346938775510204,0.2653061224489796,0.8542274052478134,0.1457725947521866,191,19,60,112,185,6,0.09947643979057591,0.31413612565445026,0.5863874345549738,0.9685863874345549,0.031413612565445025
9661,344,238,106,295,49,0.6918604651162791,0.3081395348837209,0.8575581395348837,0.14244186046511628,221,23,67,131,214,7,0.10407239819004525,0.3031674208144796,0.5927601809954751,0.9683257918552036,0.03167420814479638
9662,279,223,56,233,46,0.7992831541218638,0.2007168458781362,0.8351254480286738,0.16487455197132617,161,21,58,82,158,3,0.13043478260869565,0.36024844720496896,0.5093167701863354,0.9813664596273292,0.018633540372670808
9663,327,245,82,281,46,0.7492354740061162,0.25076452599388377,0.8593272171253823,0.14067278287461774,191,19,60,112,185,6,0.09947643979057591,0.31413612565445026,0.5863874345549738,0.9685863874345549,0.031413612565445025
9664,214,179,35,147,67,0.8364485981308412,0.16355140186915887,0.6869158878504673,0.3130841121495327,122,33,43,46,119,3,0.27049180327868855,0.3524590163934426,0.3770491803278688,0.9754098360655737,0.02459016393442623
9665,147,135,12,115,32,0.9183673469387755,0.08163265306122448,0.782312925170068,0.21768707482993196,181,53,57,71,164,17,0.292817679558011,0.3149171270718232,0.39226519337016574,0.9060773480662984,0.09392265193370165
9666,144,131,13,116,28,0.9097222222222222,0.09027777777777778,0.8055555555555556,0.19444444444444445,162,46,58,58,149,13,0.2839506172839506,0.35802469135802467,0.35802469135802467,0.9197530864197531,0.08024691358024691
9667,326,221,105,279,47,0.6779141104294478,0.3220858895705521,0.8558282208588958,0.1441717791411043,212,23,64,125,205,7,0.10849056603773585,0.3018867924528302,0.589622641509434,0.9669811320754716,0.0330188679245283
9668,164,139,25,128,36,0.8475609756097561,0.1524390243902439,0.7804878048780488,0.21951219512195122,165,24,40,101,152,13,0.14545454545454545,0.24242424242424243,0.6121212121212121,0.9212121212121213,0.07878787878787878
9669,346,240,106,294,52,0.6936416184971098,0.3063583815028902,0.8497109826589595,0.15028901734104047,221,23,67,131,214,7,0.10407239819004525,0.3031674208144796,0.5927601809954751,0.9683257918552036,0.03167420814479638
9670,355,250,105,305,50,0.704225352112676,0.29577464788732394,0.8591549295774648,0.14084507042253522,191,19,60,112,185,6,0.09947643979057591,0.31413612565445026,0.5863874345549738,0.9685863874345549,0.031413612565445025
9671,363,254,109,311,52,0.699724517906336,0.3002754820936639,0.8567493112947658,0.14325068870523416,191,19,60,112,185,6,0.09947643979057591,0.31413612565445026,0.5863874345549738,0.9685863874345549,0.031413612565445025
9672,1290,1179,111,1242,48,0.913953488372093,0.08604651162790698,0.9627906976744186,0.037209302325581395,191,19,60,112,185,6,0.09947643979057591,0.31413612565445026,0.5863874345549738,0.9685863874345549,0.031413612565445025
9673,121,110,11,89,32,0.9090909090909091,0.09090909090909091,0.7355371900826446,0.2644628099173554,278,123,74,81,259,19,0.44244604316546765,0.26618705035971224,0.29136690647482016,0.9316546762589928,0.0683453237410072
9674,361,246,115,316,45,0.6814404432132964,0.3185595567867036,0.8753462603878116,0.12465373961218837,191,19,60,112,185,6,0.09947643979057591,0.31413612565445026,0.5863874345549738,0.9685863874345549,0.031413612565445025
9675,333,270,63,260,73,0.8108108108108109,0.1891891891891892,0.7807807807807807,0.21921921921921922,292,75,74,143,277,15,0.2568493150684932,0.2534246575342466,0.4897260273972603,0.9486301369863014,0.05136986301369863
9676,376,304,72,326,50,0.8085106382978723,0.19148936170212766,0.8670212765957447,0.13297872340425532,193,23,56,114,185,8,0.11917098445595854,0.29015544041450775,0.5906735751295337,0.9585492227979274,0.04145077720207254
9677,352,243,109,309,43,0.6903409090909091,0.3096590909090909,0.8778409090909091,0.12215909090909091,191,19,60,112,185,6,0.09947643979057591,0.31413612565445026,0.5863874345549738,0.9685863874345549,0.031413612565445025
9678,350,244,106,305,45,0.6971428571428572,0.3028571428571429,0.8714285714285714,0.12857142857142856,191,19,60,112,185,6,0.09947643979057591,0.31413612565445026,0.5863874345549738,0.9685863874345549,0.031413612565445025
9679,312,246,66,265,47,0.7884615384615384,0.21153846153846154,0.8493589743589743,0.15064102564102563,191,19,60,112,185,6,0.09947643979057591,0.31413612565445026,0.5863874345549738,0.9685863874345549,0.031413612565445025
9680,1077,872,205,793,284,0.8096564531104921,0.1903435468895079,0.7363045496750232,0.26369545032497677,89,17,50,22,89,0,0.19101123595505617,0.5617977528089888,0.24719101123595505,1.0,0.0
9681,331,224,107,280,51,0.676737160120846,0.32326283987915405,0.8459214501510574,0.1540785498489426,212,23,64,125,205,7,0.10849056603773585,0.3018867924528302,0.589622641509434,0.9669811320754716,0.0330188679245283
9682,36,36,0,19,17,1.0,0.0,0.5277777777777778,0.4722222222222222,7,0,0,7,6,1,0.0,0.0,1.0,0.8571428571428571,0.14285714285714285
9683,290,249,41,243,47,0.8586206896551725,0.1413793103448276,0.8379310344827586,0.16206896551724137,191,19,60,112,185,6,0.09947643979057591,0.31413612565445026,0.5863874345549738,0.9685863874345549,0.031413612565445025
9684,357,246,111,307,50,0.6890756302521008,0.31092436974789917,0.8599439775910365,0.1400560224089636,191,19,60,112,185,6,0.09947643979057591,0.31413612565445026,0.5863874345549738,0.9685863874345549,0.031413612565445025
9685,157,132,25,121,36,0.8407643312101911,0.1592356687898089,0.7707006369426752,0.22929936305732485,165,26,38,101,152,13,0.15757575757575756,0.23030303030303031,0.6121212121212121,0.9212121212121213,0.07878787878787878
9686,178,153,25,130,48,0.8595505617977528,0.1404494382022472,0.7303370786516854,0.2696629213483146,167,23,40,104,153,14,0.1377245508982036,0.23952095808383234,0.6227544910179641,0.9161676646706587,0.08383233532934131
9687,336,231,105,283,53,0.6875,0.3125,0.8422619047619048,0.15773809523809523,212,23,64,125,205,7,0.10849056603773585,0.3018867924528302,0.589622641509434,0.9669811320754716,0.0330188679245283
9688,349,240,109,306,43,0.6876790830945558,0.3123209169054441,0.8767908309455588,0.12320916905444126,191,19,60,112,185,6,0.09947643979057591,0.31413612565445026,0.5863874345549738,0.9685863874345549,0.031413612565445025
9689,284,246,38,230,54,0.8661971830985915,0.13380281690140844,0.8098591549295775,0.19014084507042253,221,23,67,131,214,7,0.10407239819004525,0.3031674208144796,0.5927601809954751,0.9683257918552036,0.03167420814479638
9690,387,275,112,339,48,0.710594315245478,0.28940568475452194,0.875968992248062,0.12403100775193798,191,19,60,112,185,6,0.09947643979057591,0.31413612565445026,0.5863874345549738,0.9685863874345549,0.031413612565445025
9691,346,241,105,299,47,0.6965317919075145,0.30346820809248554,0.8641618497109826,0.13583815028901733,221,23,67,131,214,7,0.10407239819004525,0.3031674208144796,0.5927601809954751,0.9683257918552036,0.03167420814479638
9692,323,232,91,275,48,0.718266253869969,0.28173374613003094,0.8513931888544891,0.14860681114551083,161,21,58,82,158,3,0.13043478260869565,0.36024844720496896,0.5093167701863354,0.9813664596273292,0.018633540372670808
9693,340,247,93,296,44,0.7264705882352941,0.2735294117647059,0.8705882352941177,0.12941176470588237,161,21,58,82,158,3,0.13043478260869565,0.36024844720496896,0.5093167701863354,0.9813664596273292,0.018633540372670808
9694,342,242,100,292,50,0.7076023391812866,0.29239766081871343,0.8538011695906432,0.14619883040935672,221,23,67,131,214,7,0.10407239819004525,0.3031674208144796,0.5927601809954751,0.9683257918552036,0.03167420814479638
9695,304,250,54,256,48,0.8223684210526315,0.17763157894736842,0.8421052631578947,0.15789473684210525,191,19,60,112,185,6,0.09947643979057591,0.31413612565445026,0.5863874345549738,0.9685863874345549,0.031413612565445025
9696,367,309,58,318,49,0.8419618528610354,0.15803814713896458,0.8664850136239782,0.1335149863760218,191,19,60,112,185,6,0.09947643979057591,0.31413612565445026,0.5863874345549738,0.9685863874345549,0.031413612565445025
9697,313,242,71,269,44,0.7731629392971247,0.2268370607028754,0.8594249201277955,0.14057507987220447,191,19,60,112,185,6,0.09947643979057591,0.31413612565445026,0.5863874345549738,0.9685863874345549,0.031413612565445025
9698,402,333,69,305,97,0.8283582089552238,0.17164179104477612,0.7587064676616916,0.24129353233830847,122,18,78,26,121,1,0.14754098360655737,0.639344262295082,0.21311475409836064,0.9918032786885246,0.00819672131147541
9699,288,247,41,239,49,0.8576388888888888,0.1423611111111111,0.8298611111111112,0.1701388888888889,191,19,60,112,185,6,0.09947643979057591,0.31413612565445026,0.5863874345549738,0.9685863874345549,0.031413612565445025
9700,169,145,24,127,42,0.8579881656804734,0.14201183431952663,0.7514792899408284,0.2485207100591716,357,33,56,268,342,15,0.09243697478991597,0.1568627450980392,0.7507002801120448,0.957983193277311,0.04201680672268908
9701,342,235,107,295,47,0.6871345029239766,0.3128654970760234,0.8625730994152047,0.13742690058479531,221,23,67,131,214,7,0.10407239819004525,0.3031674208144796,0.5927601809954751,0.9683257918552036,0.03167420814479638
9702,340,237,103,288,52,0.6970588235294117,0.3029411764705882,0.8470588235294118,0.15294117647058825,221,23,67,131,214,7,0.10407239819004525,0.3031674208144796,0.5927601809954751,0.9683257918552036,0.03167420814479638
9703,315,251,64,268,47,0.7968253968253968,0.20317460317460317,0.8507936507936508,0.1492063492063492,191,19,60,112,185,6,0.09947643979057591,0.31413612565445026,0.5863874345549738,0.9685863874345549,0.031413612565445025
9704,375,314,61,293,82,0.8373333333333334,0.16266666666666665,0.7813333333333333,0.21866666666666668,424,69,189,166,385,39,0.16273584905660377,0.44575471698113206,0.3915094339622642,0.9080188679245284,0.09198113207547169
9705,290,227,63,242,48,0.7827586206896552,0.21724137931034482,0.8344827586206897,0.16551724137931034,161,21,58,82,158,3,0.13043478260869565,0.36024844720496896,0.5093167701863354,0.9813664596273292,0.018633540372670808
9706,397,288,109,353,44,0.72544080604534,0.27455919395465994,0.889168765743073,0.11083123425692695,111,16,19,76,109,2,0.14414414414414414,0.17117117117117117,0.6846846846846847,0.9819819819819819,0.018018018018018018
9707,382,279,103,329,53,0.7303664921465969,0.2696335078534031,0.8612565445026178,0.1387434554973822,221,23,67,131,214,7,0.10407239819004525,0.3031674208144796,0.5927601809954751,0.9683257918552036,0.03167420814479638
9708,194,177,17,148,46,0.9123711340206185,0.08762886597938144,0.7628865979381443,0.23711340206185566,289,115,78,96,272,17,0.39792387543252594,0.2698961937716263,0.33217993079584773,0.9411764705882353,0.058823529411764705
9709,160,134,26,125,35,0.8375,0.1625,0.78125,0.21875,186,30,32,124,176,10,0.16129032258064516,0.17204301075268819,0.6666666666666666,0.946236559139785,0.053763440860215055
9710,148,127,21,107,41,0.8581081081081081,0.14189189189189189,0.722972972972973,0.27702702702702703,287,19,53,215,273,14,0.06620209059233449,0.18466898954703834,0.7491289198606271,0.9512195121951219,0.04878048780487805
9711,367,254,113,318,49,0.6920980926430518,0.3079019073569482,0.8664850136239782,0.1335149863760218,191,19,60,112,185,6,0.09947643979057591,0.31413612565445026,0.5863874345549738,0.9685863874345549,0.031413612565445025
9712,151,126,25,110,41,0.8344370860927153,0.16556291390728478,0.7284768211920529,0.271523178807947,350,120,121,109,328,22,0.34285714285714286,0.3457142857142857,0.31142857142857144,0.9371428571428572,0.06285714285714286
9713,344,243,101,299,45,0.7063953488372093,0.2936046511627907,0.8691860465116279,0.1308139534883721,191,19,60,112,185,6,0.09947643979057591,0.31413612565445026,0.5863874345549738,0.9685863874345549,0.031413612565445025
9714,460,393,67,338,122,0.8543478260869565,0.14565217391304347,0.7347826086956522,0.26521739130434785,163,46,55,62,159,4,0.2822085889570552,0.3374233128834356,0.3803680981595092,0.9754601226993865,0.024539877300613498
9715,323,271,52,275,48,0.8390092879256966,0.1609907120743034,0.8513931888544891,0.14860681114551083,191,19,60,112,185,6,0.09947643979057591,0.31413612565445026,0.5863874345549738,0.9685863874345549,0.031413612565445025
9716,346,241,105,292,54,0.6965317919075145,0.30346820809248554,0.8439306358381503,0.15606936416184972,221,23,67,131,214,7,0.10407239819004525,0.3031674208144796,0.5927601809954751,0.9683257918552036,0.03167420814479638
9717,280,230,50,236,44,0.8214285714285714,0.17857142857142858,0.8428571428571429,0.15714285714285714,193,23,56,114,185,8,0.11917098445595854,0.29015544041450775,0.5906735751295337,0.9585492227979274,0.04145077720207254
9718,316,250,66,267,49,0.7911392405063291,0.2088607594936709,0.8449367088607594,0.1550632911392405,191,19,60,112,185,6,0.09947643979057591,0.31413612565445026,0.5863874345549738,0.9685863874345549,0.031413612565445025
9719,355,246,109,309,46,0.6929577464788732,0.30704225352112674,0.8704225352112676,0.1295774647887324,191,19,60,112,185,6,0.09947643979057591,0.31413612565445026,0.5863874345549738,0.9685863874345549,0.031413612565445025
9720,440,297,143,282,158,0.675,0.325,0.6409090909090909,0.35909090909090907,150,5,6,139,137,13,0.03333333333333333,0.04,0.9266666666666666,0.9133333333333333,0.08666666666666667
9721,412,340,72,343,69,0.8252427184466019,0.17475728155339806,0.8325242718446602,0.16747572815533981,151,4,45,102,137,14,0.026490066225165563,0.2980132450331126,0.6754966887417219,0.9072847682119205,0.09271523178807947
9722,207,176,31,155,52,0.8502415458937198,0.1497584541062802,0.748792270531401,0.25120772946859904,143,40,46,57,138,5,0.27972027972027974,0.32167832167832167,0.3986013986013986,0.965034965034965,0.03496503496503497
9723,291,251,40,244,47,0.8625429553264605,0.13745704467353953,0.8384879725085911,0.16151202749140894,191,19,60,112,185,6,0.09947643979057591,0.31413612565445026,0.5863874345549738,0.9685863874345549,0.031413612565445025
9724,295,240,55,230,65,0.8135593220338984,0.1864406779661017,0.7796610169491526,0.22033898305084745,113,34,53,26,112,1,0.3008849557522124,0.4690265486725664,0.23008849557522124,0.9911504424778761,0.008849557522123894
9725,277,238,39,227,50,0.8592057761732852,0.1407942238267148,0.8194945848375451,0.18050541516245489,221,23,67,131,214,7,0.10407239819004525,0.3031674208144796,0.5927601809954751,0.9683257918552036,0.03167420814479638
9726,316,251,65,264,52,0.7943037974683544,0.20569620253164558,0.8354430379746836,0.16455696202531644,191,19,60,112,185,6,0.09947643979057591,0.31413612565445026,0.5863874345549738,0.9685863874345549,0.031413612565445025
9727,329,256,73,275,54,0.7781155015197568,0.22188449848024316,0.8358662613981763,0.1641337386018237,191,19,60,112,185,6,0.09947643979057591,0.31413612565445026,0.5863874345549738,0.9685863874345549,0.031413612565445025
9728,380,276,104,321,59,0.7263157894736842,0.2736842105263158,0.8447368421052631,0.15526315789473685,221,23,67,131,214,7,0.10407239819004525,0.3031674208144796,0.5927601809954751,0.9683257918552036,0.03167420814479638
9729,0,0,0,0,0,0.0,0.0,0.0,0.0,0,0,0,0,0,0,0.0,0.0,0.0,0.0,0.0
9730,368,257,111,320,48,0.6983695652173914,0.3016304347826087,0.8695652173913043,0.13043478260869565,191,19,60,112,185,6,0.09947643979057591,0.31413612565445026,0.5863874345549738,0.9685863874345549,0.031413612565445025
9731,413,399,14,315,98,0.9661016949152542,0.03389830508474576,0.7627118644067796,0.23728813559322035,6,0,0,6,3,3,0.0,0.0,1.0,0.5,0.5
9732,1253,1018,235,930,323,0.8124501197126895,0.18754988028731046,0.7422186751795691,0.257781324820431,139,36,44,59,135,4,0.2589928057553957,0.31654676258992803,0.4244604316546763,0.9712230215827338,0.02877697841726619
9733,152,125,27,118,34,0.8223684210526315,0.17763157894736842,0.7763157894736842,0.2236842105263158,149,17,33,99,142,7,0.11409395973154363,0.2214765100671141,0.6644295302013423,0.9530201342281879,0.04697986577181208
9734,478,377,101,389,89,0.7887029288702929,0.2112970711297071,0.8138075313807531,0.18619246861924685,380,42,84,254,363,17,0.11052631578947368,0.22105263157894736,0.6684210526315789,0.9552631578947368,0.04473684210526316
9735,359,247,112,314,45,0.6880222841225627,0.31197771587743733,0.8746518105849582,0.12534818941504178,191,19,60,112,185,6,0.09947643979057591,0.31413612565445026,0.5863874345549738,0.9685863874345549,0.031413612565445025
9736,360,250,110,311,49,0.6944444444444444,0.3055555555555556,0.8638888888888889,0.1361111111111111,191,19,60,112,185,6,0.09947643979057591,0.31413612565445026,0.5863874345549738,0.9685863874345549,0.031413612565445025
9737,361,248,113,315,46,0.6869806094182825,0.31301939058171746,0.8725761772853186,0.12742382271468145,191,19,60,112,185,6,0.09947643979057591,0.31413612565445026,0.5863874345549738,0.9685863874345549,0.031413612565445025
9738,366,301,65,276,90,0.8224043715846995,0.17759562841530055,0.7540983606557377,0.2459016393442623,107,1,29,77,76,31,0.009345794392523364,0.27102803738317754,0.719626168224299,0.7102803738317757,0.2897196261682243
9739,270,234,36,224,46,0.8666666666666667,0.13333333333333333,0.8296296296296296,0.17037037037037037,193,23,56,114,185,8,0.11917098445595854,0.29015544041450775,0.5906735751295337,0.9585492227979274,0.04145077720207254
9740,271,222,49,224,47,0.8191881918819188,0.18081180811808117,0.8265682656826568,0.17343173431734318,212,23,64,125,205,7,0.10849056603773585,0.3018867924528302,0.589622641509434,0.9669811320754716,0.0330188679245283
9741,885,721,164,700,185,0.8146892655367232,0.18531073446327684,0.7909604519774012,0.20903954802259886,95,17,52,26,94,1,0.17894736842105263,0.5473684210526316,0.2736842105263158,0.9894736842105263,0.010526315789473684
9742,356,247,109,308,48,0.6938202247191011,0.3061797752808989,0.8651685393258427,0.1348314606741573,191,19,60,112,185,6,0.09947643979057591,0.31413612565445026,0.5863874345549738,0.9685863874345549,0.031413612565445025
9743,365,257,108,313,52,0.7041095890410959,0.2958904109589041,0.8575342465753425,0.14246575342465753,191,19,60,112,185,6,0.09947643979057591,0.31413612565445026,0.5863874345549738,0.9685863874345549,0.031413612565445025
9744,0,0,0,0,0,0.0,0.0,0.0,0.0,0,0,0,0,0,0,0.0,0.0,0.0,0.0,0.0
9745,393,323,70,294,99,0.821882951653944,0.178117048346056,0.7480916030534351,0.25190839694656486,86,15,50,21,85,1,0.1744186046511628,0.5813953488372093,0.2441860465116279,0.9883720930232558,0.011627906976744186
9746,741,598,143,569,172,0.8070175438596491,0.19298245614035087,0.7678812415654521,0.2321187584345479,401,82,165,154,387,14,0.20448877805486285,0.4114713216957606,0.38403990024937656,0.9650872817955112,0.034912718204488775
9747,307,224,83,258,49,0.7296416938110749,0.2703583061889251,0.8403908794788274,0.15960912052117263,161,21,58,82,158,3,0.13043478260869565,0.36024844720496896,0.5093167701863354,0.9813664596273292,0.018633540372670808
9748,161,137,24,126,35,0.8509316770186336,0.14906832298136646,0.782608695652174,0.21739130434782608,412,28,39,345,396,16,0.06796116504854369,0.09466019417475728,0.837378640776699,0.9611650485436893,0.038834951456310676
9749,5632,5615,17,4137,1495,0.9969815340909091,0.003018465909090909,0.7345525568181818,0.2654474431818182,401,116,32,253,383,18,0.2892768079800499,0.0798004987531172,0.6309226932668329,0.9551122194513716,0.04488778054862843
9750,163,139,24,119,44,0.852760736196319,0.147239263803681,0.7300613496932515,0.26993865030674846,381,99,25,257,363,18,0.25984251968503935,0.06561679790026247,0.6745406824146981,0.952755905511811,0.047244094488188976
9751,361,252,109,311,50,0.6980609418282548,0.30193905817174516,0.8614958448753463,0.13850415512465375,191,19,60,112,185,6,0.09947643979057591,0.31413612565445026,0.5863874345549738,0.9685863874345549,0.031413612565445025
9752,389,280,109,338,51,0.7197943444730077,0.2802056555269923,0.8688946015424165,0.13110539845758354,191,19,60,112,185,6,0.09947643979057591,0.31413612565445026,0.5863874345549738,0.9685863874345549,0.031413612565445025
9753,370,259,111,319,51,0.7,0.3,0.8621621621621621,0.13783783783783785,191,19,60,112,185,6,0.09947643979057591,0.31413612565445026,0.5863874345549738,0.9685863874345549,0.031413612565445025
9754,304,234,70,251,53,0.7697368421052632,0.23026315789473684,0.8256578947368421,0.17434210526315788,212,23,64,125,205,7,0.10849056603773585,0.3018867924528302,0.589622641509434,0.9669811320754716,0.0330188679245283
9755,4528,3647,881,3970,558,0.8054328621908127,0.19456713780918727,0.8767667844522968,0.12323321554770318,1592,184,409,999,1338,254,0.11557788944723618,0.25690954773869346,0.6275125628140703,0.8404522613065326,0.15954773869346733
9756,302,243,59,258,44,0.804635761589404,0.19536423841059603,0.8543046357615894,0.1456953642384106,191,19,60,112,185,6,0.09947643979057591,0.31413612565445026,0.5863874345549738,0.9685863874345549,0.031413612565445025
9757,335,252,83,285,50,0.7522388059701492,0.24776119402985075,0.8507462686567164,0.14925373134328357,191,19,60,112,185,6,0.09947643979057591,0.31413612565445026,0.5863874345549738,0.9685863874345549,0.031413612565445025
9758,367,254,113,318,49,0.6920980926430518,0.3079019073569482,0.8664850136239782,0.1335149863760218,191,19,60,112,185,6,0.09947643979057591,0.31413612565445026,0.5863874345549738,0.9685863874345549,0.031413612565445025
9759,991,843,148,781,210,0.8506559031281534,0.14934409687184663,0.7880928355196771,0.2119071644803229,134,43,64,27,134,0,0.3208955223880597,0.47761194029850745,0.20149253731343283,1.0,0.0
9760,360,247,113,310,50,0.6861111111111111,0.3138888888888889,0.8611111111111112,0.1388888888888889,191,19,60,112,185,6,0.09947643979057591,0.31413612565445026,0.5863874345549738,0.9685863874345549,0.031413612565445025
9761,218,167,51,147,71,0.7660550458715596,0.23394495412844038,0.6743119266055045,0.3256880733944954,320,0,266,54,303,17,0.0,0.83125,0.16875,0.946875,0.053125
9762,373,263,110,321,52,0.7050938337801609,0.2949061662198391,0.8605898123324397,0.13941018766756033,191,19,60,112,185,6,0.09947643979057591,0.31413612565445026,0.5863874345549738,0.9685863874345549,0.031413612565445025
9763,351,240,111,308,43,0.6837606837606838,0.3162393162393162,0.8774928774928775,0.1225071225071225,191,19,60,112,185,6,0.09947643979057591,0.31413612565445026,0.5863874345549738,0.9685863874345549,0.031413612565445025
9764,494,399,95,369,125,0.8076923076923077,0.19230769230769232,0.7469635627530364,0.25303643724696356,321,18,186,117,158,163,0.056074766355140186,0.5794392523364486,0.3644859813084112,0.49221183800623053,0.5077881619937694
9765,173,147,26,130,43,0.8497109826589595,0.15028901734104047,0.7514450867052023,0.24855491329479767,464,40,62,362,445,19,0.08620689655172414,0.1336206896551724,0.7801724137931034,0.959051724137931,0.040948275862068964
9766,361,251,110,307,54,0.6952908587257618,0.3047091412742382,0.850415512465374,0.14958448753462603,191,19,60,112,185,6,0.09947643979057591,0.31413612565445026,0.5863874345549738,0.9685863874345549,0.031413612565445025
9767,315,253,62,265,50,0.8031746031746032,0.19682539682539682,0.8412698412698413,0.15873015873015872,191,19,60,112,185,6,0.09947643979057591,0.31413612565445026,0.5863874345549738,0.9685863874345549,0.031413612565445025
9768,351,295,56,296,55,0.8404558404558404,0.15954415954415954,0.8433048433048433,0.15669515669515668,191,19,60,112,185,6,0.09947643979057591,0.31413612565445026,0.5863874345549738,0.9685863874345549,0.031413612565445025
9769,394,287,107,342,52,0.7284263959390863,0.2715736040609137,0.868020304568528,0.1319796954314721,191,19,60,112,185,6,0.09947643979057591,0.31413612565445026,0.5863874345549738,0.9685863874345549,0.031413612565445025
9770,638,536,102,581,57,0.8401253918495298,0.15987460815047022,0.9106583072100314,0.08934169278996865,1235,46,548,641,1187,48,0.03724696356275304,0.4437246963562753,0.5190283400809717,0.9611336032388664,0.038866396761133605
9771,307,234,73,260,47,0.762214983713355,0.23778501628664495,0.8469055374592834,0.15309446254071662,221,23,67,131,214,7,0.10407239819004525,0.3031674208144796,0.5927601809954751,0.9683257918552036,0.03167420814479638
9772,36,36,0,19,17,1.0,0.0,0.5277777777777778,0.4722222222222222,7,0,0,7,6,1,0.0,0.0,1.0,0.8571428571428571,0.14285714285714285
9773,973,801,172,780,193,0.8232271325796505,0.17677286742034942,0.8016443987667009,0.19835560123329907,149,43,80,26,148,1,0.28859060402684567,0.5369127516778524,0.174496644295302,0.9932885906040269,0.006711409395973154
9774,323,233,90,273,50,0.7213622291021672,0.2786377708978328,0.8452012383900929,0.15479876160990713,161,21,58,82,158,3,0.13043478260869565,0.36024844720496896,0.5093167701863354,0.9813664596273292,0.018633540372670808
9775,359,250,109,309,50,0.6963788300835655,0.30362116991643456,0.8607242339832869,0.1392757660167131,191,19,60,112,185,6,0.09947643979057591,0.31413612565445026,0.5863874345549738,0.9685863874345549,0.031413612565445025
9776,293,244,49,247,46,0.8327645051194539,0.16723549488054607,0.8430034129692833,0.15699658703071673,191,19,60,112,185,6,0.09947643979057591,0.31413612565445026,0.5863874345549738,0.9685863874345549,0.031413612565445025
9777,324,230,94,275,49,0.7098765432098766,0.29012345679012347,0.8487654320987654,0.15123456790123457,161,21,58,82,158,3,0.13043478260869565,0.36024844720496896,0.5093167701863354,0.9813664596273292,0.018633540372670808
9778,416,312,104,370,46,0.75,0.25,0.8894230769230769,0.11057692307692307,191,19,60,112,185,6,0.09947643979057591,0.31413612565445026,0.5863874345549738,0.9685863874345549,0.031413612565445025
9779,154,130,24,123,31,0.8441558441558441,0.15584415584415584,0.7987012987012987,0.2012987012987013,356,34,57,265,343,13,0.09550561797752809,0.1601123595505618,0.7443820224719101,0.9634831460674157,0.03651685393258427
9780,356,244,112,312,44,0.6853932584269663,0.3146067415730337,0.8764044943820225,0.12359550561797752,191,19,60,112,185,6,0.09947643979057591,0.31413612565445026,0.5863874345549738,0.9685863874345549,0.031413612565445025
9781,203,176,27,149,54,0.8669950738916257,0.1330049261083744,0.7339901477832512,0.2660098522167488,153,41,45,67,148,5,0.2679738562091503,0.29411764705882354,0.43790849673202614,0.9673202614379085,0.032679738562091505
9782,369,258,111,317,52,0.6991869918699187,0.3008130081300813,0.8590785907859079,0.14092140921409213,191,19,60,112,185,6,0.09947643979057591,0.31413612565445026,0.5863874345549738,0.9685863874345549,0.031413612565445025
9783,440,373,67,316,124,0.8477272727272728,0.15227272727272728,0.7181818181818181,0.2818181818181818,161,42,57,62,158,3,0.2608695652173913,0.35403726708074534,0.38509316770186336,0.9813664596273292,0.018633540372670808
9784,1421,1400,21,1037,384,0.9852216748768473,0.014778325123152709,0.7297677691766362,0.27023223082336384,164,2,10,152,150,14,0.012195121951219513,0.06097560975609756,0.926829268292683,0.9146341463414634,0.08536585365853659
9785,134,113,21,105,29,0.8432835820895522,0.15671641791044777,0.7835820895522388,0.21641791044776118,206,85,14,107,200,6,0.41262135922330095,0.06796116504854369,0.5194174757281553,0.970873786407767,0.02912621359223301
9786,336,232,104,287,49,0.6904761904761905,0.30952380952380953,0.8541666666666666,0.14583333333333334,221,23,67,131,214,7,0.10407239819004525,0.3031674208144796,0.5927601809954751,0.9683257918552036,0.03167420814479638
9787,360,251,109,310,50,0.6972222222222222,0.30277777777777776,0.8611111111111112,0.1388888888888889,212,23,64,125,205,7,0.10849056603773585,0.3018867924528302,0.589622641509434,0.9669811320754716,0.0330188679245283
9788,338,249,89,287,51,0.7366863905325444,0.26331360946745563,0.849112426035503,0.15088757396449703,161,21,58,82,158,3,0.13043478260869565,0.36024844720496896,0.5093167701863354,0.9813664596273292,0.018633540372670808
9789,334,273,61,280,54,0.8173652694610778,0.18263473053892215,0.8383233532934131,0.16167664670658682,212,23,64,125,205,7,0.10849056603773585,0.3018867924528302,0.589622641509434,0.9669811320754716,0.0330188679245283
9790,350,239,111,307,43,0.6828571428571428,0.3171428571428571,0.8771428571428571,0.12285714285714286,191,19,60,112,185,6,0.09947643979057591,0.31413612565445026,0.5863874345549738,0.9685863874345549,0.031413612565445025
9791,205,169,36,156,49,0.824390243902439,0.17560975609756097,0.7609756097560976,0.23902439024390243,46,3,8,35,43,3,0.06521739130434782,0.17391304347826086,0.7608695652173914,0.9347826086956522,0.06521739130434782
9792,36,36,0,19,17,1.0,0.0,0.5277777777777778,0.4722222222222222,7,0,0,7,6,1,0.0,0.0,1.0,0.8571428571428571,0.14285714285714285
9793,284,245,39,230,54,0.8626760563380281,0.13732394366197184,0.8098591549295775,0.19014084507042253,221,23,67,131,214,7,0.10407239819004525,0.3031674208144796,0.5927601809954751,0.9683257918552036,0.03167420814479638
9794,3553,2919,634,2856,697,0.8215592457078525,0.17844075429214748,0.8038277511961722,0.19617224880382775,1753,72,302,1379,1413,340,0.04107244723331432,0.17227609811751282,0.7866514546491729,0.8060467769537935,0.1939532230462065
9795,367,254,113,319,48,0.6920980926430518,0.3079019073569482,0.8692098092643051,0.1307901907356948,191,19,60,112,185,6,0.09947643979057591,0.31413612565445026,0.5863874345549738,0.9685863874345549,0.031413612565445025
9796,350,304,46,301,49,0.8685714285714285,0.13142857142857142,0.86,0.14,191,19,60,112,185,6,0.09947643979057591,0.31413612565445026,0.5863874345549738,0.9685863874345549,0.031413612565445025
9797,36,36,0,19,17,1.0,0.0,0.5277777777777778,0.4722222222222222,7,0,0,7,6,1,0.0,0.0,1.0,0.8571428571428571,0.14285714285714285
9798,4341,3269,1072,2451,1890,0.7530522920985948,0.24694770790140522,0.5646164478230823,0.43538355217691777,1472,44,304,1124,1359,113,0.029891304347826088,0.20652173913043478,0.7635869565217391,0.923233695652174,0.07676630434782608
9799,562,462,100,462,100,0.8220640569395018,0.17793594306049823,0.8220640569395018,0.17793594306049823,129,17,83,29,128,1,0.13178294573643412,0.6434108527131783,0.2248062015503876,0.9922480620155039,0.007751937984496124
9800,1298,1286,12,1287,11,0.9907550077041603,0.009244992295839754,0.9915254237288136,0.00847457627118644,399,3,92,304,241,158,0.007518796992481203,0.23057644110275688,0.7619047619047619,0.6040100250626567,0.39598997493734334
9801,303,248,55,256,47,0.8184818481848185,0.18151815181518152,0.8448844884488449,0.1551155115511551,191,19,60,112,185,6,0.09947643979057591,0.31413612565445026,0.5863874345549738,0.9685863874345549,0.031413612565445025
9802,352,241,111,308,44,0.6846590909090909,0.3153409090909091,0.875,0.125,191,19,60,112,185,6,0.09947643979057591,0.31413612565445026,0.5863874345549738,0.9685863874345549,0.031413612565445025
9803,316,224,92,271,45,0.7088607594936709,0.2911392405063291,0.8575949367088608,0.14240506329113925,161,21,58,82,158,3,0.13043478260869565,0.36024844720496896,0.5093167701863354,0.9813664596273292,0.018633540372670808
9804,1425,1404,21,1038,387,0.9852631578947368,0.014736842105263158,0.728421052631579,0.27157894736842103,166,1,11,154,151,15,0.006024096385542169,0.06626506024096386,0.927710843373494,0.9096385542168675,0.09036144578313253
9805,8912,7168,1744,6404,2508,0.8043087971274686,0.19569120287253142,0.7185816876122083,0.28141831238779175,4233,219,871,3143,3434,799,0.0517363571934798,0.20576423340420505,0.7424994094023152,0.8112449799196787,0.18875502008032127
9806,152,130,22,121,31,0.8552631578947368,0.14473684210526316,0.7960526315789473,0.20394736842105263,449,24,40,385,426,23,0.053452115812917596,0.08908685968819599,0.8574610244988864,0.9487750556792873,0.051224944320712694
9807,945,773,172,764,181,0.817989417989418,0.182010582010582,0.8084656084656084,0.19153439153439153,119,42,49,28,118,1,0.35294117647058826,0.4117647058823529,0.23529411764705882,0.9915966386554622,0.008403361344537815
9808,876,756,120,766,110,0.863013698630137,0.136986301369863,0.8744292237442922,0.12557077625570776,454,132,291,31,452,2,0.2907488986784141,0.6409691629955947,0.06828193832599119,0.9955947136563876,0.004405286343612335
9809,364,253,111,312,52,0.695054945054945,0.30494505494505497,0.8571428571428571,0.14285714285714285,191,19,60,112,185,6,0.09947643979057591,0.31413612565445026,0.5863874345549738,0.9685863874345549,0.031413612565445025
9810,8563,5751,2812,4556,4007,0.6716104169099615,0.3283895830900385,0.532056522246876,0.4679434777531239,2750,21,541,2188,2565,185,0.0076363636363636364,0.19672727272727272,0.7956363636363636,0.9327272727272727,0.06727272727272728
9811,163,144,19,115,48,0.8834355828220859,0.1165644171779141,0.7055214723926381,0.294478527607362,353,127,141,85,333,20,0.3597733711048159,0.39943342776203966,0.24079320113314448,0.943342776203966,0.056657223796033995
9812,376,266,110,319,57,0.7074468085106383,0.2925531914893617,0.848404255319149,0.15159574468085107,191,19,60,112,185,6,0.09947643979057591,0.31413612565445026,0.5863874345549738,0.9685863874345549,0.031413612565445025
9813,336,232,104,284,52,0.6904761904761905,0.30952380952380953,0.8452380952380952,0.15476190476190477,221,23,67,131,214,7,0.10407239819004525,0.3031674208144796,0.5927601809954751,0.9683257918552036,0.03167420814479638
9814,312,256,56,260,52,0.8205128205128205,0.1794871794871795,0.8333333333333334,0.16666666666666666,191,19,60,112,185,6,0.09947643979057591,0.31413612565445026,0.5863874345549738,0.9685863874345549,0.031413612565445025
9815,160,139,21,119,41,0.86875,0.13125,0.74375,0.25625,289,124,16,149,276,13,0.4290657439446367,0.05536332179930796,0.5155709342560554,0.9550173010380623,0.04498269896193772
9816,152,126,26,112,40,0.8289473684210527,0.17105263157894737,0.7368421052631579,0.2631578947368421,396,110,129,157,353,43,0.2777777777777778,0.32575757575757575,0.39646464646464646,0.8914141414141414,0.10858585858585859
9817,361,247,114,312,49,0.6842105263157895,0.3157894736842105,0.8642659279778393,0.13573407202216067,191,19,60,112,185,6,0.09947643979057591,0.31413612565445026,0.5863874345549738,0.9685863874345549,0.031413612565445025
9818,331,243,88,275,56,0.7341389728096677,0.26586102719033233,0.8308157099697885,0.1691842900302115,161,21,58,82,158,3,0.13043478260869565,0.36024844720496896,0.5093167701863354,0.9813664596273292,0.018633540372670808
9819,355,245,110,310,45,0.6901408450704225,0.30985915492957744,0.8732394366197183,0.1267605633802817,191,19,60,112,185,6,0.09947643979057591,0.31413612565445026,0.5863874345549738,0.9685863874345549,0.031413612565445025
9820,306,245,61,254,52,0.8006535947712419,0.19934640522875818,0.8300653594771242,0.16993464052287582,221,23,67,131,214,7,0.10407239819004525,0.3031674208144796,0.5927601809954751,0.9683257918552036,0.03167420814479638
9821,130,110,20,101,29,0.8461538461538461,0.15384615384615385,0.7769230769230769,0.2230769230769231,265,2,27,236,249,16,0.007547169811320755,0.1018867924528302,0.8905660377358491,0.939622641509434,0.06037735849056604
9822,337,232,105,288,49,0.6884272997032641,0.3115727002967359,0.8545994065281899,0.14540059347181009,221,23,67,131,214,7,0.10407239819004525,0.3031674208144796,0.5927601809954751,0.9683257918552036,0.03167420814479638
9823,291,229,62,248,43,0.7869415807560137,0.21305841924398625,0.852233676975945,0.14776632302405499,161,21,58,82,158,3,0.13043478260869565,0.36024844720496896,0.5093167701863354,0.9813664596273292,0.018633540372670808
9824,274,237,37,222,52,0.864963503649635,0.13503649635036497,0.8102189781021898,0.1897810218978102,221,23,67,131,214,7,0.10407239819004525,0.3031674208144796,0.5927601809954751,0.9683257918552036,0.03167420814479638
9825,1406,1165,241,1151,255,0.8285917496443812,0.17140825035561877,0.8186344238975818,0.1813655761024182,145,36,48,61,142,3,0.2482758620689655,0.3310344827586207,0.4206896551724138,0.9793103448275862,0.020689655172413793
9826,383,274,109,340,43,0.7154046997389034,0.2845953002610966,0.8877284595300261,0.1122715404699739,191,19,60,112,185,6,0.09947643979057591,0.31413612565445026,0.5863874345549738,0.9685863874345549,0.031413612565445025
9827,359,323,36,300,59,0.8997214484679665,0.10027855153203342,0.8356545961002786,0.16434540389972144,44,2,3,39,38,6,0.045454545454545456,0.06818181818181818,0.8863636363636364,0.8636363636363636,0.13636363636363635
9828,712,622,90,682,30,0.8735955056179775,0.12640449438202248,0.9578651685393258,0.042134831460674156,318,79,96,143,305,13,0.24842767295597484,0.3018867924528302,0.449685534591195,0.9591194968553459,0.040880503144654086
9829,355,245,110,308,47,0.6901408450704225,0.30985915492957744,0.8676056338028169,0.1323943661971831,191,19,60,112,185,6,0.09947643979057591,0.31413612565445026,0.5863874345549738,0.9685863874345549,0.031413612565445025
9830,150,123,27,121,29,0.82,0.18,0.8066666666666666,0.19333333333333333,149,17,35,97,144,5,0.11409395973154363,0.2348993288590604,0.6510067114093959,0.9664429530201343,0.03355704697986577
9831,5841,5359,482,3169,2672,0.9174798835815785,0.0825201164184215,0.5425440849169663,0.45745591508303374,1213,159,499,555,1088,125,0.13107996702390767,0.4113767518549052,0.45754328112118714,0.8969497114591921,0.10305028854080792
9832,383,289,94,333,50,0.7545691906005222,0.2454308093994778,0.8694516971279374,0.13054830287206268,193,23,56,114,185,8,0.11917098445595854,0.29015544041450775,0.5906735751295337,0.9585492227979274,0.04145077720207254
9833,342,230,112,291,51,0.672514619883041,0.32748538011695905,0.8508771929824561,0.14912280701754385,212,23,64,125,205,7,0.10849056603773585,0.3018867924528302,0.589622641509434,0.9669811320754716,0.0330188679245283
9834,365,284,81,318,47,0.7780821917808219,0.2219178082191781,0.8712328767123287,0.12876712328767123,191,19,60,112,185,6,0.09947643979057591,0.31413612565445026,0.5863874345549738,0.9685863874345549,0.031413612565445025
9835,442,372,70,325,117,0.8416289592760181,0.1583710407239819,0.7352941176470589,0.2647058823529412,147,39,48,60,144,3,0.2653061224489796,0.32653061224489793,0.40816326530612246,0.9795918367346939,0.02040816326530612
9836,2699,2144,555,2372,327,0.7943682845498333,0.20563171545016673,0.8788440163023342,0.12115598369766581,1045,128,330,587,980,65,0.12248803827751197,0.3157894736842105,0.5617224880382775,0.937799043062201,0.06220095693779904
9837,335,253,82,285,50,0.755223880597015,0.24477611940298508,0.8507462686567164,0.14925373134328357,191,19,60,112,185,6,0.09947643979057591,0.31413612565445026,0.5863874345549738,0.9685863874345549,0.031413612565445025
9838,201,174,27,156,45,0.8656716417910447,0.13432835820895522,0.7761194029850746,0.22388059701492538,153,39,46,68,147,6,0.2549019607843137,0.3006535947712418,0.4444444444444444,0.9607843137254902,0.0392156862745098
9839,204,173,31,151,53,0.8480392156862745,0.15196078431372548,0.7401960784313726,0.25980392156862747,143,40,45,58,138,5,0.27972027972027974,0.3146853146853147,0.40559440559440557,0.965034965034965,0.03496503496503497
9840,332,252,80,280,52,0.7590361445783133,0.24096385542168675,0.8433734939759037,0.1566265060240964,191,19,60,112,185,6,0.09947643979057591,0.31413612565445026,0.5863874345549738,0.9685863874345549,0.031413612565445025
9841,154,127,27,119,35,0.8246753246753247,0.17532467532467533,0.7727272727272727,0.22727272727272727,145,17,26,102,142,3,0.11724137931034483,0.1793103448275862,0.7034482758620689,0.9793103448275862,0.020689655172413793
9842,405,296,109,361,44,0.7308641975308642,0.2691358024691358,0.891358024691358,0.10864197530864197,191,19,60,112,185,6,0.09947643979057591,0.31413612565445026,0.5863874345549738,0.9685863874345549,0.031413612565445025
9843,916,753,163,687,229,0.8220524017467249,0.1779475982532751,0.75,0.25,98,15,18,65,91,7,0.15306122448979592,0.1836734693877551,0.6632653061224489,0.9285714285714286,0.07142857142857142
9844,10875,9972,903,7568,3307,0.9169655172413793,0.08303448275862069,0.6959080459770115,0.3040919540229885,1635,285,558,792,1339,296,0.1743119266055046,0.3412844036697248,0.48440366972477067,0.8189602446483181,0.18103975535168196
9845,302,245,57,256,46,0.8112582781456954,0.18874172185430463,0.847682119205298,0.152317880794702,191,19,60,112,185,6,0.09947643979057591,0.31413612565445026,0.5863874345549738,0.9685863874345549,0.031413612565445025
9846,341,238,103,288,53,0.6979472140762464,0.3020527859237537,0.844574780058651,0.15542521994134897,221,23,67,131,214,7,0.10407239819004525,0.3031674208144796,0.5927601809954751,0.9683257918552036,0.03167420814479638
9847,36,36,0,19,17,1.0,0.0,0.5277777777777778,0.4722222222222222,7,0,0,7,6,1,0.0,0.0,1.0,0.8571428571428571,0.14285714285714285
9848,288,231,57,238,50,0.8020833333333334,0.19791666666666666,0.8263888888888888,0.1736111111111111,161,21,58,82,158,3,0.13043478260869565,0.36024844720496896,0.5093167701863354,0.9813664596273292,0.018633540372670808
9849,189,119,70,180,9,0.6296296296296297,0.37037037037037035,0.9523809523809523,0.047619047619047616,249,2,126,121,246,3,0.008032128514056224,0.5060240963855421,0.4859437751004016,0.9879518072289156,0.012048192771084338
9850,336,294,42,279,57,0.875,0.125,0.8303571428571429,0.16964285714285715,221,23,67,131,214,7,0.10407239819004525,0.3031674208144796,0.5927601809954751,0.9683257918552036,0.03167420814479638
9851,366,274,92,313,53,0.7486338797814208,0.25136612021857924,0.855191256830601,0.1448087431693989,161,21,58,82,158,3,0.13043478260869565,0.36024844720496896,0.5093167701863354,0.9813664596273292,0.018633540372670808
9852,345,247,98,300,45,0.7159420289855073,0.28405797101449276,0.8695652173913043,0.13043478260869565,221,23,67,131,214,7,0.10407239819004525,0.3031674208144796,0.5927601809954751,0.9683257918552036,0.03167420814479638
9853,405,393,12,322,83,0.9703703703703703,0.02962962962962963,0.7950617283950617,0.20493827160493827,12,0,2,10,8,4,0.0,0.16666666666666666,0.8333333333333334,0.6666666666666666,0.3333333333333333
9854,1734,1462,272,1652,82,0.8431372549019608,0.1568627450980392,0.9527104959630911,0.04728950403690888,1153,59,544,550,1149,4,0.05117085862966175,0.47181266261925414,0.4770164787510841,0.9965307892454467,0.003469210754553339
9855,243,200,43,206,37,0.823045267489712,0.17695473251028807,0.8477366255144033,0.1522633744855967,186,5,23,158,174,12,0.026881720430107527,0.12365591397849462,0.8494623655913979,0.9354838709677419,0.06451612903225806
9856,404,346,58,348,56,0.8564356435643564,0.14356435643564355,0.8613861386138614,0.13861386138613863,153,5,23,125,148,5,0.032679738562091505,0.1503267973856209,0.8169934640522876,0.9673202614379085,0.032679738562091505
9857,2062,1754,308,1961,101,0.8506304558680893,0.14936954413191075,0.9510184287099903,0.0489815712900097,410,67,194,149,407,3,0.16341463414634147,0.47317073170731705,0.36341463414634145,0.9926829268292683,0.007317073170731708
9858,263,226,37,232,31,0.8593155893536122,0.14068441064638784,0.8821292775665399,0.11787072243346007,160,5,23,132,150,10,0.03125,0.14375,0.825,0.9375,0.0625
9859,429,377,52,386,43,0.8787878787878788,0.12121212121212122,0.8997668997668997,0.10023310023310024,160,5,24,131,153,7,0.03125,0.15,0.81875,0.95625,0.04375
9860,248,206,42,205,43,0.8306451612903226,0.1693548387096774,0.8266129032258065,0.17338709677419356,189,5,23,161,181,8,0.026455026455026454,0.12169312169312169,0.8518518518518519,0.9576719576719577,0.042328042328042326
9861,309,89,220,188,121,0.28802588996763756,0.7119741100323624,0.6084142394822006,0.39158576051779936,124,1,55,68,119,5,0.008064516129032258,0.4435483870967742,0.5483870967741935,0.9596774193548387,0.04032258064516129
9862,2056,1779,277,1998,58,0.8652723735408561,0.13472762645914396,0.9717898832684825,0.02821011673151751,1122,40,542,540,1117,5,0.035650623885918005,0.483065953654189,0.48128342245989303,0.9955436720142602,0.004456327985739751
9863,960,762,198,909,51,0.79375,0.20625,0.946875,0.053125,683,84,285,314,682,1,0.12298682284040996,0.4172767203513909,0.45973645680819913,0.9985358711566618,0.0014641288433382138
9864,1092,910,182,1045,47,0.8333333333333334,0.16666666666666666,0.956959706959707,0.04304029304029304,973,49,444,480,965,8,0.050359712230215826,0.4563206577595067,0.4933196300102775,0.9917780061664954,0.008221993833504625
9865,914,739,175,863,51,0.8085339168490153,0.19146608315098468,0.9442013129102844,0.05579868708971553,1477,82,704,691,1468,9,0.055517941773865945,0.4766418415707515,0.46784021665538256,0.993906567366283,0.006093432633716994
9866,942,732,210,894,48,0.7770700636942676,0.2229299363057325,0.9490445859872612,0.050955414012738856,554,69,278,207,553,1,0.12454873646209386,0.5018050541516246,0.37364620938628157,0.9981949458483754,0.0018050541516245488
9867,320,274,46,283,37,0.85625,0.14375,0.884375,0.115625,184,5,24,155,174,10,0.02717391304347826,0.13043478260869565,0.842391304347826,0.9456521739130435,0.05434782608695652
9868,341,289,52,297,44,0.8475073313782991,0.15249266862170088,0.8709677419354839,0.12903225806451613,198,4,25,169,190,8,0.020202020202020204,0.12626262626262627,0.8535353535353535,0.9595959595959596,0.04040404040404041
9869,408,340,68,345,63,0.8333333333333334,0.16666666666666666,0.8455882352941176,0.15441176470588236,120,4,24,92,114,6,0.03333333333333333,0.2,0.7666666666666667,0.95,0.05
9870,233,191,42,196,37,0.8197424892703863,0.18025751072961374,0.8412017167381974,0.15879828326180256,174,5,23,146,165,9,0.028735632183908046,0.13218390804597702,0.8390804597701149,0.9482758620689655,0.05172413793103448
9871,1490,1223,267,1431,59,0.8208053691275168,0.17919463087248322,0.9604026845637584,0.03959731543624161,1618,70,784,764,1604,14,0.04326328800988875,0.484548825710754,0.4721878862793572,0.9913473423980222,0.00865265760197775
9872,755,591,164,712,43,0.7827814569536424,0.21721854304635763,0.9430463576158941,0.05695364238410596,1222,50,586,586,1216,6,0.04091653027823241,0.4795417348608838,0.4795417348608838,0.9950900163666121,0.004909983633387889
9873,1734,1462,272,1652,82,0.8431372549019608,0.1568627450980392,0.9527104959630911,0.04728950403690888,1153,59,544,550,1149,4,0.05117085862966175,0.47181266261925414,0.4770164787510841,0.9965307892454467,0.003469210754553339
9874,1267,1049,218,1220,47,0.8279400157853196,0.17205998421468036,0.9629044988161011,0.037095501183898975,1164,44,552,568,1156,8,0.037800687285223365,0.4742268041237113,0.4879725085910653,0.993127147766323,0.006872852233676976
9875,883,724,159,843,40,0.8199320498301246,0.18006795016987542,0.9546998867497168,0.045300113250283124,1088,71,500,517,1079,9,0.06525735294117647,0.45955882352941174,0.47518382352941174,0.9917279411764706,0.008272058823529412
9876,205,181,24,186,19,0.8829268292682927,0.11707317073170732,0.9073170731707317,0.09268292682926829,151,4,24,123,144,7,0.026490066225165563,0.15894039735099338,0.8145695364238411,0.9536423841059603,0.046357615894039736
9877,393,341,52,344,49,0.8676844783715013,0.13231552162849872,0.8753180661577609,0.12468193384223919,132,5,23,104,126,6,0.03787878787878788,0.17424242424242425,0.7878787878787878,0.9545454545454546,0.045454545454545456
9878,934,774,160,905,29,0.828693790149893,0.17130620985010706,0.9689507494646681,0.031049250535331904,679,105,300,274,678,1,0.15463917525773196,0.4418262150220913,0.40353460972017674,0.9985272459499264,0.0014727540500736377
9879,342,278,64,286,56,0.8128654970760234,0.1871345029239766,0.8362573099415205,0.16374269005847952,160,5,23,132,154,6,0.03125,0.14375,0.825,0.9625,0.0375
9880,292,97,195,145,147,0.3321917808219178,0.6678082191780822,0.4965753424657534,0.5034246575342466,111,0,44,67,107,4,0.0,0.3963963963963964,0.6036036036036037,0.963963963963964,0.036036036036036036
9881,218,164,54,169,49,0.7522935779816514,0.24770642201834864,0.7752293577981652,0.22477064220183487,171,5,23,143,163,8,0.029239766081871343,0.13450292397660818,0.8362573099415205,0.9532163742690059,0.04678362573099415
9882,929,745,184,892,37,0.8019375672766416,0.19806243272335844,0.9601722282023681,0.03982777179763186,676,98,292,286,675,1,0.14497041420118342,0.4319526627218935,0.4230769230769231,0.9985207100591716,0.0014792899408284023
9883,1250,1027,223,1185,65,0.8216,0.1784,0.948,0.052,674,103,289,282,673,1,0.15281899109792285,0.4287833827893175,0.41839762611275966,0.9985163204747775,0.001483679525222552
9884,303,251,52,254,49,0.8283828382838284,0.1716171617161716,0.8382838283828383,0.1617161716171617,157,5,23,129,151,6,0.03184713375796178,0.1464968152866242,0.821656050955414,0.9617834394904459,0.03821656050955414
9885,1252,1032,220,1178,74,0.8242811501597445,0.1757188498402556,0.9408945686900958,0.05910543130990415,1150,47,560,543,1145,5,0.0408695652173913,0.48695652173913045,0.4721739130434783,0.9956521739130435,0.004347826086956522
9886,481,448,33,450,31,0.9313929313929314,0.06860706860706861,0.9355509355509356,0.06444906444906445,185,5,23,157,176,9,0.02702702702702703,0.12432432432432433,0.8486486486486486,0.9513513513513514,0.04864864864864865
9887,431,386,45,388,43,0.8955916473317865,0.10440835266821345,0.9002320185614849,0.09976798143851508,158,5,23,130,148,10,0.03164556962025317,0.14556962025316456,0.8227848101265823,0.9367088607594937,0.06329113924050633
9888,318,111,207,198,120,0.3490566037735849,0.6509433962264151,0.6226415094339622,0.37735849056603776,92,1,45,46,88,4,0.010869565217391304,0.4891304347826087,0.5,0.9565217391304348,0.043478260869565216
9889,1038,862,176,980,58,0.8304431599229287,0.16955684007707128,0.9441233140655106,0.055876685934489405,980,66,474,440,975,5,0.0673469387755102,0.48367346938775513,0.4489795918367347,0.9948979591836735,0.00510204081632653
9890,377,325,52,324,53,0.8620689655172413,0.13793103448275862,0.8594164456233422,0.14058355437665782,170,5,23,142,161,9,0.029411764705882353,0.13529411764705881,0.8352941176470589,0.9470588235294117,0.052941176470588235
9891,1205,999,206,1133,72,0.829045643153527,0.17095435684647303,0.9402489626556016,0.05975103734439834,1008,44,487,477,1002,6,0.04365079365079365,0.48313492063492064,0.4732142857142857,0.9940476190476191,0.005952380952380952
9892,276,82,194,142,134,0.2971014492753623,0.7028985507246377,0.5144927536231884,0.4855072463768116,100,0,40,60,97,3,0.0,0.4,0.6,0.97,0.03
9893,1254,1036,218,1207,47,0.8261562998405104,0.17384370015948963,0.9625199362041468,0.037480063795853266,1382,67,657,658,1374,8,0.04848046309696093,0.47539797395079597,0.4761215629522431,0.9942112879884226,0.005788712011577424
9894,2170,1953,217,2102,68,0.9,0.1,0.9686635944700461,0.03133640552995392,1288,45,621,622,1283,5,0.03493788819875776,0.48214285714285715,0.4829192546583851,0.9961180124223602,0.0038819875776397515
9895,913,813,100,880,33,0.8904709748083242,0.10952902519167579,0.963855421686747,0.03614457831325301,1188,71,558,559,1179,9,0.05976430976430976,0.4696969696969697,0.47053872053872053,0.9924242424242424,0.007575757575757576
9896,275,66,209,139,136,0.24,0.76,0.5054545454545455,0.49454545454545457,97,0,44,53,93,4,0.0,0.4536082474226804,0.5463917525773195,0.9587628865979382,0.041237113402061855
9897,462,405,57,406,56,0.8766233766233766,0.12337662337662338,0.8787878787878788,0.12121212121212122,157,5,23,129,148,9,0.03184713375796178,0.1464968152866242,0.821656050955414,0.9426751592356688,0.05732484076433121
9898,1655,1408,247,1553,102,0.8507552870090634,0.14924471299093656,0.938368580060423,0.06163141993957704,1264,48,610,606,1258,6,0.0379746835443038,0.4825949367088608,0.47943037974683544,0.995253164556962,0.004746835443037975
9899,343,302,41,308,35,0.880466472303207,0.119533527696793,0.8979591836734694,0.10204081632653061,198,5,23,170,188,10,0.025252525252525252,0.11616161616161616,0.8585858585858586,0.9494949494949495,0.050505050505050504
9900,1011,837,174,937,74,0.827893175074184,0.17210682492581603,0.9268051434223541,0.07319485657764589,714,62,416,236,713,1,0.08683473389355742,0.5826330532212886,0.33053221288515405,0.9985994397759104,0.0014005602240896359
9901,337,285,52,290,47,0.8456973293768546,0.1543026706231454,0.8605341246290801,0.1394658753709199,144,4,24,116,139,5,0.027777777777777776,0.16666666666666666,0.8055555555555556,0.9652777777777778,0.034722222222222224
9902,1532,1286,246,1470,62,0.839425587467363,0.16057441253263707,0.9595300261096605,0.04046997389033943,1281,58,622,601,1276,5,0.04527712724434036,0.4855581576893052,0.46916471506635443,0.9960967993754879,0.0039032006245121
9903,319,114,205,162,157,0.3573667711598746,0.6426332288401254,0.5078369905956113,0.49216300940438873,124,0,45,79,119,5,0.0,0.3629032258064516,0.6370967741935484,0.9596774193548387,0.04032258064516129
9904,1335,1151,184,1277,58,0.8621722846441947,0.13782771535580524,0.9565543071161049,0.04344569288389513,2095,54,1003,1038,2089,6,0.025775656324582338,0.47875894988066825,0.4954653937947494,0.9971360381861575,0.002863961813842482
9905,848,689,159,794,54,0.8125,0.1875,0.9363207547169812,0.06367924528301887,1040,65,499,476,1034,6,0.0625,0.4798076923076923,0.4576923076923077,0.9942307692307693,0.0057692307692307696
9906,1749,1509,240,1690,59,0.8627787307032591,0.137221269296741,0.9662664379645511,0.033733562035448826,1182,58,567,557,1178,4,0.049069373942470386,0.4796954314720812,0.4712351945854484,0.9966159052453468,0.00338409475465313
9907,238,203,35,212,26,0.8529411764705882,0.14705882352941177,0.8907563025210085,0.1092436974789916,188,5,23,160,181,7,0.026595744680851064,0.12234042553191489,0.851063829787234,0.9627659574468085,0.03723404255319149
9908,211,170,41,177,34,0.8056872037914692,0.1943127962085308,0.8388625592417062,0.16113744075829384,170,5,24,141,162,8,0.029411764705882353,0.1411764705882353,0.8294117647058824,0.9529411764705882,0.047058823529411764
9909,468,417,51,417,51,0.8910256410256411,0.10897435897435898,0.8910256410256411,0.10897435897435898,160,4,24,132,151,9,0.025,0.15,0.825,0.94375,0.05625
9910,1791,1553,238,1736,55,0.8671133445002792,0.1328866554997208,0.9692908989391401,0.030709101060859854,1282,65,609,608,1277,5,0.05070202808112324,0.4750390015600624,0.47425897035881437,0.9960998439937597,0.0039001560062402497
9911,1250,1027,223,1185,65,0.8216,0.1784,0.948,0.052,676,103,289,284,675,1,0.15236686390532544,0.4275147928994083,0.42011834319526625,0.9985207100591716,0.0014792899408284023
9912,1227,981,246,954,273,0.7995110024449877,0.20048899755501223,0.7775061124694377,0.22249388753056235,468,9,94,365,306,162,0.019230769230769232,0.20085470085470086,0.7799145299145299,0.6538461538461539,0.34615384615384615
9913,269,219,50,223,46,0.8141263940520446,0.18587360594795538,0.828996282527881,0.17100371747211895,183,5,23,155,172,11,0.0273224043715847,0.12568306010928962,0.8469945355191257,0.9398907103825137,0.060109289617486336
9914,2185,1916,269,2132,53,0.8768878718535469,0.12311212814645309,0.9757437070938215,0.02425629290617849,1123,66,549,508,1118,5,0.058771148708815675,0.4888691006233304,0.45235975066785394,0.9955476402493322,0.004452359750667854
9915,761,595,166,718,43,0.7818659658344284,0.21813403416557162,0.9434954007884363,0.056504599211563734,623,88,249,286,622,1,0.14125200642054575,0.3996789727126806,0.4590690208667737,0.9983948635634029,0.0016051364365971107
9916,187,146,41,153,34,0.7807486631016043,0.2192513368983957,0.8181818181818182,0.18181818181818182,131,5,23,103,124,7,0.03816793893129771,0.17557251908396945,0.7862595419847328,0.9465648854961832,0.05343511450381679
9917,1192,940,252,1120,72,0.7885906040268457,0.21140939597315436,0.9395973154362416,0.06040268456375839,1943,67,928,948,1935,8,0.034482758620689655,0.47761194029850745,0.4879053010808029,0.9958826556870818,0.004117344312918168
9918,224,180,44,188,36,0.8035714285714286,0.19642857142857142,0.8392857142857143,0.16071428571428573,147,5,24,118,138,9,0.034013605442176874,0.16326530612244897,0.8027210884353742,0.9387755102040817,0.061224489795918366
9919,789,625,164,736,53,0.7921419518377694,0.20785804816223066,0.9328263624841572,0.06717363751584284,563,59,299,205,561,2,0.10479573712255773,0.5310834813499112,0.3641207815275311,0.9964476021314387,0.003552397868561279
9920,738,573,165,699,39,0.7764227642276422,0.22357723577235772,0.9471544715447154,0.052845528455284556,573,101,229,243,572,1,0.1762652705061082,0.39965095986038396,0.42408376963350786,0.9982547993019197,0.0017452006980802793
9921,1215,1087,128,1177,38,0.8946502057613168,0.10534979423868313,0.968724279835391,0.031275720164609055,1189,80,554,555,1184,5,0.0672834314550042,0.4659377628259041,0.4667788057190917,0.9957947855340622,0.004205214465937763
9922,1158,929,229,1088,70,0.802245250431779,0.19775474956822106,0.9395509499136442,0.06044905008635579,659,105,313,241,656,3,0.15933232169954475,0.47496206373292865,0.36570561456752654,0.9954476479514416,0.004552352048558422
9923,318,263,55,263,55,0.8270440251572327,0.17295597484276728,0.8270440251572327,0.17295597484276728,140,5,23,112,136,4,0.03571428571428571,0.16428571428571428,0.8,0.9714285714285714,0.02857142857142857
9924,463,406,57,406,57,0.8768898488120951,0.12311015118790497,0.8768898488120951,0.12311015118790497,186,5,23,158,174,12,0.026881720430107527,0.12365591397849462,0.8494623655913979,0.9354838709677419,0.06451612903225806
9925,205,162,43,165,40,0.7902439024390244,0.2097560975609756,0.8048780487804879,0.1951219512195122,155,5,23,127,144,11,0.03225806451612903,0.14838709677419354,0.8193548387096774,0.9290322580645162,0.07096774193548387
9926,1718,1436,282,1643,75,0.8358556461001164,0.16414435389988358,0.9563445867287543,0.043655413271245634,983,40,463,480,978,5,0.04069175991861648,0.47100712105798576,0.4883011190233978,0.9949135300101729,0.00508646998982706
9927,647,478,169,599,48,0.7387944358578052,0.26120556414219476,0.9258114374034003,0.07418856259659969,565,88,241,236,564,1,0.15575221238938053,0.4265486725663717,0.4176991150442478,0.9982300884955753,0.0017699115044247787
9928,222,184,38,187,35,0.8288288288288288,0.17117117117117117,0.8423423423423423,0.15765765765765766,166,5,23,138,158,8,0.030120481927710843,0.13855421686746988,0.8313253012048193,0.9518072289156626,0.04819277108433735
9929,970,768,202,923,47,0.7917525773195876,0.20824742268041238,0.9515463917525773,0.04845360824742268,552,84,179,289,551,1,0.15217391304347827,0.3242753623188406,0.5235507246376812,0.9981884057971014,0.0018115942028985507
9930,997,809,188,937,60,0.8114343029087262,0.18856569709127383,0.9398194583751254,0.06018054162487462,486,78,176,232,485,1,0.16049382716049382,0.36213991769547327,0.4773662551440329,0.9979423868312757,0.00205761316872428
9931,228,198,30,205,23,0.868421052631579,0.13157894736842105,0.8991228070175439,0.10087719298245613,160,4,24,132,152,8,0.025,0.15,0.825,0.95,0.05
9932,220,183,37,192,28,0.8318181818181818,0.16818181818181818,0.8727272727272727,0.12727272727272726,150,5,25,120,143,7,0.03333333333333333,0.16666666666666666,0.8,0.9533333333333334,0.04666666666666667
9933,1242,1146,96,1217,25,0.9227053140096618,0.07729468599033816,0.9798711755233495,0.020128824476650563,914,48,435,431,911,3,0.0525164113785558,0.4759299781181619,0.47155361050328226,0.9967177242888403,0.0032822757111597373
9934,341,115,226,191,150,0.33724340175953077,0.6627565982404692,0.5601173020527859,0.4398826979472141,127,0,49,78,122,5,0.0,0.3858267716535433,0.6141732283464567,0.9606299212598425,0.03937007874015748
9935,1352,1106,246,1295,57,0.8180473372781065,0.1819526627218935,0.9578402366863905,0.04215976331360947,1129,72,531,526,1121,8,0.0637732506643047,0.47032772364924713,0.4658990256864482,0.9929140832595217,0.0070859167404783
9936,1532,1286,246,1470,62,0.839425587467363,0.16057441253263707,0.9595300261096605,0.04046997389033943,1281,58,622,601,1276,5,0.04527712724434036,0.4855581576893052,0.46916471506635443,0.9960967993754879,0.0039032006245121
9937,2175,1945,230,2106,69,0.8942528735632184,0.10574712643678161,0.9682758620689655,0.031724137931034485,1286,37,622,627,1280,6,0.028771384136858476,0.48367029548989116,0.48755832037325036,0.995334370139969,0.004665629860031105
9938,351,297,54,298,53,0.8461538461538461,0.15384615384615385,0.8490028490028491,0.150997150997151,161,5,23,133,152,9,0.031055900621118012,0.14285714285714285,0.8260869565217391,0.9440993788819876,0.055900621118012424
9939,251,221,30,230,21,0.8804780876494024,0.11952191235059761,0.9163346613545816,0.08366533864541832,146,4,25,117,140,6,0.0273972602739726,0.17123287671232876,0.8013698630136986,0.958904109589041,0.0410958904109589
9940,948,773,175,889,59,0.8154008438818565,0.18459915611814345,0.9377637130801688,0.06223628691983123,1009,64,490,455,1004,5,0.06342913776015857,0.48562933597621405,0.4509415262636274,0.9950445986124876,0.004955401387512388
9941,285,69,216,158,127,0.24210526315789474,0.7578947368421053,0.5543859649122806,0.4456140350877193,111,0,44,67,108,3,0.0,0.3963963963963964,0.6036036036036037,0.972972972972973,0.02702702702702703
9942,237,181,56,188,49,0.7637130801687764,0.23628691983122363,0.7932489451476793,0.20675105485232068,146,5,24,117,140,6,0.03424657534246575,0.1643835616438356,0.8013698630136986,0.958904109589041,0.0410958904109589
9943,1160,967,193,1098,62,0.8336206896551724,0.16637931034482759,0.946551724137931,0.05344827586206897,1112,53,525,534,1104,8,0.047661870503597124,0.4721223021582734,0.4802158273381295,0.9928057553956835,0.007194244604316547
9944,228,202,26,205,23,0.8859649122807017,0.11403508771929824,0.8991228070175439,0.10087719298245613,172,5,23,144,164,8,0.029069767441860465,0.13372093023255813,0.8372093023255814,0.9534883720930233,0.046511627906976744
9945,312,284,28,287,25,0.9102564102564102,0.08974358974358974,0.9198717948717948,0.08012820512820513,169,5,23,141,161,8,0.029585798816568046,0.13609467455621302,0.834319526627219,0.9526627218934911,0.047337278106508875
9946,1734,1462,272,1652,82,0.8431372549019608,0.1568627450980392,0.9527104959630911,0.04728950403690888,1153,59,544,550,1149,4,0.05117085862966175,0.47181266261925414,0.4770164787510841,0.9965307892454467,0.003469210754553339
9947,387,345,42,350,37,0.8914728682170543,0.10852713178294573,0.9043927648578811,0.09560723514211886,143,4,24,115,137,6,0.027972027972027972,0.16783216783216784,0.8041958041958042,0.958041958041958,0.04195804195804196
9948,206,163,43,165,41,0.7912621359223301,0.2087378640776699,0.8009708737864077,0.19902912621359223,151,5,23,123,145,6,0.033112582781456956,0.152317880794702,0.8145695364238411,0.9602649006622517,0.039735099337748346
9949,1287,1095,192,1244,43,0.8508158508158508,0.14918414918414918,0.9665889665889665,0.03341103341103341,1106,49,522,535,1098,8,0.04430379746835443,0.4719710669077758,0.4837251356238698,0.9927667269439421,0.007233273056057866
9950,1035,815,220,970,65,0.7874396135265701,0.21256038647342995,0.9371980676328503,0.06280193236714976,716,99,305,312,715,1,0.138268156424581,0.4259776536312849,0.43575418994413406,0.9986033519553073,0.0013966480446927375
9951,418,358,60,357,61,0.8564593301435407,0.14354066985645933,0.854066985645933,0.145933014354067,145,4,24,117,138,7,0.027586206896551724,0.16551724137931034,0.8068965517241379,0.9517241379310345,0.04827586206896552
9952,613,459,154,570,43,0.7487765089722676,0.25122349102773245,0.9298531810766721,0.0701468189233279,607,80,273,254,606,1,0.13179571663920922,0.4497528830313015,0.4184514003294893,0.9983525535420099,0.0016474464579901153
9953,1134,949,185,1072,62,0.8368606701940036,0.16313932980599646,0.9453262786596119,0.054673721340388004,968,39,465,464,965,3,0.040289256198347105,0.48037190082644626,0.4793388429752066,0.996900826446281,0.0030991735537190084
9954,1621,1375,246,1556,65,0.8482418260333128,0.15175817396668723,0.9599012954966071,0.040098704503392965,1049,52,488,509,1044,5,0.04957102001906578,0.4652049571020019,0.4852240228789323,0.9952335557673975,0.004766444232602479
9955,402,340,62,348,54,0.845771144278607,0.15422885572139303,0.8656716417910447,0.13432835820895522,147,5,23,119,141,6,0.034013605442176874,0.1564625850340136,0.8095238095238095,0.9591836734693877,0.04081632653061224
9956,1175,971,204,1124,51,0.8263829787234043,0.17361702127659576,0.9565957446808511,0.04340425531914894,694,92,287,315,693,1,0.13256484149855907,0.41354466858789624,0.4538904899135447,0.9985590778097982,0.001440922190201729
9957,325,104,221,174,151,0.32,0.68,0.5353846153846153,0.4646153846153846,107,0,49,58,105,2,0.0,0.45794392523364486,0.5420560747663551,0.9813084112149533,0.018691588785046728
9958,295,238,57,237,58,0.8067796610169492,0.19322033898305085,0.8033898305084746,0.19661016949152543,166,4,24,138,158,8,0.024096385542168676,0.14457831325301204,0.8313253012048193,0.9518072289156626,0.04819277108433735
9959,1532,1286,246,1470,62,0.839425587467363,0.16057441253263707,0.9595300261096605,0.04046997389033943,1281,58,622,601,1276,5,0.04527712724434036,0.4855581576893052,0.46916471506635443,0.9960967993754879,0.0039032006245121
9960,962,779,183,921,41,0.8097713097713097,0.19022869022869024,0.9573804573804574,0.04261954261954262,548,97,253,198,547,1,0.177007299270073,0.46167883211678834,0.3613138686131387,0.9981751824817519,0.0018248175182481751
9961,1723,1542,181,1667,56,0.8949506674405108,0.10504933255948927,0.967498549042368,0.03250145095763204,1276,65,608,603,1269,7,0.050940438871473356,0.47648902821316613,0.4725705329153605,0.9945141065830722,0.0054858934169279
9962,1049,853,196,1010,39,0.8131553860819828,0.18684461391801716,0.9628217349857007,0.037178265014299335,997,55,464,478,992,5,0.055165496489468405,0.4653961885656971,0.4794383149448345,0.9949849548645938,0.0050150451354062184
9963,295,255,40,264,31,0.864406779661017,0.13559322033898305,0.8949152542372881,0.10508474576271186,156,4,25,127,149,7,0.02564102564102564,0.16025641025641027,0.8141025641025641,0.9551282051282052,0.04487179487179487
9964,972,770,202,925,47,0.7921810699588477,0.20781893004115226,0.9516460905349794,0.04835390946502058,759,110,337,312,758,1,0.14492753623188406,0.4440052700922266,0.41106719367588934,0.9986824769433466,0.0013175230566534915
9965,251,80,171,147,104,0.3187250996015936,0.6812749003984063,0.5856573705179283,0.41434262948207173,90,0,40,50,89,1,0.0,0.4444444444444444,0.5555555555555556,0.9888888888888889,0.011111111111111112
9966,960,782,178,920,40,0.8145833333333333,0.18541666666666667,0.9583333333333334,0.041666666666666664,1978,65,951,962,1969,9,0.03286147623862487,0.480788675429727,0.4863498483316481,0.9954499494438828,0.00455005055611729
9967,1734,1462,272,1652,82,0.8431372549019608,0.1568627450980392,0.9527104959630911,0.04728950403690888,1153,59,544,550,1149,4,0.05117085862966175,0.47181266261925414,0.4770164787510841,0.9965307892454467,0.003469210754553339
9968,1136,954,182,1104,32,0.8397887323943662,0.1602112676056338,0.971830985915493,0.028169014084507043,1279,59,628,592,1275,4,0.046129788897576234,0.4910086004691165,0.4628616106333073,0.99687255668491,0.003127443315089914
9969,237,199,38,201,36,0.8396624472573839,0.16033755274261605,0.8481012658227848,0.1518987341772152,198,4,24,170,191,7,0.020202020202020204,0.12121212121212122,0.8585858585858586,0.9646464646464646,0.03535353535353535
9970,472,416,56,415,57,0.8813559322033898,0.11864406779661017,0.8792372881355932,0.12076271186440678,178,5,23,150,169,9,0.028089887640449437,0.12921348314606743,0.8426966292134831,0.949438202247191,0.05056179775280899
9971,1176,1006,170,1145,31,0.8554421768707483,0.1445578231292517,0.9736394557823129,0.026360544217687076,1583,52,760,771,1580,3,0.032849020846494,0.4801010739102969,0.48704990524320907,0.998104864181933,0.0018951358180669614
9972,1264,1026,238,1210,54,0.8117088607594937,0.18829113924050633,0.9572784810126582,0.04272151898734177,1005,75,481,449,996,9,0.07462686567164178,0.4786069651741294,0.44676616915422884,0.991044776119403,0.008955223880597015
9973,1335,1151,184,1277,58,0.8621722846441947,0.13782771535580524,0.9565543071161049,0.04344569288389513,2095,54,1003,1038,2089,6,0.025775656324582338,0.47875894988066825,0.4954653937947494,0.9971360381861575,0.002863961813842482
9974,539,482,57,482,57,0.8942486085343229,0.10575139146567718,0.8942486085343229,0.10575139146567718,177,4,24,149,169,8,0.022598870056497175,0.13559322033898305,0.8418079096045198,0.9548022598870056,0.04519774011299435
9975,171,129,42,137,34,0.7543859649122807,0.24561403508771928,0.8011695906432749,0.19883040935672514,200,5,24,171,189,11,0.025,0.12,0.855,0.945,0.055
9976,968,737,231,902,66,0.7613636363636364,0.23863636363636365,0.9318181818181818,0.06818181818181818,1072,62,499,511,1063,9,0.05783582089552239,0.46548507462686567,0.4766791044776119,0.9916044776119403,0.008395522388059701
9977,514,435,79,443,71,0.8463035019455253,0.15369649805447472,0.8618677042801557,0.13813229571984437,146,4,24,118,139,7,0.0273972602739726,0.1643835616438356,0.8082191780821918,0.952054794520548,0.04794520547945205
9978,1335,1151,184,1277,58,0.8621722846441947,0.13782771535580524,0.9565543071161049,0.04344569288389513,2095,54,1003,1038,2089,6,0.025775656324582338,0.47875894988066825,0.4954653937947494,0.9971360381861575,0.002863961813842482
9979,964,765,199,915,49,0.7935684647302904,0.20643153526970953,0.9491701244813278,0.0508298755186722,716,92,297,327,715,1,0.12849162011173185,0.41480446927374304,0.45670391061452514,0.9986033519553073,0.0013966480446927375
9980,1734,1462,272,1652,82,0.8431372549019608,0.1568627450980392,0.9527104959630911,0.04728950403690888,1153,59,544,550,1149,4,0.05117085862966175,0.47181266261925414,0.4770164787510841,0.9965307892454467,0.003469210754553339
9981,824,678,146,780,44,0.8228155339805825,0.17718446601941748,0.9466019417475728,0.05339805825242718,858,61,396,401,851,7,0.07109557109557109,0.46153846153846156,0.46736596736596736,0.9918414918414918,0.008158508158508158
9982,487,430,57,436,51,0.8829568788501027,0.11704312114989733,0.8952772073921971,0.10472279260780287,156,5,23,128,148,8,0.03205128205128205,0.14743589743589744,0.8205128205128205,0.9487179487179487,0.05128205128205128
9983,1055,830,225,1007,48,0.7867298578199052,0.2132701421800948,0.9545023696682464,0.04549763033175355,1198,67,564,567,1188,10,0.055926544240400666,0.4707846410684474,0.4732888146911519,0.991652754590985,0.008347245409015025
9984,143,121,22,126,17,0.8461538461538461,0.15384615384615385,0.8811188811188811,0.11888111888111888,132,11,56,65,132,0,0.08333333333333333,0.42424242424242425,0.49242424242424243,1.0,0.0
9985,1532,1286,246,1470,62,0.839425587467363,0.16057441253263707,0.9595300261096605,0.04046997389033943,1282,58,622,602,1277,5,0.0452418096723869,0.48517940717628705,0.46957878315132606,0.9960998439937597,0.0039001560062402497
9986,1882,1632,250,1800,82,0.8671625929861849,0.13283740701381508,0.9564293304994687,0.04357066950053135,1174,64,570,540,1167,7,0.054514480408858604,0.4855195911413969,0.4599659284497445,0.9940374787052811,0.00596252129471891
9987,306,109,197,165,141,0.3562091503267974,0.6437908496732027,0.5392156862745098,0.46078431372549017,92,0,38,54,90,2,0.0,0.41304347826086957,0.5869565217391305,0.9782608695652174,0.021739130434782608
9988,432,372,60,372,60,0.8611111111111112,0.1388888888888889,0.8611111111111112,0.1388888888888889,191,5,24,162,179,12,0.02617801047120419,0.1256544502617801,0.8481675392670157,0.93717277486911,0.06282722513089005
9989,514,435,79,443,71,0.8463035019455253,0.15369649805447472,0.8618677042801557,0.13813229571984437,155,4,24,127,146,9,0.025806451612903226,0.15483870967741936,0.8193548387096774,0.9419354838709677,0.05806451612903226
9990,1455,1261,194,1411,44,0.8666666666666667,0.13333333333333333,0.9697594501718213,0.030240549828178694,1298,71,626,601,1292,6,0.054699537750385205,0.48228043143297383,0.463020030816641,0.9953775038520801,0.004622496147919877
9991,2056,1779,277,1998,58,0.8652723735408561,0.13472762645914396,0.9717898832684825,0.02821011673151751,1122,40,542,540,1117,5,0.035650623885918005,0.483065953654189,0.48128342245989303,0.9955436720142602,0.004456327985739751
9992,487,430,57,436,51,0.8829568788501027,0.11704312114989733,0.8952772073921971,0.10472279260780287,169,5,23,141,158,11,0.029585798816568046,0.13609467455621302,0.834319526627219,0.9349112426035503,0.0650887573964497
9993,1357,1142,215,1289,68,0.8415622697126013,0.1584377302873987,0.9498894620486367,0.050110537951363304,1299,54,627,618,1293,6,0.04157043879907621,0.48267898383371827,0.47575057736720555,0.9953810623556582,0.004618937644341801
9994,402,340,62,348,54,0.845771144278607,0.15422885572139303,0.8656716417910447,0.13432835820895522,145,5,23,117,139,6,0.034482758620689655,0.15862068965517243,0.8068965517241379,0.9586206896551724,0.041379310344827586
9995,1087,934,153,1062,25,0.859245630174793,0.140754369825207,0.9770009199632015,0.022999080036798528,923,63,430,430,916,7,0.06825568797399784,0.4658721560130011,0.4658721560130011,0.9924160346695557,0.007583965330444204
9996,352,300,52,305,47,0.8522727272727273,0.14772727272727273,0.8664772727272727,0.13352272727272727,167,4,24,139,158,9,0.023952095808383235,0.1437125748502994,0.8323353293413174,0.9461077844311377,0.05389221556886228
9997,243,63,180,118,125,0.25925925925925924,0.7407407407407407,0.48559670781893005,0.51440329218107,82,0,34,48,79,3,0.0,0.4146341463414634,0.5853658536585366,0.9634146341463414,0.036585365853658534
9998,1184,1013,171,1141,43,0.8555743243243243,0.14442567567567569,0.9636824324324325,0.036317567567567564,1041,54,498,489,1036,5,0.05187319884726225,0.4783861671469741,0.4697406340057637,0.9951969260326609,0.004803073967339097
9999,983,791,192,928,55,0.8046795523906409,0.1953204476093591,0.9440488301119023,0.05595116988809766,637,76,243,318,635,2,0.11930926216640503,0.3814756671899529,0.49921507064364207,0.9968602825745683,0.0031397174254317113
10000,1476,1304,172,1431,45,0.8834688346883469,0.11653116531165311,0.9695121951219512,0.03048780487804878,1039,47,499,493,1035,4,0.04523580365736285,0.480269489894129,0.47449470644850816,0.9961501443695862,0.0038498556304138597
10001,291,243,48,247,44,0.8350515463917526,0.16494845360824742,0.8487972508591065,0.15120274914089346,187,5,23,159,178,9,0.026737967914438502,0.12299465240641712,0.8502673796791443,0.9518716577540107,0.0481283422459893
10002,406,359,47,361,45,0.8842364532019704,0.11576354679802955,0.8891625615763546,0.11083743842364532,130,4,24,102,125,5,0.03076923076923077,0.18461538461538463,0.7846153846153846,0.9615384615384616,0.038461538461538464
10003,300,237,63,245,55,0.79,0.21,0.8166666666666667,0.18333333333333332,165,5,24,136,155,10,0.030303030303030304,0.14545454545454545,0.8242424242424242,0.9393939393939394,0.06060606060606061
10004,1335,1151,184,1277,58,0.8621722846441947,0.13782771535580524,0.9565543071161049,0.04344569288389513,2095,54,1003,1038,2089,6,0.025775656324582338,0.47875894988066825,0.4954653937947494,0.9971360381861575,0.002863961813842482
10005,1532,1286,246,1470,62,0.839425587467363,0.16057441253263707,0.9595300261096605,0.04046997389033943,1281,58,622,601,1276,5,0.04527712724434036,0.4855581576893052,0.46916471506635443,0.9960967993754879,0.0039032006245121
10006,1125,881,244,1062,63,0.7831111111111111,0.21688888888888888,0.944,0.056,660,86,325,249,657,3,0.1303030303030303,0.49242424242424243,0.37727272727272726,0.9954545454545455,0.004545454545454545
10007,965,808,157,907,58,0.8373056994818653,0.16269430051813472,0.9398963730569948,0.06010362694300518,540,49,270,221,536,4,0.09074074074074075,0.5,0.40925925925925927,0.9925925925925926,0.007407407407407408
10008,319,98,221,172,147,0.3072100313479624,0.6927899686520376,0.5391849529780565,0.4608150470219436,126,0,53,73,122,4,0.0,0.42063492063492064,0.5793650793650794,0.9682539682539683,0.031746031746031744
10009,275,245,30,253,22,0.8909090909090909,0.10909090909090909,0.92,0.08,150,5,23,122,145,5,0.03333333333333333,0.15333333333333332,0.8133333333333334,0.9666666666666667,0.03333333333333333
10010,796,661,135,762,34,0.8304020100502513,0.16959798994974876,0.957286432160804,0.04271356783919598,1965,60,957,948,1956,9,0.030534351145038167,0.4870229007633588,0.48244274809160304,0.9954198473282443,0.004580152671755725
10011,1215,1087,128,1177,38,0.8946502057613168,0.10534979423868313,0.968724279835391,0.031275720164609055,1189,80,554,555,1184,5,0.0672834314550042,0.4659377628259041,0.4667788057190917,0.9957947855340622,0.004205214465937763
10012,2093,1852,241,2039,54,0.884854276158624,0.11514572384137602,0.9741997133301481,0.025800286669851888,1256,54,604,598,1249,7,0.042993630573248405,0.48089171974522293,0.47611464968152867,0.9944267515923567,0.005573248407643312
10013,318,263,55,263,55,0.8270440251572327,0.17295597484276728,0.8270440251572327,0.17295597484276728,140,5,23,112,136,4,0.03571428571428571,0.16428571428571428,0.8,0.9714285714285714,0.02857142857142857
10014,1820,1595,225,1765,55,0.8763736263736264,0.12362637362637363,0.9697802197802198,0.03021978021978022,1147,53,545,549,1143,4,0.046207497820401046,0.47515257192676547,0.47863993025283347,0.9965126416739319,0.0034873583260680036
10015,182,143,39,152,30,0.7857142857142857,0.21428571428571427,0.8351648351648352,0.16483516483516483,147,5,24,118,141,6,0.034013605442176874,0.16326530612244897,0.8027210884353742,0.9591836734693877,0.04081632653061224
10016,1422,1161,261,1372,50,0.8164556962025317,0.18354430379746836,0.9648382559774965,0.035161744022503515,944,65,439,440,936,8,0.06885593220338983,0.4650423728813559,0.4661016949152542,0.9915254237288136,0.00847457627118644
10017,1734,1462,272,1652,82,0.8431372549019608,0.1568627450980392,0.9527104959630911,0.04728950403690888,1153,59,544,550,1149,4,0.05117085862966175,0.47181266261925414,0.4770164787510841,0.9965307892454467,0.003469210754553339
10018,457,390,67,391,66,0.8533916849015317,0.14660831509846828,0.8555798687089715,0.14442013129102846,185,5,23,157,177,8,0.02702702702702703,0.12432432432432433,0.8486486486486486,0.9567567567567568,0.043243243243243246
10019,281,88,193,168,113,0.31316725978647686,0.6868327402135231,0.597864768683274,0.40213523131672596,94,0,36,58,91,3,0.0,0.3829787234042553,0.6170212765957447,0.9680851063829787,0.031914893617021274
10020,1296,1162,134,1248,48,0.8966049382716049,0.10339506172839506,0.9629629629629629,0.037037037037037035,1285,61,608,616,1280,5,0.047470817120622566,0.47315175097276263,0.4793774319066148,0.9961089494163424,0.0038910505836575876
10021,211,170,41,177,34,0.8056872037914692,0.1943127962085308,0.8388625592417062,0.16113744075829384,170,5,24,141,162,8,0.029411764705882353,0.1411764705882353,0.8294117647058824,0.9529411764705882,0.047058823529411764
10022,341,277,64,285,56,0.8123167155425219,0.187683284457478,0.8357771260997068,0.16422287390029325,164,5,23,136,155,9,0.03048780487804878,0.1402439024390244,0.8292682926829268,0.9451219512195121,0.054878048780487805
10023,1268,1029,239,1225,43,0.8115141955835962,0.18848580441640378,0.9660883280757098,0.03391167192429022,1150,82,524,544,1141,9,0.07130434782608695,0.45565217391304347,0.47304347826086957,0.9921739130434782,0.00782608695652174
10024,960,768,192,917,43,0.8,0.2,0.9552083333333333,0.04479166666666667,1205,69,581,555,1197,8,0.05726141078838174,0.4821576763485477,0.4605809128630705,0.9933609958506224,0.006639004149377593
10025,291,243,48,247,44,0.8350515463917526,0.16494845360824742,0.8487972508591065,0.15120274914089346,176,5,23,148,168,8,0.028409090909090908,0.13068181818181818,0.8409090909090909,0.9545454545454546,0.045454545454545456
10026,978,762,216,916,62,0.7791411042944786,0.22085889570552147,0.9366053169734151,0.06339468302658487,613,94,235,284,612,1,0.1533442088091354,0.3833605220228385,0.4632952691680261,0.99836867862969,0.0016313213703099511
10027,228,198,30,205,23,0.868421052631579,0.13157894736842105,0.8991228070175439,0.10087719298245613,166,4,24,138,156,10,0.024096385542168676,0.14457831325301204,0.8313253012048193,0.9397590361445783,0.060240963855421686
10028,457,390,67,391,66,0.8533916849015317,0.14660831509846828,0.8555798687089715,0.14442013129102846,163,5,23,135,155,8,0.03067484662576687,0.1411042944785276,0.8282208588957055,0.950920245398773,0.049079754601226995
10029,306,270,36,276,30,0.8823529411764706,0.11764705882352941,0.9019607843137255,0.09803921568627451,154,5,23,126,148,6,0.032467532467532464,0.14935064935064934,0.8181818181818182,0.961038961038961,0.03896103896103896
10030,316,101,215,182,134,0.31962025316455694,0.680379746835443,0.5759493670886076,0.4240506329113924,114,1,44,69,110,4,0.008771929824561403,0.38596491228070173,0.6052631578947368,0.9649122807017544,0.03508771929824561
10031,1440,1219,221,1383,57,0.8465277777777778,0.15347222222222223,0.9604166666666667,0.03958333333333333,1109,52,537,520,1105,4,0.046889089269612265,0.4842200180342651,0.4688908926961226,0.9963931469792606,0.0036068530207394047
10032,378,307,71,317,61,0.8121693121693122,0.18783068783068782,0.8386243386243386,0.16137566137566137,187,5,25,157,179,8,0.026737967914438502,0.13368983957219252,0.839572192513369,0.9572192513368984,0.0427807486631016
10033,1691,1531,160,1642,49,0.9053814311058546,0.09461856889414548,0.9710230632761679,0.02897693672383205,982,64,464,454,979,3,0.06517311608961303,0.4725050916496945,0.4623217922606925,0.9969450101832994,0.003054989816700611
10034,1501,1283,218,1441,60,0.854763491005996,0.145236508994004,0.9600266489007329,0.039973351099267154,1147,64,561,522,1142,5,0.05579773321708806,0.4891020052310375,0.45510026155187444,0.995640802092415,0.004359197907585004
10035,305,101,204,153,152,0.33114754098360655,0.6688524590163935,0.5016393442622951,0.49836065573770494,91,0,40,51,87,4,0.0,0.43956043956043955,0.5604395604395604,0.9560439560439561,0.04395604395604396
10036,1335,1151,184,1277,58,0.8621722846441947,0.13782771535580524,0.9565543071161049,0.04344569288389513,2095,54,1003,1038,2089,6,0.025775656324582338,0.47875894988066825,0.4954653937947494,0.9971360381861575,0.002863961813842482
10037,1170,1004,166,1122,48,0.8581196581196581,0.14188034188034188,0.958974358974359,0.041025641025641026,1051,53,514,484,1043,8,0.05042816365366318,0.489058039961941,0.4605137963843958,0.9923882017126546,0.007611798287345386
10038,915,726,189,869,46,0.7934426229508197,0.20655737704918034,0.9497267759562842,0.05027322404371585,1134,60,547,527,1127,7,0.05291005291005291,0.48236331569664903,0.46472663139329806,0.9938271604938271,0.006172839506172839
10039,425,377,48,379,46,0.8870588235294118,0.11294117647058824,0.8917647058823529,0.10823529411764705,202,5,23,174,192,10,0.024752475247524754,0.11386138613861387,0.8613861386138614,0.9504950495049505,0.04950495049504951
10040,1734,1462,272,1652,82,0.8431372549019608,0.1568627450980392,0.9527104959630911,0.04728950403690888,1153,59,544,550,1149,4,0.05117085862966175,0.47181266261925414,0.4770164787510841,0.9965307892454467,0.003469210754553339
10041,488,430,58,437,51,0.8811475409836066,0.11885245901639344,0.8954918032786885,0.10450819672131148,144,5,23,116,138,6,0.034722222222222224,0.1597222222222222,0.8055555555555556,0.9583333333333334,0.041666666666666664
10042,1393,1192,201,1315,78,0.8557071069633884,0.14429289303661164,0.9440057430007178,0.05599425699928212,1659,46,799,814,1649,10,0.027727546714888487,0.4816154309825196,0.49065702230259195,0.9939722724532851,0.006027727546714889
10043,1242,1146,96,1217,25,0.9227053140096618,0.07729468599033816,0.9798711755233495,0.020128824476650563,914,48,435,431,911,3,0.0525164113785558,0.4759299781181619,0.47155361050328226,0.9967177242888403,0.0032822757111597373
10044,1665,1415,250,1586,79,0.8498498498498499,0.15015015015015015,0.9525525525525526,0.04744744744744745,2153,49,1043,1061,2146,7,0.02275894101254064,0.48444031583836505,0.4928007431490943,0.9967487227124942,0.003251277287505806
10045,1335,1151,184,1277,58,0.8621722846441947,0.13782771535580524,0.9565543071161049,0.04344569288389513,2095,54,1003,1038,2089,6,0.025775656324582338,0.47875894988066825,0.4954653937947494,0.9971360381861575,0.002863961813842482
10046,279,79,200,159,120,0.2831541218637993,0.7168458781362007,0.5698924731182796,0.43010752688172044,110,0,52,58,107,3,0.0,0.4727272727272727,0.5272727272727272,0.9727272727272728,0.02727272727272727
10047,487,430,57,436,51,0.8829568788501027,0.11704312114989733,0.8952772073921971,0.10472279260780287,169,5,23,141,158,11,0.029585798816568046,0.13609467455621302,0.834319526627219,0.9349112426035503,0.0650887573964497
10048,329,268,61,265,64,0.8145896656534954,0.18541033434650456,0.8054711246200608,0.1945288753799392,141,5,23,113,136,5,0.03546099290780142,0.16312056737588654,0.8014184397163121,0.9645390070921985,0.03546099290780142
10049,825,638,187,773,52,0.7733333333333333,0.22666666666666666,0.936969696969697,0.06303030303030303,791,62,375,354,783,8,0.07838179519595449,0.4740834386852086,0.4475347661188369,0.9898862199747156,0.010113780025284451
10050,1050,842,208,989,61,0.8019047619047619,0.1980952380952381,0.9419047619047619,0.058095238095238096,666,98,272,296,665,1,0.14714714714714713,0.4084084084084084,0.4444444444444444,0.9984984984984985,0.0015015015015015015
10051,247,192,55,200,47,0.7773279352226721,0.22267206477732793,0.8097165991902834,0.1902834008097166,154,5,23,126,145,9,0.032467532467532464,0.14935064935064934,0.8181818181818182,0.9415584415584416,0.05844155844155844
10052,2056,1779,277,1998,58,0.8652723735408561,0.13472762645914396,0.9717898832684825,0.02821011673151751,1122,40,542,540,1117,5,0.035650623885918005,0.483065953654189,0.48128342245989303,0.9955436720142602,0.004456327985739751
10053,409,365,44,367,42,0.8924205378973105,0.10757946210268948,0.8973105134474327,0.10268948655256724,197,5,23,169,189,8,0.025380710659898477,0.116751269035533,0.8578680203045685,0.9593908629441624,0.04060913705583756
10054,1130,1005,125,1095,35,0.8893805309734514,0.11061946902654868,0.9690265486725663,0.030973451327433628,1140,56,553,531,1136,4,0.04912280701754386,0.4850877192982456,0.46578947368421053,0.9964912280701754,0.0035087719298245615
10055,221,180,41,187,34,0.8144796380090498,0.18552036199095023,0.8461538461538461,0.15384615384615385,168,4,25,139,161,7,0.023809523809523808,0.1488095238095238,0.8273809523809523,0.9583333333333334,0.041666666666666664
10056,417,355,62,363,54,0.8513189448441247,0.1486810551558753,0.8705035971223022,0.12949640287769784,180,5,24,151,170,10,0.027777777777777776,0.13333333333333333,0.8388888888888889,0.9444444444444444,0.05555555555555555
10057,1089,886,203,1029,60,0.8135904499540864,0.18640955004591367,0.9449035812672176,0.05509641873278237,1031,59,483,489,1022,9,0.05722599418040737,0.4684772065955383,0.4742967992240543,0.991270611057226,0.008729388942774006
10058,353,293,60,301,52,0.830028328611898,0.16997167138810199,0.8526912181303116,0.14730878186968838,160,5,24,131,153,7,0.03125,0.15,0.81875,0.95625,0.04375
10059,771,658,113,732,39,0.8534370946822308,0.14656290531776914,0.9494163424124513,0.05058365758754864,1095,53,520,522,1090,5,0.048401826484018265,0.4748858447488584,0.4767123287671233,0.9954337899543378,0.0045662100456621
10060,1060,829,231,997,63,0.7820754716981132,0.2179245283018868,0.940566037735849,0.059433962264150944,721,77,297,347,720,1,0.10679611650485436,0.4119278779472954,0.4812760055478502,0.9986130374479889,0.0013869625520110957
10061,193,148,45,153,40,0.7668393782383419,0.23316062176165803,0.7927461139896373,0.20725388601036268,154,4,24,126,149,5,0.025974025974025976,0.15584415584415584,0.8181818181818182,0.9675324675324676,0.032467532467532464
10062,355,319,36,319,36,0.8985915492957747,0.10140845070422536,0.8985915492957747,0.10140845070422536,139,5,23,111,134,5,0.03597122302158273,0.16546762589928057,0.7985611510791367,0.9640287769784173,0.03597122302158273
10063,1728,1472,256,1661,67,0.8518518518518519,0.14814814814814814,0.9612268518518519,0.03877314814814815,1433,44,682,707,1427,6,0.030704815073272853,0.47592463363572923,0.4933705512909979,0.9958129797627355,0.00418702023726448
10064,279,232,47,240,39,0.8315412186379928,0.16845878136200718,0.8602150537634409,0.13978494623655913,120,4,24,92,114,6,0.03333333333333333,0.2,0.7666666666666667,0.95,0.05
10065,194,143,51,151,43,0.7371134020618557,0.26288659793814434,0.7783505154639175,0.22164948453608246,155,5,24,126,146,9,0.03225806451612903,0.15483870967741936,0.8129032258064516,0.9419354838709677,0.05806451612903226
10066,1780,1618,162,1738,42,0.9089887640449438,0.09101123595505618,0.9764044943820225,0.02359550561797753,1569,56,775,738,1566,3,0.035691523263224986,0.49394518801784576,0.47036328871892924,0.9980879541108987,0.0019120458891013384
10067,215,165,50,170,45,0.7674418604651163,0.23255813953488372,0.7906976744186046,0.20930232558139536,154,5,23,126,142,12,0.032467532467532464,0.14935064935064934,0.8181818181818182,0.922077922077922,0.07792207792207792
10068,218,164,54,169,49,0.7522935779816514,0.24770642201834864,0.7752293577981652,0.22477064220183487,154,5,23,126,146,8,0.032467532467532464,0.14935064935064934,0.8181818181818182,0.948051948051948,0.05194805194805195
10069,908,782,126,866,42,0.8612334801762115,0.13876651982378854,0.9537444933920705,0.046255506607929514,1262,33,615,614,1256,6,0.026148969889064975,0.4873217115689382,0.4865293185419968,0.9952456418383518,0.004754358161648178
10070,552,463,89,530,22,0.8387681159420289,0.161231884057971,0.9601449275362319,0.03985507246376811,1117,66,536,515,1110,7,0.05908683974932856,0.4798567591763653,0.4610564010743062,0.9937332139659804,0.006266786034019696
10071,1257,1049,208,1192,65,0.8345266507557677,0.1654733492442323,0.9482895783611774,0.05171042163882259,1027,60,489,478,1022,5,0.05842259006815969,0.4761441090555015,0.46543330087633883,0.9951314508276533,0.004868549172346641
10072,1309,1061,248,1252,57,0.8105423987776929,0.1894576012223071,0.9564553093964858,0.04354469060351413,1078,49,511,518,1071,7,0.045454545454545456,0.474025974025974,0.4805194805194805,0.9935064935064936,0.006493506493506494
10073,352,302,50,308,44,0.8579545454545454,0.14204545454545456,0.875,0.125,121,5,23,93,114,7,0.04132231404958678,0.19008264462809918,0.768595041322314,0.9421487603305785,0.05785123966942149
10074,889,757,132,863,26,0.8515185601799775,0.1484814398200225,0.9707536557930259,0.02924634420697413,1049,49,519,481,1045,4,0.04671115347950429,0.4947569113441373,0.45853193517635843,0.996186844613918,0.0038131553860819827
10075,950,779,171,899,51,0.82,0.18,0.9463157894736842,0.05368421052631579,1134,67,520,547,1126,8,0.059082892416225746,0.4585537918871252,0.48236331569664903,0.9929453262786596,0.007054673721340388
10076,4853,4146,707,3964,889,0.8543169173706986,0.14568308262930146,0.8168143416443437,0.18318565835565628,1007,125,267,615,701,306,0.12413108242303873,0.26514399205561073,0.6107249255213505,0.6961271102284012,0.3038728897715988
10077,410,365,45,368,42,0.8902439024390244,0.10975609756097561,0.8975609756097561,0.1024390243902439,187,5,22,160,177,10,0.026737967914438502,0.11764705882352941,0.8556149732620321,0.946524064171123,0.053475935828877004
10078,544,496,48,497,47,0.9117647058823529,0.08823529411764706,0.9136029411764706,0.08639705882352941,201,5,23,173,191,10,0.024875621890547265,0.11442786069651742,0.8606965174129353,0.9502487562189055,0.04975124378109453
10079,426,364,62,370,56,0.8544600938967136,0.14553990610328638,0.8685446009389671,0.13145539906103287,171,5,23,143,162,9,0.029239766081871343,0.13450292397660818,0.8362573099415205,0.9473684210526315,0.05263157894736842
10080,247,75,172,143,104,0.30364372469635625,0.6963562753036437,0.5789473684210527,0.42105263157894735,126,0,39,87,119,7,0.0,0.30952380952380953,0.6904761904761905,0.9444444444444444,0.05555555555555555
10081,565,492,73,549,16,0.8707964601769912,0.12920353982300886,0.9716814159292035,0.02831858407079646,1067,54,507,506,1061,6,0.05060918462980318,0.4751640112464855,0.4742268041237113,0.9943767572633552,0.005623242736644799
10082,942,732,210,881,61,0.7770700636942676,0.2229299363057325,0.935244161358811,0.06475583864118896,674,103,262,309,671,3,0.15281899109792285,0.3887240356083086,0.45845697329376855,0.9955489614243324,0.004451038575667656
10083,846,740,106,807,39,0.8747044917257684,0.12529550827423167,0.9539007092198581,0.04609929078014184,640,46,308,286,635,5,0.071875,0.48125,0.446875,0.9921875,0.0078125
10084,4851,4146,705,3962,889,0.8546691403834261,0.1453308596165739,0.8167388167388168,0.18326118326118326,1001,125,264,612,696,305,0.12487512487512488,0.26373626373626374,0.6113886113886113,0.6953046953046953,0.3046953046953047
10085,539,482,57,482,57,0.8942486085343229,0.10575139146567718,0.8942486085343229,0.10575139146567718,177,4,24,149,169,8,0.022598870056497175,0.13559322033898305,0.8418079096045198,0.9548022598870056,0.04519774011299435
10086,342,292,50,301,41,0.8538011695906432,0.14619883040935672,0.8801169590643275,0.11988304093567251,158,5,24,129,151,7,0.03164556962025317,0.1518987341772152,0.8164556962025317,0.9556962025316456,0.04430379746835443
10087,246,212,34,220,26,0.8617886178861789,0.13821138211382114,0.8943089430894309,0.10569105691056911,150,5,23,122,142,8,0.03333333333333333,0.15333333333333332,0.8133333333333334,0.9466666666666667,0.05333333333333334
10088,351,297,54,298,53,0.8461538461538461,0.15384615384615385,0.8490028490028491,0.150997150997151,193,5,23,165,184,9,0.025906735751295335,0.11917098445595854,0.8549222797927462,0.9533678756476683,0.046632124352331605
10089,1723,1480,243,1672,51,0.8589669181659896,0.14103308183401045,0.9704004643064422,0.02959953569355775,1002,68,479,455,998,4,0.06786427145708583,0.4780439121756487,0.4540918163672655,0.9960079840319361,0.003992015968063872
10090,1278,936,342,1124,154,0.7323943661971831,0.2676056338028169,0.8794992175273866,0.12050078247261346,636,66,183,387,533,103,0.10377358490566038,0.28773584905660377,0.6084905660377359,0.8380503144654088,0.1619496855345912
10091,802,674,128,747,55,0.8403990024937655,0.1596009975062344,0.9314214463840399,0.0685785536159601,522,70,223,229,510,12,0.13409961685823754,0.4272030651340996,0.4386973180076628,0.9770114942528736,0.022988505747126436
10092,259,222,37,229,30,0.8571428571428571,0.14285714285714285,0.8841698841698842,0.11583011583011583,173,4,24,145,161,12,0.023121387283236993,0.13872832369942195,0.838150289017341,0.930635838150289,0.06936416184971098
10093,987,767,220,926,61,0.7771023302938197,0.22289766970618036,0.9381965552178319,0.06180344478216818,518,82,228,208,517,1,0.1583011583011583,0.44015444015444016,0.4015444015444015,0.9980694980694981,0.0019305019305019305
10094,1867,1677,190,1806,61,0.8982324584895555,0.10176754151044456,0.967327262988752,0.03267273701124799,1121,73,526,522,1115,6,0.06512042818911686,0.46922390722569135,0.4656556645851918,0.9946476360392507,0.0053523639607493305
10095,228,198,30,205,23,0.868421052631579,0.13157894736842105,0.8991228070175439,0.10087719298245613,166,4,24,138,156,10,0.024096385542168676,0.14457831325301204,0.8313253012048193,0.9397590361445783,0.060240963855421686
10096,1550,1353,197,1519,31,0.8729032258064516,0.1270967741935484,0.98,0.02,1124,66,537,521,1120,4,0.05871886120996441,0.4777580071174377,0.46352313167259784,0.99644128113879,0.0035587188612099642
10097,984,798,186,940,44,0.8109756097560976,0.18902439024390244,0.9552845528455285,0.044715447154471545,642,74,262,306,641,1,0.11526479750778816,0.40809968847352024,0.4766355140186916,0.9984423676012462,0.001557632398753894
10098,1166,992,174,1137,29,0.8507718696397941,0.14922813036020582,0.9751286449399656,0.024871355060034305,2117,51,1021,1045,2110,7,0.024090694378837978,0.48228625413320736,0.49362305148795466,0.9966934341048653,0.0033065658951346244
10099,1799,1500,299,1706,93,0.8337965536409117,0.16620344635908837,0.9483046136742634,0.05169538632573652,1166,40,558,568,1159,7,0.03430531732418525,0.47855917667238423,0.48713550600343053,0.9939965694682675,0.006003430531732418
10100,254,219,35,220,34,0.8622047244094488,0.1377952755905512,0.8661417322834646,0.13385826771653545,149,5,23,121,140,9,0.03355704697986577,0.15436241610738255,0.8120805369127517,0.9395973154362416,0.06040268456375839
10101,1011,795,216,952,59,0.7863501483679525,0.21364985163204747,0.9416419386745796,0.058358061325420374,548,107,242,199,547,1,0.19525547445255476,0.4416058394160584,0.36313868613138683,0.9981751824817519,0.0018248175182481751
10102,417,365,52,364,53,0.8752997601918465,0.12470023980815348,0.8729016786570744,0.12709832134292565,133,5,23,105,125,8,0.03759398496240601,0.17293233082706766,0.7894736842105263,0.9398496240601504,0.06015037593984962
10103,1504,1287,217,1449,55,0.855718085106383,0.14428191489361702,0.9634308510638298,0.036569148936170214,1126,67,534,525,1120,6,0.05950266429840142,0.47424511545293074,0.46625222024866786,0.9946714031971581,0.0053285968028419185
10104,349,111,238,189,160,0.31805157593123207,0.6819484240687679,0.5415472779369628,0.4584527220630373,124,1,52,71,122,2,0.008064516129032258,0.41935483870967744,0.5725806451612904,0.9838709677419355,0.016129032258064516
10105,261,76,185,129,132,0.29118773946360155,0.7088122605363985,0.4942528735632184,0.5057471264367817,101,2,40,59,98,3,0.019801980198019802,0.39603960396039606,0.5841584158415841,0.9702970297029703,0.0297029702970297
10106,2056,1779,277,1998,58,0.8652723735408561,0.13472762645914396,0.9717898832684825,0.02821011673151751,1122,40,542,540,1117,5,0.035650623885918005,0.483065953654189,0.48128342245989303,0.9955436720142602,0.004456327985739751
10107,781,611,170,734,47,0.7823303457106274,0.2176696542893726,0.939820742637644,0.06017925736235595,713,91,307,315,712,1,0.1276297335203366,0.4305750350631136,0.4417952314165498,0.9985974754558204,0.001402524544179523
10108,894,733,161,838,56,0.819910514541387,0.18008948545861297,0.9373601789709173,0.06263982102908278,1246,44,593,609,1239,7,0.03531300160513644,0.47592295345104335,0.4887640449438202,0.9943820224719101,0.0056179775280898875
10109,352,302,50,308,44,0.8579545454545454,0.14204545454545456,0.875,0.125,121,5,23,93,114,7,0.04132231404958678,0.19008264462809918,0.768595041322314,0.9421487603305785,0.05785123966942149
10110,253,76,177,143,110,0.30039525691699603,0.6996047430830039,0.5652173913043478,0.43478260869565216,119,0,47,72,112,7,0.0,0.3949579831932773,0.6050420168067226,0.9411764705882353,0.058823529411764705
10111,1093,930,163,1065,28,0.8508691674290942,0.14913083257090576,0.9743824336688015,0.025617566331198535,1581,63,753,765,1578,3,0.03984819734345351,0.476280834914611,0.4838709677419355,0.9981024667931688,0.0018975332068311196
10112,432,387,45,389,43,0.8958333333333334,0.10416666666666667,0.9004629629629629,0.09953703703703703,160,5,23,132,154,6,0.03125,0.14375,0.825,0.9625,0.0375
10113,867,702,165,832,35,0.8096885813148789,0.1903114186851211,0.9596309111880046,0.040369088811995385,571,80,251,240,569,2,0.14010507880910683,0.4395796847635727,0.4203152364273205,0.9964973730297724,0.0035026269702276708
10114,2104,1800,304,2018,86,0.8555133079847909,0.1444866920152091,0.9591254752851711,0.0408745247148289,1133,68,558,507,1126,7,0.06001765225066196,0.49249779346866723,0.4474845542806708,0.9938217122683142,0.00617828773168579
10115,1215,1087,128,1177,38,0.8946502057613168,0.10534979423868313,0.968724279835391,0.031275720164609055,1189,80,554,555,1184,5,0.0672834314550042,0.4659377628259041,0.4667788057190917,0.9957947855340622,0.004205214465937763
10116,468,417,51,417,51,0.8910256410256411,0.10897435897435898,0.8910256410256411,0.10897435897435898,160,4,24,132,151,9,0.025,0.15,0.825,0.94375,0.05625
10117,482,443,39,449,33,0.9190871369294605,0.08091286307053942,0.9315352697095436,0.06846473029045644,180,5,23,152,171,9,0.027777777777777776,0.12777777777777777,0.8444444444444444,0.95,0.05
10118,917,785,132,880,37,0.8560523446019629,0.14394765539803708,0.9596510359869138,0.04034896401308615,2264,58,1100,1106,2256,8,0.02561837455830389,0.48586572438162545,0.48851590106007065,0.9964664310954063,0.0035335689045936395
10119,307,72,235,167,140,0.23452768729641693,0.7654723127035831,0.5439739413680782,0.4560260586319218,139,2,47,90,136,3,0.014388489208633094,0.3381294964028777,0.6474820143884892,0.9784172661870504,0.02158273381294964
10120,1394,1077,317,1306,88,0.772596843615495,0.22740315638450503,0.9368723098995696,0.06312769010043041,1209,50,574,585,1202,7,0.0413564929693962,0.4747725392886683,0.4838709677419355,0.9942100909842845,0.005789909015715467
10121,1448,1234,214,1401,47,0.8522099447513812,0.1477900552486188,0.9675414364640884,0.0324585635359116,1210,55,565,590,1202,8,0.045454545454545456,0.4669421487603306,0.48760330578512395,0.9933884297520661,0.006611570247933884
10122,240,181,59,181,59,0.7541666666666667,0.24583333333333332,0.7541666666666667,0.24583333333333332,185,4,24,157,176,9,0.021621621621621623,0.12972972972972974,0.8486486486486486,0.9513513513513514,0.04864864864864865
10123,270,222,48,230,40,0.8222222222222222,0.17777777777777778,0.8518518518518519,0.14814814814814814,164,5,24,135,157,7,0.03048780487804878,0.14634146341463414,0.823170731707317,0.9573170731707317,0.042682926829268296
10124,483,444,39,449,34,0.9192546583850931,0.08074534161490683,0.9296066252587992,0.07039337474120083,192,5,23,164,181,11,0.026041666666666668,0.11979166666666667,0.8541666666666666,0.9427083333333334,0.057291666666666664
10125,1333,1130,203,1254,79,0.8477119279819955,0.1522880720180045,0.940735183795949,0.05926481620405101,1004,58,457,489,997,7,0.05776892430278884,0.4551792828685259,0.48705179282868527,0.9930278884462151,0.0069721115537848604
10126,387,333,54,341,46,0.8604651162790697,0.13953488372093023,0.8811369509043928,0.11886304909560723,160,5,24,131,152,8,0.03125,0.15,0.81875,0.95,0.05
10127,273,71,202,147,126,0.2600732600732601,0.73992673992674,0.5384615384615384,0.46153846153846156,111,1,44,66,108,3,0.009009009009009009,0.3963963963963964,0.5945945945945946,0.972972972972973,0.02702702702702703
10128,1323,1093,230,1264,59,0.8261526832955405,0.17384731670445955,0.9554043839758125,0.044595616024187455,1050,69,503,478,1043,7,0.06571428571428571,0.47904761904761906,0.4552380952380952,0.9933333333333333,0.006666666666666667
10129,431,386,45,388,43,0.8955916473317865,0.10440835266821345,0.9002320185614849,0.09976798143851508,158,5,23,130,148,10,0.03164556962025317,0.14556962025316456,0.8227848101265823,0.9367088607594937,0.06329113924050633
10130,1089,887,202,1036,53,0.8145087235996327,0.1854912764003673,0.9513314967860422,0.048668503213957756,1096,76,514,506,1089,7,0.06934306569343066,0.46897810218978103,0.46167883211678834,0.9936131386861314,0.006386861313868613
10131,652,575,77,639,13,0.8819018404907976,0.11809815950920245,0.9800613496932515,0.019938650306748466,1202,79,561,562,1195,7,0.06572379367720466,0.4667221297836938,0.46755407653910147,0.9941763727121464,0.005823627287853577
10132,1352,1152,200,1284,68,0.8520710059171598,0.14792899408284024,0.9497041420118343,0.05029585798816568,1555,50,746,759,1546,9,0.03215434083601286,0.4797427652733119,0.48810289389067524,0.9942122186495177,0.005787781350482315
10133,814,665,149,781,33,0.816953316953317,0.18304668304668303,0.9594594594594594,0.04054054054054054,1064,60,502,502,1059,5,0.05639097744360902,0.4718045112781955,0.4718045112781955,0.9953007518796992,0.004699248120300752
10134,1519,1215,304,1453,66,0.7998683344305464,0.20013166556945358,0.956550362080316,0.043449637919684,1168,52,544,572,1163,5,0.04452054794520548,0.4657534246575342,0.4897260273972603,0.9957191780821918,0.004280821917808219
10135,1665,1415,250,1586,79,0.8498498498498499,0.15015015015015015,0.9525525525525526,0.04744744744744745,2153,49,1043,1061,2146,7,0.02275894101254064,0.48444031583836505,0.4928007431490943,0.9967487227124942,0.003251277287505806
10136,275,225,50,232,43,0.8181818181818182,0.18181818181818182,0.8436363636363636,0.15636363636363637,155,4,25,126,151,4,0.025806451612903226,0.16129032258064516,0.8129032258064516,0.9741935483870968,0.025806451612903226
10137,797,667,130,747,50,0.8368883312421581,0.16311166875784192,0.9372647427854455,0.06273525721455459,1036,55,468,513,1030,6,0.05308880308880309,0.4517374517374517,0.4951737451737452,0.9942084942084942,0.005791505791505791
10138,1089,899,190,1045,44,0.8255280073461891,0.17447199265381083,0.9595959595959596,0.04040404040404041,1003,68,480,455,993,10,0.06779661016949153,0.4785643070787637,0.45363908275174475,0.9900299102691924,0.009970089730807577
10139,420,360,60,367,53,0.8571428571428571,0.14285714285714285,0.8738095238095238,0.1261904761904762,192,5,23,164,184,8,0.026041666666666668,0.11979166666666667,0.8541666666666666,0.9583333333333334,0.041666666666666664
10140,965,841,124,931,34,0.8715025906735752,0.12849740932642487,0.9647668393782384,0.035233160621761656,2108,43,998,1067,2101,7,0.020398481973434534,0.47343453510436434,0.5061669829222012,0.9966793168880456,0.003320683111954459
10141,269,97,172,134,135,0.36059479553903345,0.6394052044609665,0.49814126394052044,0.5018587360594795,104,0,44,60,102,2,0.0,0.4230769230769231,0.5769230769230769,0.9807692307692307,0.019230769230769232
10142,341,289,52,297,44,0.8475073313782991,0.15249266862170088,0.8709677419354839,0.12903225806451613,176,4,25,147,167,9,0.022727272727272728,0.14204545454545456,0.8352272727272727,0.9488636363636364,0.05113636363636364
10143,1247,1004,243,1182,65,0.8051323175621492,0.19486768243785085,0.9478748997594226,0.052125100240577385,1005,66,478,461,999,6,0.06567164179104477,0.47562189054726367,0.45870646766169154,0.9940298507462687,0.005970149253731343
10144,1390,1166,224,1320,70,0.8388489208633093,0.16115107913669063,0.9496402877697842,0.050359712230215826,1090,43,526,521,1085,5,0.03944954128440367,0.48256880733944957,0.4779816513761468,0.9954128440366973,0.0045871559633027525
10145,1386,1201,185,1340,46,0.8665223665223665,0.13347763347763347,0.9668109668109668,0.03318903318903319,1296,53,634,609,1291,5,0.04089506172839506,0.48919753086419754,0.4699074074074074,0.996141975308642,0.0038580246913580245
10146,1137,955,182,1103,34,0.8399296394019349,0.1600703605980651,0.9700967458223395,0.02990325417766051,1287,48,597,642,1283,4,0.037296037296037296,0.46386946386946387,0.4988344988344988,0.9968919968919969,0.003108003108003108
10147,307,101,206,159,148,0.3289902280130293,0.6710097719869706,0.5179153094462541,0.4820846905537459,105,0,35,70,100,5,0.0,0.3333333333333333,0.6666666666666666,0.9523809523809523,0.047619047619047616
10148,228,202,26,205,23,0.8859649122807017,0.11403508771929824,0.8991228070175439,0.10087719298245613,140,5,23,112,136,4,0.03571428571428571,0.16428571428571428,0.8,0.9714285714285714,0.02857142857142857
10149,124,78,46,87,37,0.6290322580645161,0.3709677419354839,0.7016129032258065,0.29838709677419356,159,5,24,130,153,6,0.031446540880503145,0.1509433962264151,0.8176100628930818,0.9622641509433962,0.03773584905660377
10150,222,184,38,191,31,0.8288288288288288,0.17117117117117117,0.8603603603603603,0.13963963963963963,186,5,23,158,178,8,0.026881720430107527,0.12365591397849462,0.8494623655913979,0.956989247311828,0.043010752688172046
10151,1822,1588,234,1752,70,0.8715697036223929,0.12843029637760703,0.9615806805708014,0.038419319429198684,1109,58,530,521,1103,6,0.05229936880072137,0.47790802524797116,0.4697926059513075,0.9945897204688909,0.005410279531109108
10152,237,194,43,193,44,0.8185654008438819,0.18143459915611815,0.8143459915611815,0.18565400843881857,144,5,23,116,138,6,0.034722222222222224,0.1597222222222222,0.8055555555555556,0.9583333333333334,0.041666666666666664
10153,351,297,54,298,53,0.8461538461538461,0.15384615384615385,0.8490028490028491,0.150997150997151,192,5,23,164,184,8,0.026041666666666668,0.11979166666666667,0.8541666666666666,0.9583333333333334,0.041666666666666664
10154,841,702,139,802,39,0.8347205707491082,0.16527942925089179,0.9536266349583828,0.04637336504161712,583,86,247,250,582,1,0.14751286449399656,0.4236706689536878,0.4288164665523156,0.9982847341337907,0.0017152658662092624
10155,1176,1006,170,1145,31,0.8554421768707483,0.1445578231292517,0.9736394557823129,0.026360544217687076,1583,52,760,771,1580,3,0.032849020846494,0.4801010739102969,0.48704990524320907,0.998104864181933,0.0018951358180669614
10156,883,774,109,852,31,0.8765571913929785,0.12344280860702152,0.9648924122310306,0.035107587768969425,1201,76,578,547,1194,7,0.06328059950041633,0.48126561199000834,0.45545378850957535,0.9941715237302248,0.005828476269775187
10157,1573,1350,223,1516,57,0.8582326764144946,0.1417673235855054,0.9637635092180546,0.036236490781945324,1809,46,873,890,1805,4,0.02542841348811498,0.48258706467661694,0.4919845218352681,0.9977888336097291,0.002211166390270868
10158,410,365,45,368,42,0.8902439024390244,0.10975609756097561,0.8975609756097561,0.1024390243902439,183,5,23,155,174,9,0.0273224043715847,0.12568306010928962,0.8469945355191257,0.9508196721311475,0.04918032786885246
10159,1867,1677,190,1806,61,0.8982324584895555,0.10176754151044456,0.967327262988752,0.03267273701124799,1121,73,526,522,1115,6,0.06512042818911686,0.46922390722569135,0.4656556645851918,0.9946476360392507,0.0053523639607493305
10160,318,263,55,263,55,0.8270440251572327,0.17295597484276728,0.8270440251572327,0.17295597484276728,140,5,23,112,136,4,0.03571428571428571,0.16428571428571428,0.8,0.9714285714285714,0.02857142857142857
10161,835,654,181,788,47,0.7832335329341318,0.21676646706586827,0.9437125748502994,0.0562874251497006,666,80,285,301,665,1,0.12012012012012012,0.42792792792792794,0.4519519519519519,0.9984984984984985,0.0015015015015015015
10162,448,383,65,390,58,0.8549107142857143,0.14508928571428573,0.8705357142857143,0.12946428571428573,148,5,24,119,141,7,0.033783783783783786,0.16216216216216217,0.8040540540540541,0.9527027027027027,0.0472972972972973
10163,1601,1377,224,1544,57,0.8600874453466584,0.13991255465334165,0.9643972517176764,0.03560274828232355,1232,51,585,596,1226,6,0.041396103896103896,0.47483766233766234,0.4837662337662338,0.9951298701298701,0.00487012987012987
10164,1594,1382,212,1554,40,0.8670012547051443,0.1329987452948557,0.9749058971141782,0.025094102885821833,982,44,472,466,977,5,0.04480651731160896,0.48065173116089616,0.4745417515274949,0.994908350305499,0.0050916496945010185
10165,319,263,56,269,50,0.8244514106583072,0.1755485893416928,0.8432601880877743,0.15673981191222572,185,5,23,157,175,10,0.02702702702702703,0.12432432432432433,0.8486486486486486,0.9459459459459459,0.05405405405405406
10166,288,92,196,157,131,0.3194444444444444,0.6805555555555556,0.5451388888888888,0.4548611111111111,114,1,53,60,111,3,0.008771929824561403,0.4649122807017544,0.5263157894736842,0.9736842105263158,0.02631578947368421
10167,261,211,50,217,44,0.8084291187739464,0.19157088122605365,0.8314176245210728,0.1685823754789272,145,5,23,117,138,7,0.034482758620689655,0.15862068965517243,0.8068965517241379,0.9517241379310345,0.04827586206896552
10168,310,264,46,264,46,0.8516129032258064,0.14838709677419354,0.8516129032258064,0.14838709677419354,159,5,23,131,151,8,0.031446540880503145,0.14465408805031446,0.8238993710691824,0.949685534591195,0.050314465408805034
10169,773,631,142,725,48,0.8163001293661061,0.18369987063389392,0.9379042690815006,0.062095730918499355,1297,63,621,613,1292,5,0.04857363145720894,0.47879722436391675,0.4726291441788743,0.9961449498843485,0.0038550501156515036
10170,278,88,190,134,144,0.31654676258992803,0.6834532374100719,0.48201438848920863,0.5179856115107914,92,0,29,63,91,1,0.0,0.31521739130434784,0.6847826086956522,0.9891304347826086,0.010869565217391304
10171,222,187,35,195,27,0.8423423423423423,0.15765765765765766,0.8783783783783784,0.12162162162162163,175,4,24,147,168,7,0.022857142857142857,0.13714285714285715,0.84,0.96,0.04
10172,1701,1467,234,1621,80,0.8624338624338624,0.13756613756613756,0.9529688418577308,0.047031158142269255,1029,63,491,475,1026,3,0.061224489795918366,0.4771622934888241,0.4616132167152575,0.9970845481049563,0.0029154518950437317
10173,1175,987,188,1130,45,0.84,0.16,0.9617021276595744,0.03829787234042553,1370,74,649,647,1359,11,0.05401459854014599,0.4737226277372263,0.47226277372262776,0.9919708029197081,0.008029197080291971
10174,520,377,143,486,34,0.725,0.275,0.9346153846153846,0.06538461538461539,1009,49,477,483,1002,7,0.048562933597621406,0.47274529236868185,0.4786917740336967,0.9930624380574826,0.006937561942517344
10175,274,225,49,231,43,0.8211678832116789,0.17883211678832117,0.843065693430657,0.15693430656934307,155,4,24,127,147,8,0.025806451612903226,0.15483870967741936,0.8193548387096774,0.9483870967741935,0.05161290322580645
10176,296,254,42,251,45,0.8581081081081081,0.14189189189189189,0.847972972972973,0.15202702702702703,173,4,24,145,165,8,0.023121387283236993,0.13872832369942195,0.838150289017341,0.953757225433526,0.046242774566473986
10177,320,274,46,283,37,0.85625,0.14375,0.884375,0.115625,185,5,24,156,175,10,0.02702702702702703,0.12972972972972974,0.8432432432432433,0.9459459459459459,0.05405405405405406
10178,460,407,53,412,48,0.8847826086956522,0.11521739130434783,0.8956521739130435,0.10434782608695652,175,5,23,147,168,7,0.02857142857142857,0.13142857142857142,0.84,0.96,0.04
10179,295,247,48,254,41,0.8372881355932204,0.16271186440677965,0.8610169491525423,0.13898305084745763,155,4,24,127,147,8,0.025806451612903226,0.15483870967741936,0.8193548387096774,0.9483870967741935,0.05161290322580645
10180,1112,915,197,1048,64,0.822841726618705,0.17715827338129497,0.9424460431654677,0.05755395683453238,758,52,447,259,756,2,0.06860158311345646,0.5897097625329816,0.341688654353562,0.9973614775725593,0.002638522427440633
10181,1576,1411,165,1529,47,0.8953045685279187,0.10469543147208121,0.9701776649746193,0.02982233502538071,1081,63,520,498,1077,4,0.058279370952821465,0.48103607770582796,0.4606845513413506,0.996299722479186,0.0037002775208140612
10182,339,260,79,264,75,0.7669616519174042,0.23303834808259588,0.7787610619469026,0.22123893805309736,122,5,23,94,116,6,0.040983606557377046,0.1885245901639344,0.7704918032786885,0.9508196721311475,0.04918032786885246
10183,1357,1142,215,1289,68,0.8415622697126013,0.1584377302873987,0.9498894620486367,0.050110537951363304,1299,54,627,618,1293,6,0.04157043879907621,0.48267898383371827,0.47575057736720555,0.9953810623556582,0.004618937644341801
10184,305,244,61,250,55,0.8,0.2,0.819672131147541,0.18032786885245902,156,5,23,128,148,8,0.03205128205128205,0.14743589743589744,0.8205128205128205,0.9487179487179487,0.05128205128205128
10185,261,211,50,217,44,0.8084291187739464,0.19157088122605365,0.8314176245210728,0.1685823754789272,145,5,23,117,138,7,0.034482758620689655,0.15862068965517243,0.8068965517241379,0.9517241379310345,0.04827586206896552
10186,933,762,171,863,70,0.8167202572347267,0.1832797427652733,0.92497320471597,0.07502679528403002,985,52,471,462,980,5,0.05279187817258883,0.4781725888324873,0.46903553299492384,0.9949238578680203,0.005076142131979695
10187,1248,1117,131,1198,50,0.8950320512820513,0.10496794871794872,0.9599358974358975,0.04006410256410257,2333,67,1128,1138,2323,10,0.0287183883411916,0.48349764252036004,0.48778396913844835,0.9957136733819117,0.0042863266180882984
10188,1335,1151,184,1277,58,0.8621722846441947,0.13782771535580524,0.9565543071161049,0.04344569288389513,2095,54,1003,1038,2089,6,0.025775656324582338,0.47875894988066825,0.4954653937947494,0.9971360381861575,0.002863961813842482
10189,289,254,35,258,31,0.8788927335640139,0.12110726643598616,0.8927335640138409,0.10726643598615918,159,4,25,130,151,8,0.025157232704402517,0.15723270440251572,0.8176100628930818,0.949685534591195,0.050314465408805034
10190,476,418,58,424,52,0.8781512605042017,0.12184873949579832,0.8907563025210085,0.1092436974789916,151,4,24,123,143,8,0.026490066225165563,0.15894039735099338,0.8145695364238411,0.9470198675496688,0.052980132450331126
10191,228,184,44,190,38,0.8070175438596491,0.19298245614035087,0.8333333333333334,0.16666666666666666,165,5,23,137,158,7,0.030303030303030304,0.1393939393939394,0.8303030303030303,0.9575757575757575,0.04242424242424243
10192,2176,1927,249,2099,77,0.8855698529411765,0.11443014705882353,0.9646139705882353,0.035386029411764705,1123,54,541,528,1117,6,0.04808548530721282,0.4817453250222618,0.4701691896705254,0.9946571682991986,0.005342831700801425
10193,303,92,211,170,133,0.30363036303630364,0.6963696369636964,0.5610561056105611,0.4389438943894389,107,0,50,57,102,5,0.0,0.4672897196261682,0.5327102803738317,0.9532710280373832,0.04672897196261682
10194,850,675,175,796,54,0.7941176470588235,0.20588235294117646,0.9364705882352942,0.06352941176470588,1189,67,559,563,1179,10,0.056349873843566024,0.4701429772918419,0.4735071488645921,0.9915895710681245,0.008410428931875526
10195,1047,823,224,974,73,0.7860553963705826,0.2139446036294174,0.9302769818529131,0.06972301814708691,642,96,272,274,641,1,0.14953271028037382,0.4236760124610592,0.42679127725856697,0.9984423676012462,0.001557632398753894
10196,291,243,48,247,44,0.8350515463917526,0.16494845360824742,0.8487972508591065,0.15120274914089346,189,5,23,161,178,11,0.026455026455026454,0.12169312169312169,0.8518518518518519,0.9417989417989417,0.0582010582010582
10197,278,79,199,139,139,0.2841726618705036,0.7158273381294964,0.5,0.5,103,1,41,61,101,2,0.009708737864077669,0.39805825242718446,0.5922330097087378,0.9805825242718447,0.019417475728155338
10198,1184,960,224,1115,69,0.8108108108108109,0.1891891891891892,0.941722972972973,0.05827702702702703,1696,47,805,844,1684,12,0.027712264150943397,0.47464622641509435,0.49764150943396224,0.9929245283018868,0.007075471698113208
10199,1199,959,240,1140,59,0.7998331943286072,0.20016680567139283,0.950792326939116,0.04920767306088407,1246,71,595,580,1238,8,0.05698234349919743,0.47752808988764045,0.4654895666131621,0.9935794542536116,0.006420545746388443
10200,1665,1415,250,1586,79,0.8498498498498499,0.15015015015015015,0.9525525525525526,0.04744744744744745,2153,49,1043,1061,2146,7,0.02275894101254064,0.48444031583836505,0.4928007431490943,0.9967487227124942,0.003251277287505806
10201,313,275,38,283,30,0.8785942492012779,0.12140575079872204,0.9041533546325878,0.09584664536741214,149,5,23,121,142,7,0.03355704697986577,0.15436241610738255,0.8120805369127517,0.9530201342281879,0.04697986577181208
10202,1029,866,163,971,58,0.8415937803692906,0.15840621963070942,0.9436345966958212,0.056365403304178816,955,49,455,451,950,5,0.05130890052356021,0.47643979057591623,0.4722513089005236,0.9947643979057592,0.005235602094240838
10203,1174,981,193,1124,50,0.8356047700170358,0.1643952299829642,0.9574105621805792,0.04258943781942078,1389,65,688,636,1382,7,0.04679625629949604,0.4953203743700504,0.45788336933045354,0.9949604031677466,0.005039596832253419
10204,351,298,53,301,50,0.8490028490028491,0.150997150997151,0.8575498575498576,0.14245014245014245,165,5,23,137,157,8,0.030303030303030304,0.1393939393939394,0.8303030303030303,0.9515151515151515,0.048484848484848485
10205,975,802,173,911,64,0.8225641025641026,0.17743589743589744,0.9343589743589743,0.06564102564102564,1090,62,522,506,1083,7,0.05688073394495413,0.47889908256880737,0.46422018348623856,0.9935779816513761,0.006422018348623854
10206,289,239,50,244,45,0.8269896193771626,0.17301038062283736,0.8442906574394463,0.15570934256055363,147,5,23,119,140,7,0.034013605442176874,0.1564625850340136,0.8095238095238095,0.9523809523809523,0.047619047619047616
10207,187,146,41,153,34,0.7807486631016043,0.2192513368983957,0.8181818181818182,0.18181818181818182,178,5,23,150,168,10,0.028089887640449437,0.12921348314606743,0.8426966292134831,0.9438202247191011,0.056179775280898875
10208,835,693,142,795,40,0.829940119760479,0.17005988023952096,0.9520958083832335,0.04790419161676647,1009,48,475,486,1000,9,0.04757185332011893,0.4707631318136769,0.48166501486620417,0.9910802775024777,0.008919722497522299
10209,323,95,228,174,149,0.29411764705882354,0.7058823529411765,0.5386996904024768,0.4613003095975232,112,1,45,66,109,3,0.008928571428571428,0.4017857142857143,0.5892857142857143,0.9732142857142857,0.026785714285714284
10210,1766,1538,228,1615,151,0.8708946772366931,0.1291053227633069,0.9144960362400906,0.0855039637599094,1034,54,496,484,1029,5,0.05222437137330754,0.4796905222437137,0.46808510638297873,0.995164410058027,0.004835589941972921
10211,1047,846,201,1006,41,0.8080229226361032,0.19197707736389685,0.9608404966571156,0.039159503342884434,702,89,326,287,701,1,0.1267806267806268,0.46438746438746437,0.40883190883190884,0.9985754985754985,0.0014245014245014246
10212,489,432,57,434,55,0.8834355828220859,0.1165644171779141,0.8875255623721882,0.11247443762781185,180,5,23,152,169,11,0.027777777777777776,0.12777777777777777,0.8444444444444444,0.9388888888888889,0.06111111111111111
10213,303,261,42,260,43,0.8613861386138614,0.13861386138613863,0.858085808580858,0.1419141914191419,197,4,24,169,188,9,0.02030456852791878,0.1218274111675127,0.8578680203045685,0.9543147208121827,0.04568527918781726
10214,1357,1142,215,1289,68,0.8415622697126013,0.1584377302873987,0.9498894620486367,0.050110537951363304,1298,54,627,617,1293,5,0.04160246533127889,0.4830508474576271,0.47534668721109397,0.9961479198767335,0.003852080123266564
10215,2008,1767,241,1961,47,0.8799800796812749,0.1200199203187251,0.976593625498008,0.023406374501992032,1261,69,608,584,1256,5,0.05471847739888977,0.4821570182394925,0.4631245043616178,0.9960348929421095,0.003965107057890563
10216,309,255,54,262,47,0.8252427184466019,0.17475728155339806,0.8478964401294499,0.15210355987055016,179,4,25,150,169,10,0.0223463687150838,0.13966480446927373,0.8379888268156425,0.9441340782122905,0.055865921787709494
10217,616,557,59,558,58,0.9042207792207793,0.09577922077922078,0.9058441558441559,0.09415584415584416,153,5,23,125,147,6,0.032679738562091505,0.1503267973856209,0.8169934640522876,0.9607843137254902,0.0392156862745098
10218,857,714,143,815,42,0.8331388564760793,0.16686114352392065,0.9509918319719953,0.049008168028004666,435,41,199,195,420,15,0.09425287356321839,0.4574712643678161,0.4482758620689655,0.9655172413793104,0.034482758620689655
10219,1665,1415,250,1586,79,0.8498498498498499,0.15015015015015015,0.9525525525525526,0.04744744744744745,2152,49,1043,1060,2145,7,0.022769516728624536,0.4846654275092937,0.49256505576208176,0.9967472118959108,0.0032527881040892194
10220,300,237,63,245,55,0.79,0.21,0.8166666666666667,0.18333333333333332,156,5,24,127,149,7,0.03205128205128205,0.15384615384615385,0.8141025641025641,0.9551282051282052,0.04487179487179487
10221,361,116,245,185,176,0.32132963988919666,0.6786703601108033,0.5124653739612188,0.48753462603878117,118,0,51,67,114,4,0.0,0.4322033898305085,0.5677966101694916,0.9661016949152542,0.03389830508474576
10222,341,277,64,285,56,0.8123167155425219,0.187683284457478,0.8357771260997068,0.16422287390029325,177,5,23,149,166,11,0.02824858757062147,0.12994350282485875,0.8418079096045198,0.9378531073446328,0.062146892655367235
10223,356,292,64,300,56,0.8202247191011236,0.1797752808988764,0.8426966292134831,0.15730337078651685,173,4,25,144,164,9,0.023121387283236993,0.14450867052023122,0.8323699421965318,0.9479768786127167,0.05202312138728324
10224,1719,1542,177,1655,64,0.8970331588132635,0.10296684118673648,0.9627690517742874,0.03723094822571262,1020,67,495,458,1014,6,0.06568627450980392,0.4852941176470588,0.44901960784313727,0.9941176470588236,0.0058823529411764705
10225,539,473,66,476,63,0.8775510204081632,0.12244897959183673,0.8831168831168831,0.11688311688311688,175,5,23,147,166,9,0.02857142857142857,0.13142857142857142,0.84,0.9485714285714286,0.05142857142857143
10226,660,489,171,615,45,0.740909090909091,0.2590909090909091,0.9318181818181818,0.06818181818181818,751,97,338,316,750,1,0.12916111850865514,0.45006657789613846,0.4207723035952064,0.9986684420772304,0.0013315579227696406
10227,418,380,38,379,39,0.9090909090909091,0.09090909090909091,0.9066985645933014,0.09330143540669857,146,5,24,117,139,7,0.03424657534246575,0.1643835616438356,0.8013698630136986,0.952054794520548,0.04794520547945205
10228,1563,1366,197,1512,51,0.8739603326935381,0.12603966730646193,0.9673704414587332,0.03262955854126679,2634,68,1287,1279,2630,4,0.025816249050873197,0.4886104783599089,0.4855732725892179,0.9984813971146546,0.0015186028853454822
10229,1099,860,239,1014,85,0.7825295723384895,0.21747042766151045,0.9226569608735213,0.07734303912647862,1104,43,508,553,1097,7,0.03894927536231884,0.4601449275362319,0.5009057971014492,0.9936594202898551,0.006340579710144928
10230,2056,1779,277,1998,58,0.8652723735408561,0.13472762645914396,0.9717898832684825,0.02821011673151751,1122,40,542,540,1117,5,0.035650623885918005,0.483065953654189,0.48128342245989303,0.9955436720142602,0.004456327985739751
10231,1075,935,140,1041,34,0.8697674418604651,0.13023255813953488,0.9683720930232558,0.03162790697674418,365,52,179,134,364,1,0.14246575342465753,0.4904109589041096,0.36712328767123287,0.9972602739726028,0.0027397260273972603
10232,482,443,39,449,33,0.9190871369294605,0.08091286307053942,0.9315352697095436,0.06846473029045644,163,5,23,135,154,9,0.03067484662576687,0.1411042944785276,0.8282208588957055,0.9447852760736196,0.05521472392638037
10233,1336,1141,195,1276,60,0.8540419161676647,0.14595808383233533,0.9550898203592815,0.04491017964071856,1582,57,755,770,1568,14,0.03603034134007586,0.47724399494311,0.48672566371681414,0.9911504424778761,0.008849557522123894
10234,4853,4147,706,3964,889,0.8545229754790851,0.1454770245209149,0.8168143416443437,0.18318565835565628,996,125,268,603,690,306,0.12550200803212852,0.26907630522088355,0.6054216867469879,0.6927710843373494,0.3072289156626506
10235,275,101,174,174,101,0.36727272727272725,0.6327272727272727,0.6327272727272727,0.36727272727272725,94,0,39,55,92,2,0.0,0.4148936170212766,0.5851063829787234,0.9787234042553191,0.02127659574468085
10236,1170,984,186,1113,57,0.841025641025641,0.15897435897435896,0.9512820512820512,0.04871794871794872,890,53,523,314,889,1,0.05955056179775281,0.5876404494382023,0.35280898876404493,0.998876404494382,0.0011235955056179776
10237,1151,1022,129,1121,30,0.8879235447437012,0.11207645525629888,0.9739357080799305,0.026064291920069503,2258,50,1101,1107,2251,7,0.022143489813994686,0.487599645704163,0.49025686448184236,0.9968999114260407,0.003100088573959256
10238,941,754,187,903,38,0.8012752391073327,0.19872476089266738,0.9596174282678002,0.040382571732199786,692,79,300,313,691,1,0.11416184971098266,0.43352601156069365,0.4523121387283237,0.9985549132947977,0.001445086705202312
10239,899,708,191,842,57,0.7875417130144605,0.21245828698553948,0.9365962180200222,0.06340378197997776,528,75,255,198,527,1,0.14204545454545456,0.48295454545454547,0.375,0.9981060606060606,0.001893939393939394
10240,1532,1286,246,1470,62,0.839425587467363,0.16057441253263707,0.9595300261096605,0.04046997389033943,1281,58,622,601,1276,5,0.04527712724434036,0.4855581576893052,0.46916471506635443,0.9960967993754879,0.0039032006245121
10241,232,177,55,186,46,0.7629310344827587,0.23706896551724138,0.8017241379310345,0.19827586206896552,168,5,24,139,161,7,0.02976190476190476,0.14285714285714285,0.8273809523809523,0.9583333333333334,0.041666666666666664
10242,278,75,203,152,126,0.2697841726618705,0.7302158273381295,0.5467625899280576,0.45323741007194246,123,2,51,70,121,2,0.016260162601626018,0.4146341463414634,0.5691056910569106,0.983739837398374,0.016260162601626018
10243,387,333,54,341,46,0.8604651162790697,0.13953488372093023,0.8811369509043928,0.11886304909560723,146,5,24,117,140,6,0.03424657534246575,0.1643835616438356,0.8013698630136986,0.958904109589041,0.0410958904109589
10244,178,144,34,151,27,0.8089887640449438,0.19101123595505617,0.848314606741573,0.15168539325842698,156,5,24,127,147,9,0.03205128205128205,0.15384615384615385,0.8141025641025641,0.9423076923076923,0.057692307692307696
10245,1417,1218,199,1348,69,0.8595624558927312,0.14043754410726889,0.9513055751587862,0.048694424841213835,1835,49,884,902,1832,3,0.02670299727520436,0.4817438692098093,0.49155313351498636,0.9983651226158038,0.0016348773841961854
10246,672,567,105,642,30,0.84375,0.15625,0.9553571428571429,0.044642857142857144,808,64,356,388,799,9,0.07920792079207921,0.4405940594059406,0.4801980198019802,0.9888613861386139,0.011138613861386138
10247,284,75,209,160,124,0.2640845070422535,0.7359154929577465,0.5633802816901409,0.43661971830985913,121,1,51,69,118,3,0.008264462809917356,0.4214876033057851,0.5702479338842975,0.9752066115702479,0.024793388429752067
10248,1701,1542,159,1638,63,0.9065255731922398,0.09347442680776014,0.9629629629629629,0.037037037037037035,1611,56,785,770,1607,4,0.03476101800124146,0.4872749844816884,0.47796399751707014,0.9975170701427685,0.002482929857231533
10249,343,302,41,308,35,0.880466472303207,0.119533527696793,0.8979591836734694,0.10204081632653061,153,5,23,125,143,10,0.032679738562091505,0.1503267973856209,0.8169934640522876,0.934640522875817,0.06535947712418301
10250,1582,1412,170,1537,45,0.8925410872313527,0.10745891276864729,0.9715549936788875,0.028445006321112517,1559,43,762,754,1556,3,0.027581783194355357,0.48877485567671586,0.4836433611289288,0.9980756895445798,0.001924310455420141
10251,1335,1151,184,1277,58,0.8621722846441947,0.13782771535580524,0.9565543071161049,0.04344569288389513,2095,54,1003,1038,2089,6,0.025775656324582338,0.47875894988066825,0.4954653937947494,0.9971360381861575,0.002863961813842482
10252,1242,1146,96,1217,25,0.9227053140096618,0.07729468599033816,0.9798711755233495,0.020128824476650563,914,48,435,431,911,3,0.0525164113785558,0.4759299781181619,0.47155361050328226,0.9967177242888403,0.0032822757111597373
10253,343,278,65,287,56,0.8104956268221575,0.18950437317784258,0.8367346938775511,0.16326530612244897,164,5,23,136,155,9,0.03048780487804878,0.1402439024390244,0.8292682926829268,0.9451219512195121,0.054878048780487805
10254,1140,941,199,1080,60,0.8254385964912281,0.17456140350877192,0.9473684210526315,0.05263157894736842,1351,47,645,659,1344,7,0.03478904515173945,0.4774241302738712,0.4877868245743893,0.9948186528497409,0.0051813471502590676
10255,202,146,56,151,51,0.7227722772277227,0.27722772277227725,0.7475247524752475,0.2524752475247525,147,4,24,119,140,7,0.027210884353741496,0.16326530612244897,0.8095238095238095,0.9523809523809523,0.047619047619047616
10256,1057,894,163,1013,44,0.8457899716177862,0.15421002838221382,0.9583727530747398,0.041627246925260174,444,42,204,198,429,15,0.0945945945945946,0.4594594594594595,0.44594594594594594,0.9662162162162162,0.033783783783783786
10257,316,257,59,260,56,0.8132911392405063,0.18670886075949367,0.8227848101265823,0.17721518987341772,164,5,23,136,156,8,0.03048780487804878,0.1402439024390244,0.8292682926829268,0.9512195121951219,0.04878048780487805
10258,1601,1367,234,1542,59,0.853841349156777,0.146158650843223,0.9631480324797002,0.03685196752029981,1266,73,610,583,1259,7,0.05766192733017378,0.48183254344391785,0.46050552922590837,0.9944707740916272,0.005529225908372828
10259,525,463,62,467,58,0.8819047619047619,0.1180952380952381,0.8895238095238095,0.11047619047619048,154,4,24,126,148,6,0.025974025974025976,0.15584415584415584,0.8181818181818182,0.961038961038961,0.03896103896103896
10260,1958,1713,245,1913,45,0.8748723186925434,0.12512768130745658,0.9770173646578141,0.022982635342185902,990,56,483,451,985,5,0.05656565656565657,0.48787878787878786,0.45555555555555555,0.9949494949494949,0.005050505050505051
10261,218,79,139,117,101,0.3623853211009174,0.6376146788990825,0.536697247706422,0.463302752293578,72,0,31,41,71,1,0.0,0.4305555555555556,0.5694444444444444,0.9861111111111112,0.013888888888888888
10262,222,187,35,195,27,0.8423423423423423,0.15765765765765766,0.8783783783783784,0.12162162162162163,178,4,24,150,168,10,0.02247191011235955,0.1348314606741573,0.8426966292134831,0.9438202247191011,0.056179775280898875
10263,457,388,69,396,61,0.849015317286652,0.15098468271334792,0.8665207877461707,0.13347921225382933,159,5,23,131,152,7,0.031446540880503145,0.14465408805031446,0.8238993710691824,0.9559748427672956,0.0440251572327044
10264,872,697,175,834,38,0.7993119266055045,0.2006880733944954,0.9564220183486238,0.04357798165137615,531,94,253,184,530,1,0.17702448210922786,0.4764595103578154,0.3465160075329567,0.9981167608286252,0.0018832391713747645
10265,206,163,43,165,41,0.7912621359223301,0.2087378640776699,0.8009708737864077,0.19902912621359223,147,5,23,119,140,7,0.034013605442176874,0.1564625850340136,0.8095238095238095,0.9523809523809523,0.047619047619047616
10266,323,253,70,260,63,0.7832817337461301,0.21671826625386997,0.804953560371517,0.19504643962848298,189,5,23,161,181,8,0.026455026455026454,0.12169312169312169,0.8518518518518519,0.9576719576719577,0.042328042328042326
10267,358,299,59,304,54,0.835195530726257,0.164804469273743,0.8491620111731844,0.15083798882681565,180,5,23,152,170,10,0.027777777777777776,0.12777777777777777,0.8444444444444444,0.9444444444444444,0.05555555555555555
10268,1532,1286,246,1470,62,0.839425587467363,0.16057441253263707,0.9595300261096605,0.04046997389033943,1281,58,622,601,1276,5,0.04527712724434036,0.4855581576893052,0.46916471506635443,0.9960967993754879,0.0039032006245121
10269,525,463,62,467,58,0.8819047619047619,0.1180952380952381,0.8895238095238095,0.11047619047619048,169,4,24,141,158,11,0.023668639053254437,0.14201183431952663,0.834319526627219,0.9349112426035503,0.0650887573964497
10270,4849,4146,703,3960,889,0.8550216539492679,0.14497834605073212,0.8166632295318622,0.18333677046813776,996,125,263,608,690,306,0.12550200803212852,0.2640562248995984,0.6104417670682731,0.6927710843373494,0.3072289156626506
10271,1776,1461,315,1662,114,0.8226351351351351,0.17736486486486486,0.9358108108108109,0.06418918918918919,560,62,265,233,555,5,0.11071428571428571,0.4732142857142857,0.4160714285714286,0.9910714285714286,0.008928571428571428
10272,2051,1819,232,1974,77,0.8868844466114091,0.11311555338859093,0.962457337883959,0.03754266211604096,2981,59,1442,1480,2975,6,0.019792016101979202,0.483730291848373,0.49647769204964776,0.9979872525997987,0.0020127474002012745
10273,307,245,62,251,56,0.7980456026058632,0.20195439739413681,0.8175895765472313,0.18241042345276873,158,5,23,130,149,9,0.03164556962025317,0.14556962025316456,0.8227848101265823,0.9430379746835443,0.056962025316455694
10274,2056,1779,277,1998,58,0.8652723735408561,0.13472762645914396,0.9717898832684825,0.02821011673151751,1122,40,542,540,1117,5,0.035650623885918005,0.483065953654189,0.48128342245989303,0.9955436720142602,0.004456327985739751
10275,1584,1349,235,1531,53,0.8516414141414141,0.14835858585858586,0.9665404040404041,0.03345959595959596,1008,44,484,480,1003,5,0.04365079365079365,0.4801587301587302,0.47619047619047616,0.9950396825396826,0.00496031746031746
10276,1449,1263,186,1389,60,0.8716356107660456,0.12836438923395446,0.9585921325051759,0.041407867494824016,1335,63,644,628,1326,9,0.04719101123595506,0.48239700374531835,0.4704119850187266,0.9932584269662922,0.006741573033707865
10277,2056,1779,277,1998,58,0.8652723735408561,0.13472762645914396,0.9717898832684825,0.02821011673151751,1122,40,542,540,1117,5,0.035650623885918005,0.483065953654189,0.48128342245989303,0.9955436720142602,0.004456327985739751
10278,341,290,51,290,51,0.8504398826979472,0.1495601173020528,0.8504398826979472,0.1495601173020528,154,5,23,126,148,6,0.032467532467532464,0.14935064935064934,0.8181818181818182,0.961038961038961,0.03896103896103896
10279,318,263,55,263,55,0.8270440251572327,0.17295597484276728,0.8270440251572327,0.17295597484276728,140,5,23,112,136,4,0.03571428571428571,0.16428571428571428,0.8,0.9714285714285714,0.02857142857142857
10280,431,386,45,388,43,0.8955916473317865,0.10440835266821345,0.9002320185614849,0.09976798143851508,174,5,23,146,165,9,0.028735632183908046,0.13218390804597702,0.8390804597701149,0.9482758620689655,0.05172413793103448
10281,1811,1476,335,1741,70,0.8150193263390392,0.1849806736609608,0.9613473219215903,0.03865267807840972,1163,51,550,562,1155,8,0.043852106620808254,0.472914875322442,0.4832330180567498,0.9931212381771282,0.006878761822871883
10282,1497,1310,187,1442,55,0.8750835003340013,0.12491649966599866,0.9632598530394122,0.03674014696058784,1107,56,528,523,1104,3,0.05058717253839205,0.47696476964769646,0.47244805781391147,0.997289972899729,0.0027100271002710027
10283,245,66,179,133,112,0.2693877551020408,0.7306122448979592,0.5428571428571428,0.45714285714285713,104,0,36,68,99,5,0.0,0.34615384615384615,0.6538461538461539,0.9519230769230769,0.04807692307692308
10284,1026,771,255,975,51,0.7514619883040936,0.24853801169590642,0.9502923976608187,0.049707602339181284,1088,62,513,513,1081,7,0.05698529411764706,0.47150735294117646,0.47150735294117646,0.9935661764705882,0.006433823529411764
10285,582,462,120,553,29,0.7938144329896907,0.20618556701030927,0.9501718213058419,0.04982817869415808,1179,39,556,584,1172,7,0.03307888040712468,0.4715860899067006,0.4953350296861747,0.9940627650551315,0.005937234944868533
10286,734,545,189,687,47,0.7425068119891008,0.2574931880108992,0.9359673024523161,0.06403269754768393,647,91,254,302,646,1,0.14064914992272023,0.39258114374034003,0.4667697063369397,0.9984544049459042,0.0015455950540958269
10287,1326,1054,272,1257,69,0.7948717948717948,0.20512820512820512,0.9479638009049773,0.05203619909502263,1261,57,598,606,1253,8,0.04520222045995242,0.4742268041237113,0.48057097541633625,0.9936558287073751,0.006344171292624901
10288,1908,1667,241,1851,57,0.8736897274633124,0.12631027253668764,0.970125786163522,0.029874213836477988,2132,56,1032,1044,2126,6,0.02626641651031895,0.48405253283302063,0.4896810506566604,0.9971857410881801,0.0028142589118198874
10289,295,84,211,152,143,0.2847457627118644,0.7152542372881356,0.5152542372881356,0.4847457627118644,80,0,35,45,78,2,0.0,0.4375,0.5625,0.975,0.025
10290,1473,1221,252,1412,61,0.8289205702647657,0.1710794297352342,0.9585879158180584,0.041412084181941616,1150,72,543,535,1144,6,0.06260869565217392,0.4721739130434783,0.4652173913043478,0.9947826086956522,0.0052173913043478265
10291,774,608,166,728,46,0.7855297157622739,0.2144702842377261,0.9405684754521964,0.059431524547803614,966,59,455,452,960,6,0.061076604554865424,0.47101449275362317,0.46790890269151136,0.9937888198757764,0.006211180124223602
10292,487,430,57,436,51,0.8829568788501027,0.11704312114989733,0.8952772073921971,0.10472279260780287,169,5,23,141,158,11,0.029585798816568046,0.13609467455621302,0.834319526627219,0.9349112426035503,0.0650887573964497
10293,232,177,55,186,46,0.7629310344827587,0.23706896551724138,0.8017241379310345,0.19827586206896552,152,5,24,123,148,4,0.03289473684210526,0.15789473684210525,0.8092105263157895,0.9736842105263158,0.02631578947368421
10294,850,741,109,820,30,0.8717647058823529,0.12823529411764706,0.9647058823529412,0.03529411764705882,532,44,252,236,516,16,0.08270676691729323,0.47368421052631576,0.44360902255639095,0.9699248120300752,0.03007518796992481
10295,171,129,42,137,34,0.7543859649122807,0.24561403508771928,0.8011695906432749,0.19883040935672514,165,5,24,136,157,8,0.030303030303030304,0.14545454545454545,0.8242424242424242,0.9515151515151515,0.048484848484848485
10296,294,95,199,166,128,0.3231292517006803,0.6768707482993197,0.564625850340136,0.43537414965986393,109,1,48,60,106,3,0.009174311926605505,0.44036697247706424,0.5504587155963303,0.9724770642201835,0.027522935779816515
10297,889,691,198,851,38,0.7772778402699663,0.22272215973003376,0.9572553430821147,0.04274465691788527,1138,63,536,539,1130,8,0.05536028119507909,0.4710017574692443,0.47363796133567665,0.9929701230228472,0.007029876977152899
10298,946,761,185,917,29,0.8044397463002114,0.19556025369978858,0.9693446088794926,0.0306553911205074,1054,63,495,496,1048,6,0.05977229601518026,0.4696394686907021,0.47058823529411764,0.9943074003795066,0.0056925996204933585
10299,462,405,57,406,56,0.8766233766233766,0.12337662337662338,0.8787878787878788,0.12121212121212122,157,5,23,129,148,9,0.03184713375796178,0.1464968152866242,0.821656050955414,0.9426751592356688,0.05732484076433121
10300,281,246,35,255,26,0.8754448398576512,0.12455516014234876,0.9074733096085409,0.09252669039145907,143,4,25,114,137,6,0.027972027972027972,0.17482517482517482,0.7972027972027972,0.958041958041958,0.04195804195804196
10301,809,688,121,766,43,0.8504326328800988,0.14956736711990112,0.9468479604449939,0.05315203955500618,411,53,203,155,398,13,0.12895377128953772,0.49391727493917276,0.3771289537712895,0.9683698296836983,0.031630170316301706
10302,1332,1133,199,1276,56,0.8506006006006006,0.1493993993993994,0.9579579579579579,0.042042042042042045,1081,60,508,513,1076,5,0.05550416281221091,0.46993524514338575,0.4745605920444033,0.9953746530989824,0.004625346901017576
10303,228,202,26,205,23,0.8859649122807017,0.11403508771929824,0.8991228070175439,0.10087719298245613,165,5,23,137,156,9,0.030303030303030304,0.1393939393939394,0.8303030303030303,0.9454545454545454,0.05454545454545454
10304,1131,890,241,1065,66,0.7869142351900973,0.21308576480990274,0.9416445623342176,0.058355437665782495,579,82,258,239,578,1,0.14162348877374784,0.44559585492227977,0.41278065630397237,0.998272884283247,0.0017271157167530224
10305,1538,1325,213,1479,59,0.8615084525357607,0.13849154746423928,0.9616384915474643,0.03836150845253576,968,49,458,461,964,4,0.0506198347107438,0.4731404958677686,0.4762396694214876,0.9958677685950413,0.004132231404958678
10306,1105,893,212,1061,44,0.8081447963800905,0.19185520361990951,0.9601809954751132,0.039819004524886875,1151,65,553,533,1144,7,0.05647263249348393,0.48045178105994785,0.4630755864465682,0.9939183318853171,0.006081668114682885
10307,809,614,195,764,45,0.7589616810877626,0.24103831891223734,0.9443757725587144,0.05562422744128554,700,84,311,305,699,1,0.12,0.4442857142857143,0.4357142857142857,0.9985714285714286,0.0014285714285714286
10308,1734,1462,272,1652,82,0.8431372549019608,0.1568627450980392,0.9527104959630911,0.04728950403690888,1153,59,544,550,1149,4,0.05117085862966175,0.47181266261925414,0.4770164787510841,0.9965307892454467,0.003469210754553339
10309,1091,888,203,1028,63,0.8139321723189734,0.1860678276810266,0.9422548120989918,0.05774518790100825,973,49,474,450,963,10,0.050359712230215826,0.48715313463514903,0.4624871531346352,0.9897225077081192,0.010277492291880781
10310,291,243,48,247,44,0.8350515463917526,0.16494845360824742,0.8487972508591065,0.15120274914089346,192,5,23,164,181,11,0.026041666666666668,0.11979166666666667,0.8541666666666666,0.9427083333333334,0.057291666666666664
10311,1868,1653,215,1793,75,0.8849036402569593,0.11509635974304068,0.9598501070663812,0.04014989293361884,2145,51,1021,1073,2138,7,0.023776223776223775,0.475990675990676,0.5002331002331002,0.9967365967365968,0.0032634032634032634
10312,592,531,61,568,24,0.8969594594594594,0.10304054054054054,0.9594594594594594,0.04054054054054054,1248,56,596,596,1238,10,0.04487179487179487,0.4775641025641026,0.4775641025641026,0.9919871794871795,0.008012820512820512
10313,1857,1625,232,1806,51,0.8750673128702208,0.12493268712977922,0.9725363489499192,0.027463651050080775,1588,69,779,740,1585,3,0.04345088161209068,0.4905541561712846,0.4659949622166247,0.9981108312342569,0.001889168765743073
10314,243,200,43,206,37,0.823045267489712,0.17695473251028807,0.8477366255144033,0.1522633744855967,184,5,23,156,174,10,0.02717391304347826,0.125,0.8478260869565217,0.9456521739130435,0.05434782608695652
10315,283,100,183,139,144,0.35335689045936397,0.6466431095406361,0.4911660777385159,0.508833922261484,120,1,48,71,118,2,0.008333333333333333,0.4,0.5916666666666667,0.9833333333333333,0.016666666666666666
10316,482,443,39,449,33,0.9190871369294605,0.08091286307053942,0.9315352697095436,0.06846473029045644,176,5,23,148,167,9,0.028409090909090908,0.13068181818181818,0.8409090909090909,0.9488636363636364,0.05113636363636364
10317,1357,1142,215,1289,68,0.8415622697126013,0.1584377302873987,0.9498894620486367,0.050110537951363304,1299,54,627,618,1293,6,0.04157043879907621,0.48267898383371827,0.47575057736720555,0.9953810623556582,0.004618937644341801
10318,424,387,37,380,44,0.9127358490566038,0.08726415094339622,0.8962264150943396,0.10377358490566038,145,5,23,117,138,7,0.034482758620689655,0.15862068965517243,0.8068965517241379,0.9517241379310345,0.04827586206896552
10319,2076,1813,263,2017,59,0.8733140655105973,0.12668593448940269,0.9715799614643545,0.02842003853564547,969,61,470,438,965,4,0.0629514963880289,0.4850361197110423,0.4520123839009288,0.9958720330237358,0.0041279669762641896
10320,1147,934,213,1093,54,0.8142981691368788,0.1857018308631212,0.952920662598082,0.047079337401918046,1107,42,523,542,1100,7,0.037940379403794036,0.47244805781391147,0.4896115627822945,0.993676603432701,0.006323396567299007
10321,243,204,39,211,32,0.8395061728395061,0.16049382716049382,0.8683127572016461,0.13168724279835392,165,5,24,136,155,10,0.030303030303030304,0.14545454545454545,0.8242424242424242,0.9393939393939394,0.06060606060606061
10322,1274,1048,226,1206,68,0.8226059654631083,0.17739403453689168,0.9466248037676609,0.05337519623233909,604,83,261,260,603,1,0.13741721854304637,0.43211920529801323,0.4304635761589404,0.9983443708609272,0.0016556291390728477
10323,342,289,53,298,44,0.8450292397660819,0.15497076023391812,0.8713450292397661,0.1286549707602339,154,4,25,125,147,7,0.025974025974025976,0.16233766233766234,0.8116883116883117,0.9545454545454546,0.045454545454545456
10324,338,93,245,191,147,0.27514792899408286,0.7248520710059172,0.5650887573964497,0.4349112426035503,130,2,62,66,128,2,0.015384615384615385,0.47692307692307695,0.5076923076923077,0.9846153846153847,0.015384615384615385
10325,431,386,45,388,43,0.8955916473317865,0.10440835266821345,0.9002320185614849,0.09976798143851508,158,5,23,130,148,10,0.03164556962025317,0.14556962025316456,0.8227848101265823,0.9367088607594937,0.06329113924050633
10326,1122,895,227,1065,57,0.7976827094474154,0.20231729055258468,0.9491978609625669,0.05080213903743316,675,83,275,317,674,1,0.12296296296296297,0.4074074074074074,0.4696296296296296,0.9985185185185185,0.0014814814814814814
10327,709,619,90,673,36,0.8730606488011283,0.12693935119887165,0.9492242595204513,0.05077574047954866,1058,66,501,491,1053,5,0.062381852551984876,0.4735349716446125,0.46408317580340264,0.995274102079395,0.004725897920604915
10328,256,60,196,140,116,0.234375,0.765625,0.546875,0.453125,97,1,41,55,94,3,0.010309278350515464,0.422680412371134,0.5670103092783505,0.9690721649484536,0.030927835051546393
10329,270,84,186,150,120,0.3111111111111111,0.6888888888888889,0.5555555555555556,0.4444444444444444,108,0,43,65,105,3,0.0,0.39814814814814814,0.6018518518518519,0.9722222222222222,0.027777777777777776
10330,1138,910,228,1078,60,0.7996485061511424,0.20035149384885764,0.9472759226713533,0.05272407732864675,669,76,316,277,668,1,0.11360239162929746,0.47234678624813153,0.414050822122571,0.9985052316890882,0.0014947683109118087
10331,1183,1007,176,1102,81,0.8512256973795436,0.14877430262045646,0.9315300084530854,0.06846999154691462,980,59,440,481,973,7,0.06020408163265306,0.4489795918367347,0.49081632653061225,0.9928571428571429,0.007142857142857143
10332,647,530,117,621,26,0.8191653786707882,0.18083462132921174,0.9598145285935085,0.0401854714064915,1088,50,513,525,1081,7,0.04595588235294118,0.47150735294117646,0.48253676470588236,0.9935661764705882,0.006433823529411764
10333,952,809,143,881,71,0.8497899159663865,0.15021008403361344,0.9254201680672269,0.07457983193277311,1930,60,961,909,1926,4,0.031088082901554404,0.4979274611398964,0.4709844559585492,0.9979274611398964,0.002072538860103627
10334,237,199,38,201,36,0.8396624472573839,0.16033755274261605,0.8481012658227848,0.1518987341772152,200,4,24,172,191,9,0.02,0.12,0.86,0.955,0.045
10335,328,102,226,160,168,0.31097560975609756,0.6890243902439024,0.4878048780487805,0.5121951219512195,83,0,37,46,82,1,0.0,0.4457831325301205,0.5542168674698795,0.9879518072289156,0.012048192771084338
10336,859,667,192,822,37,0.7764842840512224,0.22351571594877764,0.9569266589057043,0.04307334109429569,547,98,257,192,546,1,0.17915904936014626,0.46983546617915906,0.3510054844606947,0.9981718464351006,0.0018281535648994515
10337,961,796,165,886,75,0.8283038501560874,0.1716961498439126,0.9219562955254943,0.07804370447450572,399,62,181,156,386,13,0.15538847117794485,0.45363408521303256,0.39097744360902253,0.9674185463659147,0.03258145363408521
10338,1734,1462,272,1652,82,0.8431372549019608,0.1568627450980392,0.9527104959630911,0.04728950403690888,1153,59,544,550,1149,4,0.05117085862966175,0.47181266261925414,0.4770164787510841,0.9965307892454467,0.003469210754553339
10339,365,303,62,312,53,0.8301369863013699,0.16986301369863013,0.8547945205479452,0.14520547945205478,193,4,24,165,184,9,0.02072538860103627,0.12435233160621761,0.8549222797927462,0.9533678756476683,0.046632124352331605
10340,332,125,207,173,159,0.37650602409638556,0.6234939759036144,0.5210843373493976,0.4789156626506024,100,0,41,59,99,1,0.0,0.41,0.59,0.99,0.01
10341,940,825,115,911,29,0.8776595744680851,0.12234042553191489,0.9691489361702128,0.030851063829787233,1076,52,496,528,1068,8,0.048327137546468404,0.46096654275092935,0.49070631970260226,0.9925650557620818,0.007434944237918215
10342,1254,1011,243,1183,71,0.80622009569378,0.1937799043062201,0.9433811802232854,0.05661881977671451,1046,46,490,510,1039,7,0.04397705544933078,0.4684512428298279,0.4875717017208413,0.9933078393881453,0.006692160611854685
10343,526,447,79,450,76,0.8498098859315589,0.15019011406844107,0.8555133079847909,0.1444866920152091,155,4,24,127,146,9,0.025806451612903226,0.15483870967741936,0.8193548387096774,0.9419354838709677,0.05806451612903226
10344,1734,1462,272,1652,82,0.8431372549019608,0.1568627450980392,0.9527104959630911,0.04728950403690888,1153,59,544,550,1149,4,0.05117085862966175,0.47181266261925414,0.4770164787510841,0.9965307892454467,0.003469210754553339
10345,291,243,48,247,44,0.8350515463917526,0.16494845360824742,0.8487972508591065,0.15120274914089346,189,5,23,161,178,11,0.026455026455026454,0.12169312169312169,0.8518518518518519,0.9417989417989417,0.0582010582010582
10346,431,386,45,388,43,0.8955916473317865,0.10440835266821345,0.9002320185614849,0.09976798143851508,158,5,23,130,148,10,0.03164556962025317,0.14556962025316456,0.8227848101265823,0.9367088607594937,0.06329113924050633
10347,367,301,66,306,61,0.8201634877384196,0.17983651226158037,0.8337874659400545,0.16621253405994552,156,4,24,128,147,9,0.02564102564102564,0.15384615384615385,0.8205128205128205,0.9423076923076923,0.057692307692307696
10348,616,557,59,558,58,0.9042207792207793,0.09577922077922078,0.9058441558441559,0.09415584415584416,153,5,23,125,147,6,0.032679738562091505,0.1503267973856209,0.8169934640522876,0.9607843137254902,0.0392156862745098
10349,487,430,57,433,54,0.8829568788501027,0.11704312114989733,0.8891170431211499,0.11088295687885011,178,5,23,150,169,9,0.028089887640449437,0.12921348314606743,0.8426966292134831,0.949438202247191,0.05056179775280899
10350,301,99,202,166,135,0.3289036544850498,0.6710963455149501,0.5514950166112956,0.4485049833887043,91,0,36,55,90,1,0.0,0.3956043956043956,0.6043956043956044,0.989010989010989,0.01098901098901099
10351,310,264,46,264,46,0.8516129032258064,0.14838709677419354,0.8516129032258064,0.14838709677419354,144,5,23,116,137,7,0.034722222222222224,0.1597222222222222,0.8055555555555556,0.9513888888888888,0.04861111111111111
10352,337,288,49,297,40,0.8545994065281899,0.14540059347181009,0.8813056379821959,0.11869436201780416,178,4,25,149,170,8,0.02247191011235955,0.1404494382022472,0.8370786516853933,0.9550561797752809,0.0449438202247191
10353,1417,1218,199,1348,69,0.8595624558927312,0.14043754410726889,0.9513055751587862,0.048694424841213835,1835,49,884,902,1832,3,0.02670299727520436,0.4817438692098093,0.49155313351498636,0.9983651226158038,0.0016348773841961854
10354,285,96,189,156,129,0.3368421052631579,0.6631578947368421,0.5473684210526316,0.45263157894736844,121,0,46,75,117,4,0.0,0.38016528925619836,0.6198347107438017,0.9669421487603306,0.03305785123966942
10355,1184,973,211,1114,70,0.8217905405405406,0.17820945945945946,0.9408783783783784,0.05912162162162162,1051,89,480,482,1046,5,0.08468125594671741,0.45670789724072314,0.4586108468125595,0.9952426260704091,0.004757373929590866
10356,236,193,43,196,40,0.8177966101694916,0.18220338983050846,0.8305084745762712,0.1694915254237288,194,5,23,166,181,13,0.02577319587628866,0.11855670103092783,0.8556701030927835,0.9329896907216495,0.06701030927835051
10357,1229,1125,104,1184,45,0.9153783563873068,0.08462164361269324,0.9633848657445078,0.03661513425549227,1835,46,898,891,1827,8,0.025068119891008173,0.4893732970027248,0.48555858310626704,0.9956403269754769,0.004359673024523161
10358,1244,1021,223,1185,59,0.8207395498392283,0.17926045016077172,0.952572347266881,0.04742765273311897,1258,71,580,607,1250,8,0.05643879173290938,0.4610492845786963,0.4825119236883943,0.9936406995230525,0.006359300476947536
10359,294,246,48,254,40,0.8367346938775511,0.16326530612244897,0.8639455782312925,0.1360544217687075,170,4,24,142,163,7,0.023529411764705882,0.1411764705882353,0.8352941176470589,0.9588235294117647,0.041176470588235294
10360,540,483,57,483,57,0.8944444444444445,0.10555555555555556,0.8944444444444445,0.10555555555555556,170,4,24,142,158,12,0.023529411764705882,0.1411764705882353,0.8352941176470589,0.9294117647058824,0.07058823529411765
10361,249,201,48,208,41,0.8072289156626506,0.1927710843373494,0.8353413654618473,0.1646586345381526,157,5,23,129,149,8,0.03184713375796178,0.1464968152866242,0.821656050955414,0.9490445859872612,0.050955414012738856
10362,261,224,37,230,31,0.8582375478927203,0.1417624521072797,0.8812260536398467,0.11877394636015326,158,5,23,130,148,10,0.03164556962025317,0.14556962025316456,0.8227848101265823,0.9367088607594937,0.06329113924050633
10363,1476,1304,172,1431,45,0.8834688346883469,0.11653116531165311,0.9695121951219512,0.03048780487804878,1039,47,499,493,1035,4,0.04523580365736285,0.480269489894129,0.47449470644850816,0.9961501443695862,0.0038498556304138597
10364,383,338,45,340,43,0.8825065274151436,0.1174934725848564,0.8877284595300261,0.1122715404699739,152,5,23,124,144,8,0.03289473684210526,0.1513157894736842,0.8157894736842105,0.9473684210526315,0.05263157894736842
10365,339,260,79,264,75,0.7669616519174042,0.23303834808259588,0.7787610619469026,0.22123893805309736,151,5,23,123,147,4,0.033112582781456956,0.152317880794702,0.8145695364238411,0.9735099337748344,0.026490066225165563
10366,4870,4163,707,3975,895,0.8548254620123203,0.14517453798767968,0.8162217659137577,0.1837782340862423,1003,125,265,613,697,306,0.12462612163509472,0.2642073778664008,0.6111665004985045,0.6949152542372882,0.3050847457627119
10367,1035,809,226,969,66,0.7816425120772947,0.21835748792270532,0.936231884057971,0.06376811594202898,627,82,303,242,623,4,0.13078149920255183,0.48325358851674644,0.38596491228070173,0.9936204146730463,0.006379585326953748
10368,544,496,48,497,47,0.9117647058823529,0.08823529411764706,0.9136029411764706,0.08639705882352941,172,5,23,144,164,8,0.029069767441860465,0.13372093023255813,0.8372093023255814,0.9534883720930233,0.046511627906976744
10369,473,417,56,415,58,0.8816067653276956,0.11839323467230443,0.8773784355179705,0.1226215644820296,184,5,23,156,174,10,0.02717391304347826,0.125,0.8478260869565217,0.9456521739130435,0.05434782608695652
10370,488,408,80,413,75,0.8360655737704918,0.16393442622950818,0.8463114754098361,0.15368852459016394,169,5,23,141,161,8,0.029585798816568046,0.13609467455621302,0.834319526627219,0.9526627218934911,0.047337278106508875
10371,487,430,57,436,51,0.8829568788501027,0.11704312114989733,0.8952772073921971,0.10472279260780287,169,5,23,141,158,11,0.029585798816568046,0.13609467455621302,0.834319526627219,0.9349112426035503,0.0650887573964497
10372,890,782,108,854,36,0.8786516853932584,0.12134831460674157,0.9595505617977528,0.04044943820224719,1425,56,669,700,1419,6,0.03929824561403509,0.4694736842105263,0.49122807017543857,0.9957894736842106,0.004210526315789474
10373,261,224,37,230,31,0.8582375478927203,0.1417624521072797,0.8812260536398467,0.11877394636015326,156,5,23,128,148,8,0.03205128205128205,0.14743589743589744,0.8205128205128205,0.9487179487179487,0.05128205128205128
10374,487,430,57,436,51,0.8829568788501027,0.11704312114989733,0.8952772073921971,0.10472279260780287,152,5,23,124,146,6,0.03289473684210526,0.1513157894736842,0.8157894736842105,0.9605263157894737,0.039473684210526314
10375,356,316,40,317,39,0.8876404494382022,0.11235955056179775,0.8904494382022472,0.10955056179775281,156,4,24,128,149,7,0.02564102564102564,0.15384615384615385,0.8205128205128205,0.9551282051282052,0.04487179487179487
10376,778,625,153,730,48,0.8033419023136247,0.19665809768637532,0.9383033419023136,0.061696658097686374,1176,69,559,548,1168,8,0.058673469387755105,0.47534013605442177,0.46598639455782315,0.9931972789115646,0.006802721088435374
10377,767,601,166,723,44,0.7835723598435462,0.21642764015645372,0.9426336375488917,0.05736636245110821,710,75,322,313,709,1,0.1056338028169014,0.4535211267605634,0.44084507042253523,0.9985915492957746,0.0014084507042253522
10378,238,203,35,212,26,0.8529411764705882,0.14705882352941177,0.8907563025210085,0.1092436974789916,151,5,22,124,145,6,0.033112582781456956,0.1456953642384106,0.8211920529801324,0.9602649006622517,0.039735099337748346
10379,1215,1087,128,1177,38,0.8946502057613168,0.10534979423868313,0.968724279835391,0.031275720164609055,1189,80,554,555,1184,5,0.0672834314550042,0.4659377628259041,0.4667788057190917,0.9957947855340622,0.004205214465937763
10380,444,382,62,385,59,0.8603603603603603,0.13963963963963963,0.8671171171171171,0.13288288288288289,151,5,23,123,144,7,0.033112582781456956,0.152317880794702,0.8145695364238411,0.9536423841059603,0.046357615894039736
10381,602,451,151,562,40,0.7491694352159468,0.25083056478405313,0.9335548172757475,0.0664451827242525,756,55,321,380,751,5,0.07275132275132275,0.4246031746031746,0.5026455026455027,0.9933862433862434,0.006613756613756613
10382,281,228,53,230,51,0.8113879003558719,0.18861209964412812,0.8185053380782918,0.18149466192170818,147,5,23,119,137,10,0.034013605442176874,0.1564625850340136,0.8095238095238095,0.9319727891156463,0.06802721088435375
10383,228,198,30,205,23,0.868421052631579,0.13157894736842105,0.8991228070175439,0.10087719298245613,166,4,24,138,156,10,0.024096385542168676,0.14457831325301204,0.8313253012048193,0.9397590361445783,0.060240963855421686
10384,327,282,45,290,37,0.8623853211009175,0.13761467889908258,0.8868501529051988,0.11314984709480122,183,4,24,155,172,11,0.02185792349726776,0.13114754098360656,0.8469945355191257,0.9398907103825137,0.060109289617486336
10385,1259,1018,241,1187,72,0.8085782366957903,0.19142176330420968,0.9428117553613979,0.057188244638602066,725,85,304,336,722,3,0.11724137931034483,0.4193103448275862,0.463448275862069,0.9958620689655172,0.004137931034482759
10386,315,102,213,171,144,0.3238095238095238,0.6761904761904762,0.5428571428571428,0.45714285714285713,111,0,50,61,109,2,0.0,0.45045045045045046,0.5495495495495496,0.9819819819819819,0.018018018018018018
10387,1417,1218,199,1348,69,0.8595624558927312,0.14043754410726889,0.9513055751587862,0.048694424841213835,1835,49,884,902,1832,3,0.02670299727520436,0.4817438692098093,0.49155313351498636,0.9983651226158038,0.0016348773841961854
10388,261,224,37,230,31,0.8582375478927203,0.1417624521072797,0.8812260536398467,0.11877394636015326,176,5,23,148,168,8,0.028409090909090908,0.13068181818181818,0.8409090909090909,0.9545454545454546,0.045454545454545456
10389,1464,1202,262,1399,65,0.8210382513661202,0.17896174863387979,0.9556010928961749,0.04439890710382514,1093,68,525,500,1088,5,0.06221408966148216,0.48032936870997256,0.45745654162854527,0.9954254345837146,0.004574565416285453
10390,504,461,43,463,41,0.9146825396825397,0.08531746031746032,0.9186507936507936,0.08134920634920635,164,5,23,136,156,8,0.03048780487804878,0.1402439024390244,0.8292682926829268,0.9512195121951219,0.04878048780487805
10391,310,264,46,264,46,0.8516129032258064,0.14838709677419354,0.8516129032258064,0.14838709677419354,157,5,23,129,151,6,0.03184713375796178,0.1464968152866242,0.821656050955414,0.9617834394904459,0.03821656050955414
10392,426,364,62,370,56,0.8544600938967136,0.14553990610328638,0.8685446009389671,0.13145539906103287,171,5,23,143,162,9,0.029239766081871343,0.13450292397660818,0.8362573099415205,0.9473684210526315,0.05263157894736842
10393,283,94,189,146,137,0.3321554770318021,0.6678445229681979,0.5159010600706714,0.4840989399293286,79,0,29,50,77,2,0.0,0.3670886075949367,0.6329113924050633,0.9746835443037974,0.02531645569620253
10394,1636,1404,232,1570,66,0.8581907090464548,0.14180929095354522,0.9596577017114915,0.040342298288508556,2259,49,1086,1124,2252,7,0.021691013722886232,0.4807436918990704,0.49756529437804337,0.9969012837538734,0.003098716246126605
10395,272,225,47,227,45,0.8272058823529411,0.17279411764705882,0.8345588235294118,0.16544117647058823,155,4,24,127,147,8,0.025806451612903226,0.15483870967741936,0.8193548387096774,0.9483870967741935,0.05161290322580645
10396,0,0,0,0,0,0.0,0.0,0.0,0.0,6,0,0,6,6,0,0.0,0.0,1.0,1.0,0.0
10397,290,219,71,228,62,0.7551724137931034,0.24482758620689654,0.7862068965517242,0.21379310344827587,152,5,24,123,145,7,0.03289473684210526,0.15789473684210525,0.8092105263157895,0.9539473684210527,0.046052631578947366
10398,1014,916,98,966,48,0.903353057199211,0.09664694280078895,0.9526627218934911,0.047337278106508875,1250,32,599,619,1246,4,0.0256,0.4792,0.4952,0.9968,0.0032
10399,1136,921,215,1084,52,0.8107394366197183,0.1892605633802817,0.954225352112676,0.045774647887323945,1329,53,645,631,1324,5,0.0398796087283672,0.4853273137697517,0.4747930775018811,0.9962377727614747,0.003762227238525207
10400,417,366,51,365,52,0.8776978417266187,0.1223021582733813,0.8752997601918465,0.12470023980815348,133,5,23,105,125,8,0.03759398496240601,0.17293233082706766,0.7894736842105263,0.9398496240601504,0.06015037593984962
10401,264,72,192,150,114,0.2727272727272727,0.7272727272727273,0.5681818181818182,0.4318181818181818,121,1,57,63,115,6,0.008264462809917356,0.47107438016528924,0.5206611570247934,0.9504132231404959,0.049586776859504134
10402,314,286,28,289,25,0.910828025477707,0.08917197452229299,0.9203821656050956,0.07961783439490445,156,5,23,128,148,8,0.03205128205128205,0.14743589743589744,0.8205128205128205,0.9487179487179487,0.05128205128205128
10403,206,163,43,165,41,0.7912621359223301,0.2087378640776699,0.8009708737864077,0.19902912621359223,173,5,23,145,164,9,0.028901734104046242,0.1329479768786127,0.838150289017341,0.9479768786127167,0.05202312138728324
10404,300,80,220,158,142,0.26666666666666666,0.7333333333333333,0.5266666666666666,0.47333333333333333,106,1,51,54,102,4,0.009433962264150943,0.4811320754716981,0.5094339622641509,0.9622641509433962,0.03773584905660377
10405,1436,1221,215,1401,35,0.8502785515320335,0.14972144846796656,0.9756267409470752,0.02437325905292479,988,43,457,488,980,8,0.043522267206477734,0.4625506072874494,0.4939271255060729,0.9919028340080972,0.008097165991902834
10406,982,847,135,953,29,0.8625254582484725,0.13747454175152748,0.9704684317718941,0.029531568228105907,1333,61,610,662,1328,5,0.04576144036009002,0.4576144036009002,0.4966241560390098,0.9962490622655664,0.0037509377344336083
10407,1242,1146,96,1217,25,0.9227053140096618,0.07729468599033816,0.9798711755233495,0.020128824476650563,914,48,435,431,911,3,0.0525164113785558,0.4759299781181619,0.47155361050328226,0.9967177242888403,0.0032822757111597373
10408,867,695,172,819,48,0.8016147635524798,0.19838523644752018,0.9446366782006921,0.05536332179930796,655,84,291,280,654,1,0.1282442748091603,0.4442748091603053,0.42748091603053434,0.9984732824427481,0.0015267175572519084
10409,1083,866,217,1030,53,0.7996306555863343,0.20036934441366575,0.951061865189289,0.048938134810710986,553,96,273,184,552,1,0.1735985533453888,0.4936708860759494,0.33273056057866185,0.9981916817359855,0.0018083182640144665
10410,217,172,45,178,39,0.7926267281105991,0.2073732718894009,0.8202764976958525,0.17972350230414746,154,5,23,126,146,8,0.032467532467532464,0.14935064935064934,0.8181818181818182,0.948051948051948,0.05194805194805195
10411,275,245,30,253,22,0.8909090909090909,0.10909090909090909,0.92,0.08,159,5,23,131,154,5,0.031446540880503145,0.14465408805031446,0.8238993710691824,0.9685534591194969,0.031446540880503145
10412,236,178,58,176,60,0.7542372881355932,0.2457627118644068,0.7457627118644068,0.2542372881355932,141,5,23,113,133,8,0.03546099290780142,0.16312056737588654,0.8014184397163121,0.9432624113475178,0.05673758865248227
10413,881,719,162,831,50,0.8161180476730987,0.18388195232690124,0.9432463110102156,0.056753688989784334,601,85,251,265,600,1,0.14143094841930118,0.4176372712146423,0.44093178036605657,0.9983361064891847,0.0016638935108153079
10414,345,290,55,298,47,0.8405797101449275,0.15942028985507245,0.863768115942029,0.13623188405797101,181,5,24,152,171,10,0.027624309392265192,0.13259668508287292,0.8397790055248618,0.9447513812154696,0.055248618784530384
10415,1047,823,224,974,73,0.7860553963705826,0.2139446036294174,0.9302769818529131,0.06972301814708691,642,96,272,274,641,1,0.14953271028037382,0.4236760124610592,0.42679127725856697,0.9984423676012462,0.001557632398753894
10416,1074,864,210,998,76,0.8044692737430168,0.19553072625698323,0.9292364990689013,0.07076350093109869,1033,66,484,483,1026,7,0.06389157792836399,0.46853823814133594,0.4675701839303001,0.9932236205227493,0.006776379477250726
10417,420,360,60,367,53,0.8571428571428571,0.14285714285714285,0.8738095238095238,0.1261904761904762,173,5,23,145,163,10,0.028901734104046242,0.1329479768786127,0.838150289017341,0.9421965317919075,0.057803468208092484
10418,415,367,48,370,45,0.8843373493975903,0.11566265060240964,0.891566265060241,0.10843373493975904,154,4,24,126,145,9,0.025974025974025976,0.15584415584415584,0.8181818181818182,0.9415584415584416,0.05844155844155844
10419,303,261,42,260,43,0.8613861386138614,0.13861386138613863,0.858085808580858,0.1419141914191419,198,4,24,170,188,10,0.020202020202020204,0.12121212121212122,0.8585858585858586,0.9494949494949495,0.050505050505050504
10420,291,243,48,247,44,0.8350515463917526,0.16494845360824742,0.8487972508591065,0.15120274914089346,190,5,23,162,179,11,0.02631578947368421,0.12105263157894737,0.8526315789473684,0.9421052631578948,0.05789473684210526
10421,1140,932,208,1091,49,0.8175438596491228,0.1824561403508772,0.9570175438596491,0.04298245614035088,1109,59,499,551,1102,7,0.05320108205590622,0.4499549143372408,0.49684400360685305,0.9936880072137061,0.0063119927862939585
10422,303,259,44,266,37,0.8547854785478548,0.14521452145214522,0.8778877887788779,0.12211221122112212,155,4,24,127,148,7,0.025806451612903226,0.15483870967741936,0.8193548387096774,0.9548387096774194,0.04516129032258064
10423,645,514,131,611,34,0.7968992248062016,0.20310077519379846,0.9472868217054263,0.05271317829457364,610,73,286,251,609,1,0.11967213114754098,0.46885245901639344,0.41147540983606556,0.9983606557377049,0.001639344262295082
10424,1532,1286,246,1470,62,0.839425587467363,0.16057441253263707,0.9595300261096605,0.04046997389033943,1281,58,622,601,1276,5,0.04527712724434036,0.4855581576893052,0.46916471506635443,0.9960967993754879,0.0039032006245121
10425,1476,1304,172,1431,45,0.8834688346883469,0.11653116531165311,0.9695121951219512,0.03048780487804878,1039,47,499,493,1035,4,0.04523580365736285,0.480269489894129,0.47449470644850816,0.9961501443695862,0.0038498556304138597
10426,369,323,46,329,40,0.8753387533875339,0.12466124661246612,0.8915989159891599,0.10840108401084012,185,5,23,157,174,11,0.02702702702702703,0.12432432432432433,0.8486486486486486,0.9405405405405406,0.05945945945945946
10427,755,661,94,710,45,0.8754966887417218,0.12450331125827814,0.9403973509933775,0.059602649006622516,948,55,441,452,941,7,0.0580168776371308,0.4651898734177215,0.4767932489451477,0.9926160337552743,0.007383966244725738
10428,245,70,175,122,123,0.2857142857142857,0.7142857142857143,0.49795918367346936,0.5020408163265306,94,0,37,57,90,4,0.0,0.39361702127659576,0.6063829787234043,0.9574468085106383,0.0425531914893617
10429,616,557,59,558,58,0.9042207792207793,0.09577922077922078,0.9058441558441559,0.09415584415584416,165,5,23,137,156,9,0.030303030303030304,0.1393939393939394,0.8303030303030303,0.9454545454545454,0.05454545454545454
10430,4856,4149,707,3966,890,0.8544069192751236,0.14559308072487645,0.8167215815485996,0.18327841845140033,1001,125,263,613,695,306,0.12487512487512488,0.2627372627372627,0.6123876123876124,0.6943056943056943,0.30569430569430567
10431,294,79,215,159,135,0.2687074829931973,0.7312925170068028,0.5408163265306123,0.45918367346938777,97,0,48,49,94,3,0.0,0.4948453608247423,0.5051546391752577,0.9690721649484536,0.030927835051546393
10432,351,297,54,298,53,0.8461538461538461,0.15384615384615385,0.8490028490028491,0.150997150997151,159,5,23,131,152,7,0.031446540880503145,0.14465408805031446,0.8238993710691824,0.9559748427672956,0.0440251572327044
10433,1060,809,251,1002,58,0.7632075471698113,0.23679245283018868,0.9452830188679245,0.05471698113207547,717,92,300,325,716,1,0.12831241283124128,0.41841004184100417,0.45327754532775455,0.99860529986053,0.001394700139470014
10434,1150,952,198,1089,61,0.8278260869565217,0.17217391304347826,0.9469565217391305,0.05304347826086957,468,48,209,211,464,4,0.10256410256410256,0.4465811965811966,0.45085470085470086,0.9914529914529915,0.008547008547008548
10435,315,248,67,255,60,0.7873015873015873,0.2126984126984127,0.8095238095238095,0.19047619047619047,154,5,24,125,146,8,0.032467532467532464,0.15584415584415584,0.8116883116883117,0.948051948051948,0.05194805194805195
10436,1682,1409,273,1606,76,0.8376932223543401,0.16230677764565993,0.9548156956004756,0.04518430439952437,1155,45,548,562,1151,4,0.03896103896103896,0.47445887445887447,0.48658008658008656,0.9965367965367965,0.003463203463203463
10437,294,79,215,157,137,0.2687074829931973,0.7312925170068028,0.5340136054421769,0.46598639455782315,112,0,52,60,111,1,0.0,0.4642857142857143,0.5357142857142857,0.9910714285714286,0.008928571428571428
10438,915,751,164,894,21,0.8207650273224044,0.17923497267759564,0.9770491803278688,0.022950819672131147,581,84,231,266,580,1,0.14457831325301204,0.39759036144578314,0.4578313253012048,0.9982788296041308,0.0017211703958691911
10439,425,377,48,379,46,0.8870588235294118,0.11294117647058824,0.8917647058823529,0.10823529411764705,200,5,23,172,192,8,0.025,0.115,0.86,0.96,0.04
10440,194,143,51,151,43,0.7371134020618557,0.26288659793814434,0.7783505154639175,0.22164948453608246,155,5,24,126,146,9,0.03225806451612903,0.15483870967741936,0.8129032258064516,0.9419354838709677,0.05806451612903226
10441,203,156,47,161,42,0.7684729064039408,0.2315270935960591,0.7931034482758621,0.20689655172413793,148,4,24,120,140,8,0.02702702702702703,0.16216216216216217,0.8108108108108109,0.9459459459459459,0.05405405405405406
10442,287,247,40,249,38,0.8606271777003485,0.13937282229965156,0.867595818815331,0.13240418118466898,129,4,24,101,124,5,0.031007751937984496,0.18604651162790697,0.7829457364341085,0.9612403100775194,0.03875968992248062
10443,1417,1218,199,1348,69,0.8595624558927312,0.14043754410726889,0.9513055751587862,0.048694424841213835,1835,49,884,902,1832,3,0.02670299727520436,0.4817438692098093,0.49155313351498636,0.9983651226158038,0.0016348773841961854
10444,1045,835,210,982,63,0.7990430622009569,0.20095693779904306,0.939712918660287,0.06028708133971292,687,107,270,310,686,1,0.15574963609898107,0.3930131004366812,0.4512372634643377,0.9985443959243085,0.001455604075691412
10445,384,333,51,335,49,0.8671875,0.1328125,0.8723958333333334,0.12760416666666666,156,5,23,128,148,8,0.03205128205128205,0.14743589743589744,0.8205128205128205,0.9487179487179487,0.05128205128205128
10446,370,308,62,311,59,0.8324324324324325,0.16756756756756758,0.8405405405405405,0.15945945945945947,155,5,23,127,149,6,0.03225806451612903,0.14838709677419354,0.8193548387096774,0.9612903225806452,0.03870967741935484
10447,355,267,88,319,36,0.752112676056338,0.24788732394366197,0.8985915492957747,0.10140845070422536,577,69,266,242,575,2,0.1195840554592721,0.4610051993067591,0.4194107452339688,0.9965337954939342,0.0034662045060658577
10448,616,557,59,558,58,0.9042207792207793,0.09577922077922078,0.9058441558441559,0.09415584415584416,167,5,23,139,160,7,0.029940119760479042,0.1377245508982036,0.8323353293413174,0.9580838323353293,0.041916167664670656
10449,211,170,41,177,34,0.8056872037914692,0.1943127962085308,0.8388625592417062,0.16113744075829384,170,5,24,141,162,8,0.029411764705882353,0.1411764705882353,0.8294117647058824,0.9529411764705882,0.047058823529411764
10450,1278,936,342,1124,154,0.7323943661971831,0.2676056338028169,0.8794992175273866,0.12050078247261346,638,66,183,389,533,105,0.10344827586206896,0.28683385579937304,0.609717868338558,0.835423197492163,0.164576802507837
10451,313,275,38,283,30,0.8785942492012779,0.12140575079872204,0.9041533546325878,0.09584664536741214,157,5,23,129,151,6,0.03184713375796178,0.1464968152866242,0.821656050955414,0.9617834394904459,0.03821656050955414
10452,238,203,35,212,26,0.8529411764705882,0.14705882352941177,0.8907563025210085,0.1092436974789916,168,5,23,140,159,9,0.02976190476190476,0.13690476190476192,0.8333333333333334,0.9464285714285714,0.05357142857142857
10453,1123,936,187,1080,43,0.8334817453250223,0.16651825467497774,0.9617097061442564,0.03829029385574354,697,110,274,313,694,3,0.15781922525107603,0.3931133428981349,0.4490674318507891,0.9956958393113343,0.00430416068866571
10454,1064,848,216,1000,64,0.7969924812030075,0.20300751879699247,0.9398496240601504,0.06015037593984962,746,109,375,262,743,3,0.14611260053619302,0.5026809651474531,0.3512064343163539,0.9959785522788204,0.004021447721179625
10455,394,342,52,344,50,0.868020304568528,0.1319796954314721,0.8730964467005076,0.12690355329949238,131,5,23,103,125,6,0.03816793893129771,0.17557251908396945,0.7862595419847328,0.9541984732824428,0.04580152671755725
10456,2056,1779,277,1998,58,0.8652723735408561,0.13472762645914396,0.9717898832684825,0.02821011673151751,1122,40,542,540,1117,5,0.035650623885918005,0.483065953654189,0.48128342245989303,0.9955436720142602,0.004456327985739751
10457,1236,1073,163,1178,58,0.8681229773462783,0.13187702265372167,0.9530744336569579,0.04692556634304207,1059,62,513,484,1055,4,0.05854579792256846,0.48441926345609065,0.45703493862134087,0.996222851746931,0.003777148253068933
10458,191,134,57,143,48,0.7015706806282722,0.29842931937172773,0.7486910994764397,0.2513089005235602,156,5,24,127,150,6,0.03205128205128205,0.15384615384615385,0.8141025641025641,0.9615384615384616,0.038461538461538464
10459,124,78,46,87,37,0.6290322580645161,0.3709677419354839,0.7016129032258065,0.29838709677419356,156,5,24,127,149,7,0.03205128205128205,0.15384615384615385,0.8141025641025641,0.9551282051282052,0.04487179487179487
10460,319,263,56,269,50,0.8244514106583072,0.1755485893416928,0.8432601880877743,0.15673981191222572,159,5,23,131,149,10,0.031446540880503145,0.14465408805031446,0.8238993710691824,0.9371069182389937,0.06289308176100629
10461,289,87,202,168,121,0.30103806228373703,0.698961937716263,0.5813148788927336,0.4186851211072664,111,0,53,58,108,3,0.0,0.4774774774774775,0.5225225225225225,0.972972972972973,0.02702702702702703
10462,992,865,127,961,31,0.8719758064516129,0.1280241935483871,0.96875,0.03125,1659,52,812,795,1651,8,0.03134418324291742,0.48945147679324896,0.47920433996383366,0.995177817962628,0.004822182037371911
10463,303,261,42,260,43,0.8613861386138614,0.13861386138613863,0.858085808580858,0.1419141914191419,198,4,24,170,188,10,0.020202020202020204,0.12121212121212122,0.8585858585858586,0.9494949494949495,0.050505050505050504
10464,415,367,48,370,45,0.8843373493975903,0.11566265060240964,0.891566265060241,0.10843373493975904,169,4,23,142,164,5,0.023668639053254437,0.13609467455621302,0.8402366863905325,0.9704142011834319,0.029585798816568046
10465,222,187,35,195,27,0.8423423423423423,0.15765765765765766,0.8783783783783784,0.12162162162162163,175,4,24,147,168,7,0.022857142857142857,0.13714285714285715,0.84,0.96,0.04
10466,303,261,42,260,43,0.8613861386138614,0.13861386138613863,0.858085808580858,0.1419141914191419,152,4,24,124,144,8,0.02631578947368421,0.15789473684210525,0.8157894736842105,0.9473684210526315,0.05263157894736842
10467,211,170,41,177,34,0.8056872037914692,0.1943127962085308,0.8388625592417062,0.16113744075829384,170,5,24,141,162,8,0.029411764705882353,0.1411764705882353,0.8294117647058824,0.9529411764705882,0.047058823529411764
10468,774,592,182,724,50,0.7648578811369509,0.2351421188630491,0.9354005167958657,0.06459948320413436,669,88,270,311,668,1,0.13153961136023917,0.40358744394618834,0.4648729446935725,0.9985052316890882,0.0014947683109118087
10469,1237,988,249,964,273,0.7987065481002426,0.20129345189975748,0.7793047696038804,0.22069523039611966,481,11,95,375,311,170,0.02286902286902287,0.19750519750519752,0.7796257796257796,0.6465696465696466,0.35343035343035345
10470,866,670,196,802,64,0.7736720554272517,0.22632794457274827,0.9260969976905312,0.07390300230946882,658,101,261,296,655,3,0.1534954407294833,0.3966565349544073,0.44984802431610943,0.9954407294832827,0.004559270516717325
10471,228,202,26,205,23,0.8859649122807017,0.11403508771929824,0.8991228070175439,0.10087719298245613,165,5,23,137,156,9,0.030303030303030304,0.1393939393939394,0.8303030303030303,0.9454545454545454,0.05454545454545454
10472,374,310,64,316,58,0.8288770053475936,0.1711229946524064,0.8449197860962567,0.15508021390374332,199,5,23,171,189,10,0.02512562814070352,0.11557788944723618,0.8592964824120602,0.949748743718593,0.05025125628140704
10473,983,825,158,936,47,0.8392675483214649,0.1607324516785351,0.9521871820956256,0.04781281790437437,1000,44,472,484,992,8,0.044,0.472,0.484,0.992,0.008
10474,444,382,62,385,59,0.8603603603603603,0.13963963963963963,0.8671171171171171,0.13288288288288289,151,5,23,123,144,7,0.033112582781456956,0.152317880794702,0.8145695364238411,0.9536423841059603,0.046357615894039736
10475,2056,1779,277,1998,58,0.8652723735408561,0.13472762645914396,0.9717898832684825,0.02821011673151751,1122,40,542,540,1117,5,0.035650623885918005,0.483065953654189,0.48128342245989303,0.9955436720142602,0.004456327985739751
10476,923,824,99,898,25,0.8927410617551462,0.10725893824485373,0.9729144095341279,0.027085590465872156,1198,55,577,566,1193,5,0.045909849749582635,0.48163606010016696,0.4724540901502504,0.9958263772954925,0.004173622704507512
10477,1694,1429,265,1649,45,0.8435655253837072,0.15643447461629278,0.973435655253837,0.026564344746162927,1114,44,534,536,1111,3,0.03949730700179533,0.4793536804308797,0.48114901256732495,0.9973070017953322,0.0026929982046678637
10478,431,372,59,371,60,0.8631090487238979,0.1368909512761021,0.8607888631090487,0.13921113689095127,157,5,23,129,150,7,0.03184713375796178,0.1464968152866242,0.821656050955414,0.9554140127388535,0.044585987261146494
10479,2260,1970,290,2182,78,0.8716814159292036,0.12831858407079647,0.9654867256637168,0.034513274336283185,1242,48,579,615,1235,7,0.03864734299516908,0.46618357487922707,0.49516908212560384,0.9943639291465378,0.005636070853462158
10480,224,212,12,168,56,0.9464285714285714,0.05357142857142857,0.75,0.25,168,59,52,57,154,14,0.35119047619047616,0.30952380952380953,0.3392857142857143,0.9166666666666666,0.08333333333333333
10481,380,320,60,324,56,0.8421052631578947,0.15789473684210525,0.8526315789473684,0.14736842105263157,148,5,23,120,141,7,0.033783783783783786,0.1554054054054054,0.8108108108108109,0.9527027027027027,0.0472972972972973
10482,1333,1071,262,1000,333,0.8034508627156789,0.19654913728432108,0.7501875468867217,0.24981245311327832,70,0,0,70,66,4,0.0,0.0,1.0,0.9428571428571428,0.05714285714285714
10483,1734,1462,272,1652,82,0.8431372549019608,0.1568627450980392,0.9527104959630911,0.04728950403690888,1153,59,544,550,1149,4,0.05117085862966175,0.47181266261925414,0.4770164787510841,0.9965307892454467,0.003469210754553339
10484,218,183,35,190,28,0.8394495412844036,0.16055045871559634,0.8715596330275229,0.12844036697247707,154,5,24,125,148,6,0.032467532467532464,0.15584415584415584,0.8116883116883117,0.961038961038961,0.03896103896103896
10485,297,106,191,186,111,0.3569023569023569,0.6430976430976431,0.6262626262626263,0.37373737373737376,128,0,59,69,126,2,0.0,0.4609375,0.5390625,0.984375,0.015625
10486,1465,1280,185,1402,63,0.8737201365187713,0.12627986348122866,0.9569965870307168,0.043003412969283276,1594,36,776,782,1591,3,0.02258469259723965,0.4868255959849435,0.4905897114178168,0.9981179422835633,0.0018820577164366374
10487,462,409,53,414,48,0.8852813852813853,0.11471861471861472,0.8961038961038961,0.1038961038961039,163,5,23,135,156,7,0.03067484662576687,0.1411042944785276,0.8282208588957055,0.9570552147239264,0.04294478527607362
10488,238,203,35,212,26,0.8529411764705882,0.14705882352941177,0.8907563025210085,0.1092436974789916,188,5,23,160,181,7,0.026595744680851064,0.12234042553191489,0.851063829787234,0.9627659574468085,0.03723404255319149
10489,345,290,55,298,47,0.8405797101449275,0.15942028985507245,0.863768115942029,0.13623188405797101,145,5,24,116,137,8,0.034482758620689655,0.16551724137931034,0.8,0.9448275862068966,0.05517241379310345
10490,807,653,154,766,41,0.8091697645600991,0.19083023543990088,0.9491945477075588,0.05080545229244114,992,80,458,454,986,6,0.08064516129032258,0.46169354838709675,0.4576612903225806,0.9939516129032258,0.006048387096774193
10491,892,707,185,845,47,0.7926008968609866,0.20739910313901344,0.9473094170403588,0.052690582959641255,582,72,242,268,580,2,0.12371134020618557,0.41580756013745707,0.46048109965635736,0.9965635738831615,0.003436426116838488
10492,1734,1462,272,1652,82,0.8431372549019608,0.1568627450980392,0.9527104959630911,0.04728950403690888,1153,59,544,550,1149,4,0.05117085862966175,0.47181266261925414,0.4770164787510841,0.9965307892454467,0.003469210754553339
10493,1100,932,168,1068,32,0.8472727272727273,0.15272727272727274,0.9709090909090909,0.02909090909090909,994,61,463,470,987,7,0.0613682092555332,0.46579476861167,0.47283702213279677,0.9929577464788732,0.007042253521126761
10494,487,430,57,433,54,0.8829568788501027,0.11704312114989733,0.8891170431211499,0.11088295687885011,167,5,23,139,158,9,0.029940119760479042,0.1377245508982036,0.8323353293413174,0.9461077844311377,0.05389221556886228
10495,352,300,52,305,47,0.8522727272727273,0.14772727272727273,0.8664772727272727,0.13352272727272727,156,4,24,128,148,8,0.02564102564102564,0.15384615384615385,0.8205128205128205,0.9487179487179487,0.05128205128205128
10496,1042,833,209,987,55,0.7994241842610365,0.20057581573896352,0.9472168905950096,0.052783109404990404,1013,55,482,476,1006,7,0.054294175715695954,0.47581441263573543,0.4698914116485686,0.9930898321816387,0.006910167818361303
10497,476,418,58,424,52,0.8781512605042017,0.12184873949579832,0.8907563025210085,0.1092436974789916,155,4,24,127,149,6,0.025806451612903226,0.15483870967741936,0.8193548387096774,0.9612903225806452,0.03870967741935484
10498,779,672,107,758,21,0.8626444159178434,0.13735558408215662,0.9730423620025674,0.026957637997432605,878,42,421,415,869,9,0.04783599088838269,0.479498861047836,0.47266514806378135,0.989749430523918,0.010250569476082005
10499,261,211,50,217,44,0.8084291187739464,0.19157088122605365,0.8314176245210728,0.1685823754789272,154,5,23,126,148,6,0.032467532467532464,0.14935064935064934,0.8181818181818182,0.961038961038961,0.03896103896103896
10500,2313,2069,244,2252,61,0.8945092952875054,0.1054907047124946,0.9736273238218763,0.02637267617812365,988,58,463,467,984,4,0.058704453441295545,0.4686234817813765,0.4726720647773279,0.9959514170040485,0.004048582995951417
10501,228,184,44,190,38,0.8070175438596491,0.19298245614035087,0.8333333333333334,0.16666666666666666,165,5,23,137,158,7,0.030303030303030304,0.1393939393939394,0.8303030303030303,0.9575757575757575,0.04242424242424243
10502,327,266,61,265,62,0.8134556574923547,0.18654434250764526,0.8103975535168195,0.18960244648318042,141,5,23,113,136,5,0.03546099290780142,0.16312056737588654,0.8014184397163121,0.9645390070921985,0.03546099290780142
10503,310,264,46,264,46,0.8516129032258064,0.14838709677419354,0.8516129032258064,0.14838709677419354,161,5,23,133,151,10,0.031055900621118012,0.14285714285714285,0.8260869565217391,0.937888198757764,0.062111801242236024
10504,393,341,52,344,49,0.8676844783715013,0.13231552162849872,0.8753180661577609,0.12468193384223919,160,5,23,132,154,6,0.03125,0.14375,0.825,0.9625,0.0375
10505,241,178,63,182,59,0.7385892116182573,0.26141078838174275,0.7551867219917012,0.24481327800829875,156,4,24,128,150,6,0.02564102564102564,0.15384615384615385,0.8205128205128205,0.9615384615384616,0.038461538461538464
10506,1274,1048,226,1206,68,0.8226059654631083,0.17739403453689168,0.9466248037676609,0.05337519623233909,603,83,261,259,602,1,0.13764510779436154,0.43283582089552236,0.4295190713101161,0.9983416252072969,0.001658374792703151
10507,1779,1545,234,1713,66,0.8684654300168634,0.1315345699831366,0.9629005059021922,0.03709949409780776,958,49,456,453,955,3,0.0511482254697286,0.4759916492693111,0.47286012526096033,0.9968684759916493,0.003131524008350731
10508,1010,799,211,962,48,0.7910891089108911,0.2089108910891089,0.9524752475247524,0.047524752475247525,607,87,303,217,606,1,0.14332784184514002,0.49917627677100496,0.357495881383855,0.9983525535420099,0.0016474464579901153
10509,478,424,54,430,48,0.8870292887029289,0.11297071129707113,0.899581589958159,0.100418410041841,144,5,23,116,136,8,0.034722222222222224,0.1597222222222222,0.8055555555555556,0.9444444444444444,0.05555555555555555
10510,1074,857,217,1027,47,0.797951582867784,0.20204841713221602,0.9562383612662942,0.043761638733705775,1295,62,613,620,1288,7,0.047876447876447875,0.47335907335907335,0.47876447876447875,0.9945945945945946,0.005405405405405406
10511,592,517,75,579,13,0.8733108108108109,0.1266891891891892,0.9780405405405406,0.02195945945945946,744,46,338,360,732,12,0.06182795698924731,0.4543010752688172,0.4838709677419355,0.9838709677419355,0.016129032258064516
10512,857,672,185,803,54,0.7841306884480747,0.21586931155192532,0.9369894982497082,0.06301050175029171,795,81,350,364,794,1,0.1018867924528302,0.44025157232704404,0.4578616352201258,0.9987421383647799,0.0012578616352201257
10513,1560,1343,217,1505,55,0.860897435897436,0.1391025641025641,0.9647435897435898,0.035256410256410256,1051,48,505,498,1047,4,0.04567078972407231,0.4804947668886774,0.4738344433872502,0.9961941008563273,0.003805899143672693
10514,1264,1009,255,1198,66,0.7982594936708861,0.20174050632911392,0.9477848101265823,0.05221518987341772,953,42,455,456,948,5,0.04407135362014691,0.4774396642182581,0.47848898216159497,0.9947534102833159,0.005246589716684155
10515,442,372,70,374,68,0.8416289592760181,0.1583710407239819,0.8461538461538461,0.15384615384615385,169,5,23,141,161,8,0.029585798816568046,0.13609467455621302,0.834319526627219,0.9526627218934911,0.047337278106508875
10516,124,78,46,87,37,0.6290322580645161,0.3709677419354839,0.7016129032258065,0.29838709677419356,155,5,24,126,149,6,0.03225806451612903,0.15483870967741936,0.8129032258064516,0.9612903225806452,0.03870967741935484
10517,1040,828,212,980,60,0.7961538461538461,0.20384615384615384,0.9423076923076923,0.057692307692307696,757,52,363,342,753,4,0.06869220607661823,0.4795244385733157,0.45178335535006603,0.9947159841479525,0.005284015852047556
10518,285,235,50,242,43,0.8245614035087719,0.17543859649122806,0.8491228070175438,0.15087719298245614,174,5,23,146,164,10,0.028735632183908046,0.13218390804597702,0.8390804597701149,0.9425287356321839,0.05747126436781609
10519,431,386,45,388,43,0.8955916473317865,0.10440835266821345,0.9002320185614849,0.09976798143851508,148,5,23,120,140,8,0.033783783783783786,0.1554054054054054,0.8108108108108109,0.9459459459459459,0.05405405405405406
10520,1575,1364,211,1507,68,0.866031746031746,0.13396825396825396,0.9568253968253968,0.04317460317460318,1109,62,534,513,1104,5,0.05590622182146077,0.48151487826871053,0.4625788999098287,0.9954914337240758,0.004508566275924256
10521,1242,1146,96,1217,25,0.9227053140096618,0.07729468599033816,0.9798711755233495,0.020128824476650563,914,48,435,431,911,3,0.0525164113785558,0.4759299781181619,0.47155361050328226,0.9967177242888403,0.0032822757111597373
10522,855,691,164,825,30,0.808187134502924,0.19181286549707602,0.9649122807017544,0.03508771929824561,585,89,257,239,584,1,0.15213675213675212,0.4393162393162393,0.40854700854700854,0.9982905982905983,0.0017094017094017094
10523,1335,1151,184,1277,58,0.8621722846441947,0.13782771535580524,0.9565543071161049,0.04344569288389513,2095,54,1003,1038,2089,6,0.025775656324582338,0.47875894988066825,0.4954653937947494,0.9971360381861575,0.002863961813842482
10524,813,640,173,767,46,0.7872078720787208,0.21279212792127922,0.9434194341943419,0.056580565805658053,684,103,296,285,683,1,0.15058479532163743,0.4327485380116959,0.4166666666666667,0.9985380116959064,0.0014619883040935672
10525,390,333,57,339,51,0.8538461538461538,0.14615384615384616,0.8692307692307693,0.13076923076923078,172,4,25,143,162,10,0.023255813953488372,0.14534883720930233,0.8313953488372093,0.9418604651162791,0.05813953488372093
10526,1165,1013,152,1113,52,0.8695278969957082,0.13047210300429185,0.9553648068669528,0.04463519313304721,995,53,477,465,990,5,0.053266331658291456,0.4793969849246231,0.46733668341708545,0.9949748743718593,0.005025125628140704
10527,379,327,52,328,51,0.862796833773087,0.13720316622691292,0.8654353562005277,0.1345646437994723,166,4,24,138,158,8,0.024096385542168676,0.14457831325301204,0.8313253012048193,0.9518072289156626,0.04819277108433735
10528,855,662,193,801,54,0.7742690058479532,0.22573099415204678,0.9368421052631579,0.06315789473684211,608,83,304,221,607,1,0.13651315789473684,0.5,0.36348684210526316,0.9983552631578947,0.001644736842105263
10529,460,407,53,412,48,0.8847826086956522,0.11521739130434783,0.8956521739130435,0.10434782608695652,153,5,23,125,148,5,0.032679738562091505,0.1503267973856209,0.8169934640522876,0.9673202614379085,0.032679738562091505
10530,1081,871,210,1034,47,0.8057354301572618,0.1942645698427382,0.9565217391304348,0.043478260869565216,725,92,325,308,724,1,0.12689655172413794,0.4482758620689655,0.42482758620689653,0.9986206896551724,0.001379310344827586
10531,367,302,65,309,58,0.8228882833787466,0.1771117166212534,0.8419618528610354,0.15803814713896458,152,5,24,123,141,11,0.03289473684210526,0.15789473684210525,0.8092105263157895,0.9276315789473685,0.07236842105263158
10532,461,408,53,412,49,0.8850325379609545,0.11496746203904555,0.8937093275488069,0.10629067245119306,198,5,23,170,188,10,0.025252525252525252,0.11616161616161616,0.8585858585858586,0.9494949494949495,0.050505050505050504
10533,1001,835,166,939,62,0.8341658341658341,0.16583416583416583,0.938061938061938,0.061938061938061936,597,50,320,227,596,1,0.08375209380234507,0.5360134003350083,0.38023450586264657,0.998324958123953,0.0016750418760469012
10534,215,65,150,89,126,0.3023255813953488,0.6976744186046512,0.413953488372093,0.586046511627907,8,0,0,8,6,2,0.0,0.0,1.0,0.75,0.25
10535,667,537,130,639,28,0.8050974512743628,0.19490254872563717,0.9580209895052474,0.041979010494752625,1026,49,474,503,1017,9,0.04775828460038986,0.4619883040935672,0.4902534113060429,0.9912280701754386,0.008771929824561403
10536,273,84,189,158,115,0.3076923076923077,0.6923076923076923,0.5787545787545788,0.42124542124542125,102,0,44,58,99,3,0.0,0.43137254901960786,0.5686274509803921,0.9705882352941176,0.029411764705882353
10537,539,482,57,482,57,0.8942486085343229,0.10575139146567718,0.8942486085343229,0.10575139146567718,177,4,24,149,169,8,0.022598870056497175,0.13559322033898305,0.8418079096045198,0.9548022598870056,0.04519774011299435
10538,1638,1373,265,1566,72,0.8382173382173382,0.1617826617826618,0.9560439560439561,0.04395604395604396,1615,60,775,780,1605,10,0.03715170278637771,0.47987616099071206,0.48297213622291024,0.9938080495356038,0.006191950464396285
10539,904,683,221,846,58,0.7555309734513275,0.24446902654867256,0.9358407079646017,0.06415929203539823,605,73,305,227,604,1,0.1206611570247934,0.5041322314049587,0.3752066115702479,0.9983471074380166,0.001652892561983471
10540,256,83,173,133,123,0.32421875,0.67578125,0.51953125,0.48046875,83,1,36,46,82,1,0.012048192771084338,0.43373493975903615,0.5542168674698795,0.9879518072289156,0.012048192771084338
10541,377,307,70,316,61,0.8143236074270557,0.1856763925729443,0.8381962864721485,0.16180371352785147,141,5,24,112,136,5,0.03546099290780142,0.1702127659574468,0.7943262411347518,0.9645390070921985,0.03546099290780142
10542,721,628,93,696,25,0.871012482662968,0.1289875173370319,0.9653259361997226,0.03467406380027739,1107,47,534,526,1100,7,0.04245709123757904,0.4823848238482385,0.4751580849141825,0.993676603432701,0.006323396567299007
10543,343,302,41,308,35,0.880466472303207,0.119533527696793,0.8979591836734694,0.10204081632653061,198,5,23,170,188,10,0.025252525252525252,0.11616161616161616,0.8585858585858586,0.9494949494949495,0.050505050505050504
10544,222,187,35,195,27,0.8423423423423423,0.15765765765765766,0.8783783783783784,0.12162162162162163,175,4,24,147,168,7,0.022857142857142857,0.13714285714285715,0.84,0.96,0.04
10545,293,87,206,156,137,0.29692832764505117,0.7030716723549488,0.5324232081911263,0.46757679180887374,127,1,56,70,124,3,0.007874015748031496,0.4409448818897638,0.5511811023622047,0.9763779527559056,0.023622047244094488
10546,372,324,48,331,41,0.8709677419354839,0.12903225806451613,0.8897849462365591,0.11021505376344086,123,5,25,93,116,7,0.04065040650406504,0.2032520325203252,0.7560975609756098,0.943089430894309,0.056910569105691054
10547,341,274,67,280,61,0.8035190615835777,0.19648093841642228,0.8211143695014663,0.17888563049853373,163,5,24,134,153,10,0.03067484662576687,0.147239263803681,0.8220858895705522,0.9386503067484663,0.06134969325153374
10548,948,758,190,900,48,0.79957805907173,0.20042194092827004,0.9493670886075949,0.05063291139240506,605,69,242,294,604,1,0.1140495867768595,0.4,0.4859504132231405,0.9983471074380166,0.001652892561983471
10549,461,408,53,412,49,0.8850325379609545,0.11496746203904555,0.8937093275488069,0.10629067245119306,198,5,23,170,188,10,0.025252525252525252,0.11616161616161616,0.8585858585858586,0.9494949494949495,0.050505050505050504
10550,2197,1941,256,2130,67,0.8834774692762859,0.11652253072371416,0.9695038689121529,0.030496131087847066,1260,44,602,614,1255,5,0.03492063492063492,0.4777777777777778,0.4873015873015873,0.996031746031746,0.003968253968253968
10551,1307,1063,244,1227,80,0.8133129303749044,0.18668706962509563,0.9387911247130833,0.061208875286916604,929,42,441,446,923,6,0.04520990312163617,0.4747039827771798,0.48008611410118407,0.9935414424111948,0.006458557588805167
10552,810,640,170,768,42,0.7901234567901234,0.20987654320987653,0.9481481481481482,0.05185185185185185,1229,66,582,581,1223,6,0.05370219690805533,0.4735557363710334,0.4727420667209113,0.9951179820992677,0.004882017900732303
10553,300,100,200,168,132,0.3333333333333333,0.6666666666666666,0.56,0.44,95,1,37,57,94,1,0.010526315789473684,0.3894736842105263,0.6,0.9894736842105263,0.010526315789473684
10554,351,313,38,313,38,0.8917378917378918,0.10826210826210826,0.8917378917378918,0.10826210826210826,200,5,23,172,192,8,0.025,0.115,0.86,0.96,0.04
10555,305,244,61,250,55,0.8,0.2,0.819672131147541,0.18032786885245902,156,5,23,128,148,8,0.03205128205128205,0.14743589743589744,0.8205128205128205,0.9487179487179487,0.05128205128205128
10556,1532,1286,246,1470,62,0.839425587467363,0.16057441253263707,0.9595300261096605,0.04046997389033943,1281,58,622,601,1276,5,0.04527712724434036,0.4855581576893052,0.46916471506635443,0.9960967993754879,0.0039032006245121
10557,372,324,48,331,41,0.8709677419354839,0.12903225806451613,0.8897849462365591,0.11021505376344086,123,5,25,93,116,7,0.04065040650406504,0.2032520325203252,0.7560975609756098,0.943089430894309,0.056910569105691054
10558,352,298,54,299,53,0.8465909090909091,0.1534090909090909,0.8494318181818182,0.15056818181818182,161,5,23,133,152,9,0.031055900621118012,0.14285714285714285,0.8260869565217391,0.9440993788819876,0.055900621118012424
10559,266,205,61,212,54,0.7706766917293233,0.22932330827067668,0.7969924812030075,0.20300751879699247,154,4,24,126,145,9,0.025974025974025976,0.15584415584415584,0.8181818181818182,0.9415584415584416,0.05844155844155844
10560,468,417,51,417,51,0.8910256410256411,0.10897435897435898,0.8910256410256411,0.10897435897435898,151,4,24,123,144,7,0.026490066225165563,0.15894039735099338,0.8145695364238411,0.9536423841059603,0.046357615894039736
10561,394,342,52,345,49,0.868020304568528,0.1319796954314721,0.8756345177664975,0.12436548223350254,161,5,23,133,154,7,0.031055900621118012,0.14285714285714285,0.8260869565217391,0.9565217391304348,0.043478260869565216
10562,2170,1953,217,2102,68,0.9,0.1,0.9686635944700461,0.03133640552995392,1288,45,621,622,1283,5,0.03493788819875776,0.48214285714285715,0.4829192546583851,0.9961180124223602,0.0038819875776397515
10563,1674,1466,208,1608,66,0.8757467144563919,0.12425328554360812,0.9605734767025089,0.03942652329749104,978,44,459,475,974,4,0.044989775051124746,0.46932515337423314,0.48568507157464214,0.9959100204498977,0.00408997955010225
10564,737,630,107,708,29,0.8548168249660787,0.1451831750339213,0.9606512890094979,0.03934871099050204,1036,56,479,501,1029,7,0.05405405405405406,0.4623552123552124,0.48359073359073357,0.9932432432432432,0.006756756756756757
10565,2089,1825,264,2005,84,0.8736237434179033,0.1263762565820967,0.9597893729056965,0.040210627094303494,1242,43,593,606,1236,6,0.03462157809983897,0.4774557165861514,0.48792270531400966,0.9951690821256038,0.004830917874396135
10566,317,98,219,153,164,0.30914826498422715,0.6908517350157729,0.48264984227129337,0.5173501577287066,134,0,50,84,127,7,0.0,0.373134328358209,0.6268656716417911,0.9477611940298507,0.05223880597014925
10567,2056,1779,277,1998,58,0.8652723735408561,0.13472762645914396,0.9717898832684825,0.02821011673151751,1122,40,542,540,1117,5,0.035650623885918005,0.483065953654189,0.48128342245989303,0.9955436720142602,0.004456327985739751
10568,273,74,199,144,129,0.27106227106227104,0.7289377289377289,0.5274725274725275,0.4725274725274725,113,0,47,66,110,3,0.0,0.415929203539823,0.584070796460177,0.9734513274336283,0.02654867256637168
10569,875,711,164,836,39,0.8125714285714286,0.18742857142857142,0.9554285714285714,0.044571428571428574,1416,46,674,696,1407,9,0.03248587570621469,0.4759887005649718,0.4915254237288136,0.9936440677966102,0.006355932203389831
10570,944,724,220,893,51,0.7669491525423728,0.2330508474576271,0.9459745762711864,0.05402542372881356,1026,47,489,490,1020,6,0.04580896686159844,0.4766081871345029,0.4775828460038986,0.9941520467836257,0.005847953216374269
10571,352,298,54,299,53,0.8465909090909091,0.1534090909090909,0.8494318181818182,0.15056818181818182,161,5,23,133,152,9,0.031055900621118012,0.14285714285714285,0.8260869565217391,0.9440993788819876,0.055900621118012424
10572,248,198,50,205,43,0.7983870967741935,0.20161290322580644,0.8266129032258065,0.17338709677419356,142,4,24,114,136,6,0.028169014084507043,0.16901408450704225,0.8028169014084507,0.9577464788732394,0.04225352112676056
10573,287,97,190,159,128,0.33797909407665505,0.662020905923345,0.554006968641115,0.445993031358885,115,1,47,67,111,4,0.008695652173913044,0.40869565217391307,0.5826086956521739,0.9652173913043478,0.034782608695652174
10574,894,772,122,849,45,0.8635346756152126,0.13646532438478748,0.9496644295302014,0.050335570469798654,975,42,490,443,969,6,0.043076923076923075,0.5025641025641026,0.4543589743589744,0.9938461538461538,0.006153846153846154
10575,1176,1006,170,1145,31,0.8554421768707483,0.1445578231292517,0.9736394557823129,0.026360544217687076,1583,52,760,771,1580,3,0.032849020846494,0.4801010739102969,0.48704990524320907,0.998104864181933,0.0018951358180669614
10576,1180,1036,144,1135,45,0.8779661016949153,0.12203389830508475,0.961864406779661,0.038135593220338986,1289,55,627,607,1284,5,0.04266873545384019,0.4864235841737781,0.4709076803723817,0.9961210240496509,0.003878975950349108
10577,1476,1304,172,1431,45,0.8834688346883469,0.11653116531165311,0.9695121951219512,0.03048780487804878,1039,47,499,493,1035,4,0.04523580365736285,0.480269489894129,0.47449470644850816,0.9961501443695862,0.0038498556304138597
10578,431,386,45,388,43,0.8955916473317865,0.10440835266821345,0.9002320185614849,0.09976798143851508,148,5,23,120,140,8,0.033783783783783786,0.1554054054054054,0.8108108108108109,0.9459459459459459,0.05405405405405406
10579,1033,846,187,979,54,0.818973862536302,0.18102613746369797,0.9477250726040658,0.05227492739593417,570,80,218,272,568,2,0.14035087719298245,0.3824561403508772,0.47719298245614034,0.9964912280701754,0.0035087719298245615
10580,911,734,177,875,36,0.8057080131723381,0.1942919868276619,0.960482985729967,0.03951701427003293,563,75,252,236,562,1,0.13321492007104796,0.44760213143872113,0.4191829484902309,0.9982238010657194,0.0017761989342806395
10581,1635,1441,194,1573,62,0.8813455657492355,0.11865443425076452,0.962079510703364,0.037920489296636085,995,60,474,461,990,5,0.06030150753768844,0.4763819095477387,0.46331658291457284,0.9949748743718593,0.005025125628140704
10582,589,448,141,563,26,0.7606112054329371,0.23938879456706283,0.9558573853989814,0.044142614601018676,537,86,213,238,536,1,0.1601489757914339,0.39664804469273746,0.44320297951582865,0.9981378026070763,0.00186219739292365
10583,346,303,43,309,37,0.8757225433526011,0.12427745664739884,0.8930635838150289,0.1069364161849711,145,5,23,117,138,7,0.034482758620689655,0.15862068965517243,0.8068965517241379,0.9517241379310345,0.04827586206896552
10584,352,112,240,196,156,0.3181818181818182,0.6818181818181818,0.5568181818181818,0.4431818181818182,141,0,57,84,138,3,0.0,0.40425531914893614,0.5957446808510638,0.9787234042553191,0.02127659574468085
10585,487,430,57,436,51,0.8829568788501027,0.11704312114989733,0.8952772073921971,0.10472279260780287,152,5,23,124,146,6,0.03289473684210526,0.1513157894736842,0.8157894736842105,0.9605263157894737,0.039473684210526314
10586,1141,935,206,1103,38,0.8194566170026293,0.18054338299737072,0.9666958808063103,0.033304119193689745,1152,69,532,551,1144,8,0.059895833333333336,0.4618055555555556,0.4782986111111111,0.9930555555555556,0.006944444444444444
10587,924,776,148,884,40,0.8398268398268398,0.16017316017316016,0.9567099567099567,0.04329004329004329,444,54,235,155,442,2,0.12162162162162163,0.5292792792792793,0.3490990990990991,0.9954954954954955,0.0045045045045045045
10588,205,181,24,186,19,0.8829268292682927,0.11707317073170732,0.9073170731707317,0.09268292682926829,152,4,24,124,144,8,0.02631578947368421,0.15789473684210525,0.8157894736842105,0.9473684210526315,0.05263157894736842
10589,4853,4148,705,3962,891,0.8547290335874717,0.14527096641252835,0.8164022254275706,0.18359777457242943,999,125,263,611,693,306,0.12512512512512514,0.26326326326326327,0.6116116116116116,0.6936936936936937,0.3063063063063063
10590,1353,1131,222,1300,53,0.835920177383592,0.164079822616408,0.9608277900960828,0.03917220990391722,1322,41,642,639,1313,9,0.031013615733736764,0.4856278366111952,0.4833585476550681,0.9931921331316188,0.00680786686838124
10591,514,435,79,443,71,0.8463035019455253,0.15369649805447472,0.8618677042801557,0.13813229571984437,155,4,24,127,146,9,0.025806451612903226,0.15483870967741936,0.8193548387096774,0.9419354838709677,0.05806451612903226
10592,1566,1313,253,1501,65,0.8384418901660281,0.1615581098339719,0.958492975734355,0.041507024265644954,1103,61,535,507,1096,7,0.05530371713508613,0.485040797824116,0.45965548504079784,0.9936536718041704,0.006346328195829556
10593,403,333,70,339,64,0.826302729528536,0.17369727047146402,0.8411910669975186,0.1588089330024814,169,5,23,141,160,9,0.029585798816568046,0.13609467455621302,0.834319526627219,0.9467455621301775,0.05325443786982249
10594,2098,1835,263,2020,78,0.8746425166825548,0.12535748331744517,0.9628217349857007,0.037178265014299335,1005,50,469,486,1002,3,0.04975124378109453,0.4666666666666667,0.4835820895522388,0.9970149253731343,0.0029850746268656717
10595,227,172,55,179,48,0.7577092511013216,0.2422907488986784,0.788546255506608,0.21145374449339208,154,5,24,125,146,8,0.032467532467532464,0.15584415584415584,0.8116883116883117,0.948051948051948,0.05194805194805195
10596,884,769,115,849,35,0.8699095022624435,0.13009049773755657,0.9604072398190046,0.03959276018099547,981,34,466,481,975,6,0.034658511722731905,0.4750254841997961,0.49031600407747195,0.9938837920489296,0.0061162079510703364
10597,343,114,229,182,161,0.3323615160349854,0.6676384839650146,0.5306122448979592,0.46938775510204084,98,0,35,63,96,2,0.0,0.35714285714285715,0.6428571428571429,0.9795918367346939,0.02040816326530612
10598,570,425,145,535,35,0.7456140350877193,0.2543859649122807,0.9385964912280702,0.06140350877192982,1108,45,520,543,1098,10,0.04061371841155235,0.4693140794223827,0.490072202166065,0.9909747292418772,0.009025270758122744
10599,213,163,50,168,45,0.7652582159624414,0.2347417840375587,0.7887323943661971,0.2112676056338028,153,5,23,125,143,10,0.032679738562091505,0.1503267973856209,0.8169934640522876,0.934640522875817,0.06535947712418301
10600,810,633,177,768,42,0.7814814814814814,0.21851851851851853,0.9481481481481482,0.05185185185185185,695,77,307,311,694,1,0.11079136690647481,0.441726618705036,0.4474820143884892,0.9985611510791367,0.0014388489208633094
10601,514,435,79,443,71,0.8463035019455253,0.15369649805447472,0.8618677042801557,0.13813229571984437,155,4,24,127,146,9,0.025806451612903226,0.15483870967741936,0.8193548387096774,0.9419354838709677,0.05806451612903226
10602,273,94,179,126,147,0.3443223443223443,0.6556776556776557,0.46153846153846156,0.5384615384615384,77,0,33,44,72,5,0.0,0.42857142857142855,0.5714285714285714,0.935064935064935,0.06493506493506493
10603,1184,978,206,1108,76,0.8260135135135135,0.17398648648648649,0.9358108108108109,0.06418918918918919,609,56,290,263,602,7,0.09195402298850575,0.47619047619047616,0.4318555008210181,0.9885057471264368,0.011494252873563218
10604,310,264,46,264,46,0.8516129032258064,0.14838709677419354,0.8516129032258064,0.14838709677419354,159,5,23,131,151,8,0.031446540880503145,0.14465408805031446,0.8238993710691824,0.949685534591195,0.050314465408805034
10605,429,377,52,386,43,0.8787878787878788,0.12121212121212122,0.8997668997668997,0.10023310023310024,150,5,24,121,142,8,0.03333333333333333,0.16,0.8066666666666666,0.9466666666666667,0.05333333333333334
10606,305,255,50,257,48,0.8360655737704918,0.16393442622950818,0.8426229508196721,0.15737704918032788,187,5,23,159,178,9,0.026737967914438502,0.12299465240641712,0.8502673796791443,0.9518716577540107,0.0481283422459893
10607,1289,1051,238,1228,61,0.8153607447633825,0.18463925523661753,0.9526764934057409,0.047323506594259115,1105,75,520,510,1101,4,0.06787330316742081,0.47058823529411764,0.46153846153846156,0.9963800904977376,0.0036199095022624436
10608,308,263,45,269,39,0.8538961038961039,0.1461038961038961,0.8733766233766234,0.1266233766233766,175,4,25,146,169,6,0.022857142857142857,0.14285714285714285,0.8342857142857143,0.9657142857142857,0.03428571428571429
10609,320,274,46,283,37,0.85625,0.14375,0.884375,0.115625,178,5,24,149,168,10,0.028089887640449437,0.1348314606741573,0.8370786516853933,0.9438202247191011,0.056179775280898875
10610,720,564,156,676,44,0.7833333333333333,0.21666666666666667,0.9388888888888889,0.06111111111111111,1038,69,486,483,1032,6,0.06647398843930635,0.4682080924855491,0.4653179190751445,0.9942196531791907,0.005780346820809248
10611,2056,1779,277,1998,58,0.8652723735408561,0.13472762645914396,0.9717898832684825,0.02821011673151751,1122,40,542,540,1117,5,0.035650623885918005,0.483065953654189,0.48128342245989303,0.9955436720142602,0.004456327985739751
10612,462,405,57,406,56,0.8766233766233766,0.12337662337662338,0.8787878787878788,0.12121212121212122,157,5,23,129,148,9,0.03184713375796178,0.1464968152866242,0.821656050955414,0.9426751592356688,0.05732484076433121
10613,196,61,135,113,83,0.3112244897959184,0.6887755102040817,0.576530612244898,0.42346938775510207,80,1,32,47,77,3,0.0125,0.4,0.5875,0.9625,0.0375
10614,1559,1371,188,1515,44,0.8794098781270044,0.1205901218729955,0.9717767799871713,0.028223220012828735,1298,54,617,627,1292,6,0.04160246533127889,0.47534668721109397,0.4830508474576271,0.9953775038520801,0.004622496147919877
10615,4864,4157,707,3970,894,0.8546463815789473,0.14535361842105263,0.8162006578947368,0.18379934210526316,1011,125,269,617,704,307,0.12363996043521266,0.26607319485657766,0.6102868447082097,0.6963402571711177,0.3036597428288823
10616,380,320,60,324,56,0.8421052631578947,0.15789473684210525,0.8526315789473684,0.14736842105263157,172,5,23,144,163,9,0.029069767441860465,0.13372093023255813,0.8372093023255814,0.9476744186046512,0.05232558139534884
10617,917,728,189,872,45,0.7938931297709924,0.20610687022900764,0.95092693565976,0.04907306434023991,1470,76,708,686,1462,8,0.05170068027210884,0.4816326530612245,0.4666666666666667,0.9945578231292517,0.005442176870748299
10618,376,334,42,333,43,0.8882978723404256,0.11170212765957446,0.8856382978723404,0.11436170212765957,166,5,23,138,157,9,0.030120481927710843,0.13855421686746988,0.8313253012048193,0.9457831325301205,0.05421686746987952
10619,351,313,38,313,38,0.8917378917378918,0.10826210826210826,0.8917378917378918,0.10826210826210826,166,5,23,138,157,9,0.030120481927710843,0.13855421686746988,0.8313253012048193,0.9457831325301205,0.05421686746987952
10620,1486,1322,164,1418,68,0.8896366083445492,0.11036339165545088,0.9542395693135935,0.04576043068640646,1624,61,775,788,1621,3,0.037561576354679806,0.4772167487684729,0.4852216748768473,0.9981527093596059,0.0018472906403940886
10621,4857,4151,706,3968,889,0.8546427836112827,0.14535721638871732,0.8169652048589664,0.18303479514103355,1007,125,265,617,700,307,0.12413108242303873,0.2631578947368421,0.6127110228401191,0.6951340615690169,0.30486593843098314
10622,945,800,145,903,42,0.8465608465608465,0.15343915343915343,0.9555555555555556,0.044444444444444446,1195,60,586,549,1192,3,0.0502092050209205,0.4903765690376569,0.4594142259414226,0.9974895397489539,0.002510460251046025
10623,240,69,171,124,116,0.2875,0.7125,0.5166666666666667,0.48333333333333334,90,0,34,56,86,4,0.0,0.37777777777777777,0.6222222222222222,0.9555555555555556,0.044444444444444446
10624,1357,1142,215,1289,68,0.8415622697126013,0.1584377302873987,0.9498894620486367,0.050110537951363304,1299,54,627,618,1293,6,0.04157043879907621,0.48267898383371827,0.47575057736720555,0.9953810623556582,0.004618937644341801
10625,270,222,48,230,40,0.8222222222222222,0.17777777777777778,0.8518518518518519,0.14814814814814814,164,5,24,135,157,7,0.03048780487804878,0.14634146341463414,0.823170731707317,0.9573170731707317,0.042682926829268296
10626,1775,1624,151,1725,50,0.9149295774647888,0.08507042253521127,0.971830985915493,0.028169014084507043,1064,62,513,489,1058,6,0.05827067669172932,0.48214285714285715,0.45958646616541354,0.9943609022556391,0.005639097744360902
10627,1031,807,224,981,50,0.7827352085354026,0.21726479146459748,0.9515033947623667,0.04849660523763336,1077,55,491,531,1072,5,0.0510677808727948,0.4558960074280409,0.49303621169916434,0.9953574744661096,0.004642525533890436
10628,393,341,52,344,49,0.8676844783715013,0.13231552162849872,0.8753180661577609,0.12468193384223919,182,5,23,154,173,9,0.027472527472527472,0.12637362637362637,0.8461538461538461,0.9505494505494505,0.04945054945054945
10629,991,807,184,929,62,0.8143289606458123,0.1856710393541877,0.9374369323915237,0.06256306760847628,1152,51,553,548,1144,8,0.044270833333333336,0.4800347222222222,0.4756944444444444,0.9930555555555556,0.006944444444444444
10630,448,383,65,390,58,0.8549107142857143,0.14508928571428573,0.8705357142857143,0.12946428571428573,159,5,24,130,152,7,0.031446540880503145,0.1509433962264151,0.8176100628930818,0.9559748427672956,0.0440251572327044
10631,1327,1039,288,1260,67,0.7829691032403918,0.21703089675960813,0.9495101733232856,0.050489826676714394,985,51,455,479,977,8,0.05177664974619289,0.4619289340101523,0.4862944162436548,0.9918781725888325,0.008121827411167513
10632,206,163,43,165,41,0.7912621359223301,0.2087378640776699,0.8009708737864077,0.19902912621359223,157,5,23,129,149,8,0.03184713375796178,0.1464968152866242,0.821656050955414,0.9490445859872612,0.050955414012738856
10633,1532,1286,246,1470,62,0.839425587467363,0.16057441253263707,0.9595300261096605,0.04046997389033943,1281,58,622,601,1276,5,0.04527712724434036,0.4855581576893052,0.46916471506635443,0.9960967993754879,0.0039032006245121
10634,999,816,183,937,62,0.8168168168168168,0.1831831831831832,0.9379379379379379,0.062062062062062065,649,99,301,249,646,3,0.15254237288135594,0.4637904468412943,0.38366718027734975,0.9953775038520801,0.004622496147919877
10635,318,106,212,178,140,0.3333333333333333,0.6666666666666666,0.559748427672956,0.44025157232704404,114,0,51,63,112,2,0.0,0.4473684210526316,0.5526315789473685,0.9824561403508771,0.017543859649122806
10636,1325,1153,172,1275,50,0.870188679245283,0.129811320754717,0.9622641509433962,0.03773584905660377,1607,59,789,759,1604,3,0.03671437461107654,0.4909769757311761,0.4723086496577474,0.9981331673926571,0.001866832607342875
10637,216,173,43,169,47,0.8009259259259259,0.19907407407407407,0.7824074074074074,0.2175925925925926,154,5,23,126,143,11,0.032467532467532464,0.14935064935064934,0.8181818181818182,0.9285714285714286,0.07142857142857142
10638,985,811,174,946,39,0.8233502538071066,0.1766497461928934,0.9604060913705583,0.03959390862944162,648,91,316,241,647,1,0.1404320987654321,0.4876543209876543,0.37191358024691357,0.9984567901234568,0.0015432098765432098
10639,1122,918,204,1089,33,0.8181818181818182,0.18181818181818182,0.9705882352941176,0.029411764705882353,624,92,279,253,623,1,0.14743589743589744,0.44711538461538464,0.40544871794871795,0.9983974358974359,0.0016025641025641025
10640,380,320,60,324,56,0.8421052631578947,0.15789473684210525,0.8526315789473684,0.14736842105263157,172,5,23,144,163,9,0.029069767441860465,0.13372093023255813,0.8372093023255814,0.9476744186046512,0.05232558139534884
10641,1532,1286,246,1470,62,0.839425587467363,0.16057441253263707,0.9595300261096605,0.04046997389033943,1281,58,622,601,1276,5,0.04527712724434036,0.4855581576893052,0.46916471506635443,0.9960967993754879,0.0039032006245121
10642,1087,940,147,1055,32,0.8647654093836247,0.13523459061637536,0.9705611775528978,0.029438822447102116,1065,48,498,519,1061,4,0.04507042253521127,0.4676056338028169,0.48732394366197185,0.996244131455399,0.003755868544600939
10643,1237,988,249,964,273,0.7987065481002426,0.20129345189975748,0.7793047696038804,0.22069523039611966,488,11,95,382,311,177,0.022540983606557378,0.19467213114754098,0.7827868852459017,0.6372950819672131,0.36270491803278687
10644,219,164,55,170,49,0.7488584474885844,0.2511415525114155,0.776255707762557,0.2237442922374429,171,5,24,142,162,9,0.029239766081871343,0.14035087719298245,0.8304093567251462,0.9473684210526315,0.05263157894736842
10645,282,212,70,214,68,0.75177304964539,0.24822695035460993,0.7588652482269503,0.24113475177304963,189,5,23,161,180,9,0.026455026455026454,0.12169312169312169,0.8518518518518519,0.9523809523809523,0.047619047619047616
10646,1066,874,192,1010,56,0.8198874296435272,0.1801125703564728,0.9474671669793621,0.0525328330206379,1165,74,551,540,1157,8,0.06351931330472103,0.47296137339055794,0.463519313304721,0.9931330472103004,0.0068669527896995704
10647,835,653,182,792,43,0.7820359281437126,0.2179640718562874,0.948502994011976,0.05149700598802395,634,83,270,281,632,2,0.1309148264984227,0.42586750788643535,0.443217665615142,0.9968454258675079,0.0031545741324921135
10648,425,377,48,379,46,0.8870588235294118,0.11294117647058824,0.8917647058823529,0.10823529411764705,157,5,23,129,152,5,0.03184713375796178,0.1464968152866242,0.821656050955414,0.9681528662420382,0.03184713375796178
10649,846,676,170,814,32,0.7990543735224587,0.20094562647754138,0.9621749408983451,0.037825059101654845,677,74,301,302,676,1,0.10930576070901034,0.4446085672082718,0.4460856720827179,0.9985228951255539,0.0014771048744460858
10650,734,545,189,687,47,0.7425068119891008,0.2574931880108992,0.9359673024523161,0.06403269754768393,643,91,254,298,642,1,0.14152410575427682,0.39502332814930013,0.463452566096423,0.9984447900466563,0.0015552099533437014
10651,425,377,48,379,46,0.8870588235294118,0.11294117647058824,0.8917647058823529,0.10823529411764705,200,5,23,172,192,8,0.025,0.115,0.86,0.96,0.04
10652,403,333,70,339,64,0.826302729528536,0.17369727047146402,0.8411910669975186,0.1588089330024814,168,5,23,140,159,9,0.02976190476190476,0.13690476190476192,0.8333333333333334,0.9464285714285714,0.05357142857142857
10653,855,719,136,813,42,0.8409356725146199,0.15906432748538013,0.9508771929824561,0.04912280701754386,1070,63,522,485,1065,5,0.058878504672897194,0.48785046728971965,0.4532710280373832,0.9953271028037384,0.004672897196261682
10654,1151,952,199,1111,40,0.8271068635968722,0.17289313640312773,0.9652476107732406,0.03475238922675934,1070,69,506,495,1064,6,0.06448598130841121,0.47289719626168225,0.46261682242990654,0.994392523364486,0.005607476635514018
10655,205,162,43,165,40,0.7902439024390244,0.2097560975609756,0.8048780487804879,0.1951219512195122,157,5,23,129,148,9,0.03184713375796178,0.1464968152866242,0.821656050955414,0.9426751592356688,0.05732484076433121
10656,646,577,69,633,13,0.8931888544891641,0.10681114551083591,0.9798761609907121,0.020123839009287926,1591,51,776,764,1588,3,0.03205531112507857,0.48774355751099935,0.48020113136392206,0.9981143934632307,0.0018856065367693275
10657,1627,1437,190,1553,74,0.883220651505839,0.11677934849416104,0.9545175169022742,0.04548248309772587,2970,45,1447,1478,2964,6,0.015151515151515152,0.4872053872053872,0.49764309764309766,0.997979797979798,0.00202020202020202
10658,656,448,208,368,288,0.6829268292682927,0.3170731707317073,0.5609756097560976,0.43902439024390244,126,0,61,65,124,2,0.0,0.48412698412698413,0.5158730158730159,0.9841269841269841,0.015873015873015872
10659,383,326,57,333,50,0.8511749347258486,0.14882506527415143,0.8694516971279374,0.13054830287206268,174,4,24,146,165,9,0.022988505747126436,0.13793103448275862,0.8390804597701149,0.9482758620689655,0.05172413793103448
10660,564,499,65,504,60,0.8847517730496454,0.11524822695035461,0.8936170212765957,0.10638297872340426,163,5,23,135,154,9,0.03067484662576687,0.1411042944785276,0.8282208588957055,0.9447852760736196,0.05521472392638037
10661,1106,894,212,1055,51,0.8083182640144665,0.19168173598553345,0.953887884267631,0.0461121157323689,1079,69,499,511,1072,7,0.0639481000926784,0.46246524559777574,0.4735866543095459,0.9935125115848007,0.006487488415199258
10662,151,105,46,111,40,0.695364238410596,0.304635761589404,0.7350993377483444,0.26490066225165565,175,5,24,146,169,6,0.02857142857142857,0.13714285714285715,0.8342857142857143,0.9657142857142857,0.03428571428571429
10663,431,386,45,388,43,0.8955916473317865,0.10440835266821345,0.9002320185614849,0.09976798143851508,140,5,23,112,133,7,0.03571428571428571,0.16428571428571428,0.8,0.95,0.05
10664,276,232,44,233,43,0.8405797101449275,0.15942028985507245,0.8442028985507246,0.15579710144927536,118,4,24,90,113,5,0.03389830508474576,0.2033898305084746,0.7627118644067796,0.9576271186440678,0.0423728813559322
10665,206,163,43,165,41,0.7912621359223301,0.2087378640776699,0.8009708737864077,0.19902912621359223,157,5,23,129,149,8,0.03184713375796178,0.1464968152866242,0.821656050955414,0.9490445859872612,0.050955414012738856
10666,1626,1447,179,1573,53,0.8899138991389914,0.1100861008610086,0.9674046740467405,0.032595325953259535,2301,69,1097,1135,2295,6,0.02998696219035202,0.47674923946110387,0.4932637983485441,0.9973924380704041,0.002607561929595828
10667,1551,1321,230,1506,45,0.8517085751128304,0.14829142488716957,0.9709864603481625,0.029013539651837523,1267,52,611,604,1262,5,0.04104183109707971,0.48224151539068666,0.47671665351223363,0.9960536700868192,0.003946329913180742
10668,514,435,79,443,71,0.8463035019455253,0.15369649805447472,0.8618677042801557,0.13813229571984437,155,4,24,127,146,9,0.025806451612903226,0.15483870967741936,0.8193548387096774,0.9419354838709677,0.05806451612903226
10669,442,372,70,374,68,0.8416289592760181,0.1583710407239819,0.8461538461538461,0.15384615384615385,178,5,23,150,170,8,0.028089887640449437,0.12921348314606743,0.8426966292134831,0.9550561797752809,0.0449438202247191
10670,1224,1078,146,1184,40,0.880718954248366,0.119281045751634,0.9673202614379085,0.032679738562091505,2141,53,1035,1053,2134,7,0.02475478748248482,0.4834189631013545,0.49182624941616065,0.9967304997664642,0.003269500233535731
10671,432,386,46,383,49,0.8935185185185185,0.10648148148148148,0.8865740740740741,0.11342592592592593,112,5,23,84,105,7,0.044642857142857144,0.20535714285714285,0.75,0.9375,0.0625
10672,404,346,58,348,56,0.8564356435643564,0.14356435643564355,0.8613861386138614,0.13861386138613863,159,5,23,131,154,5,0.031446540880503145,0.14465408805031446,0.8238993710691824,0.9685534591194969,0.031446540880503145
10673,1476,1304,172,1431,45,0.8834688346883469,0.11653116531165311,0.9695121951219512,0.03048780487804878,1039,47,499,493,1035,4,0.04523580365736285,0.480269489894129,0.47449470644850816,0.9961501443695862,0.0038498556304138597
10674,315,248,67,255,60,0.7873015873015873,0.2126984126984127,0.8095238095238095,0.19047619047619047,155,5,24,126,146,9,0.03225806451612903,0.15483870967741936,0.8129032258064516,0.9419354838709677,0.05806451612903226
10675,368,303,65,310,58,0.8233695652173914,0.1766304347826087,0.842391304347826,0.15760869565217392,176,5,24,147,169,7,0.028409090909090908,0.13636363636363635,0.8352272727272727,0.9602272727272727,0.03977272727272727
10676,291,85,206,156,135,0.2920962199312715,0.7079037800687286,0.5360824742268041,0.4639175257731959,104,0,44,60,103,1,0.0,0.4230769230769231,0.5769230769230769,0.9903846153846154,0.009615384615384616
10677,223,187,36,196,27,0.8385650224215246,0.16143497757847533,0.8789237668161435,0.1210762331838565,176,4,25,147,169,7,0.022727272727272728,0.14204545454545456,0.8352272727272727,0.9602272727272727,0.03977272727272727
10678,312,284,28,287,25,0.9102564102564102,0.08974358974358974,0.9198717948717948,0.08012820512820513,169,5,23,141,161,8,0.029585798816568046,0.13609467455621302,0.834319526627219,0.9526627218934911,0.047337278106508875
10679,1640,1445,195,1580,60,0.8810975609756098,0.11890243902439024,0.9634146341463414,0.036585365853658534,1138,58,538,542,1133,5,0.050966608084358524,0.4727592267135325,0.47627416520210897,0.9956063268892794,0.004393673110720563
10680,260,219,41,224,36,0.8423076923076923,0.1576923076923077,0.8615384615384616,0.13846153846153847,183,5,23,155,173,10,0.0273224043715847,0.12568306010928962,0.8469945355191257,0.9453551912568307,0.0546448087431694
10681,1566,1409,157,1534,32,0.8997445721583652,0.10025542784163474,0.979565772669221,0.020434227330779056,1301,65,641,595,1296,5,0.04996156802459646,0.49269792467332824,0.4573405073020753,0.9961568024596464,0.003843197540353574
10682,153,95,58,103,50,0.6209150326797386,0.3790849673202614,0.673202614379085,0.32679738562091504,174,5,24,145,166,8,0.028735632183908046,0.13793103448275862,0.8333333333333334,0.9540229885057471,0.04597701149425287
10683,514,435,79,443,71,0.8463035019455253,0.15369649805447472,0.8618677042801557,0.13813229571984437,146,4,24,118,139,7,0.0273972602739726,0.1643835616438356,0.8082191780821918,0.952054794520548,0.04794520547945205
10684,255,69,186,133,122,0.27058823529411763,0.7294117647058823,0.5215686274509804,0.47843137254901963,112,1,51,60,110,2,0.008928571428571428,0.45535714285714285,0.5357142857142857,0.9821428571428571,0.017857142857142856
10685,314,100,214,166,148,0.3184713375796178,0.6815286624203821,0.5286624203821656,0.4713375796178344,88,0,41,47,85,3,0.0,0.4659090909090909,0.5340909090909091,0.9659090909090909,0.03409090909090909
10686,1682,1471,211,1626,56,0.8745541022592153,0.12544589774078477,0.9667063020214031,0.03329369797859691,1232,47,604,581,1227,5,0.03814935064935065,0.4902597402597403,0.4715909090909091,0.9959415584415584,0.004058441558441558
10687,1454,1258,196,1394,60,0.8651994497936726,0.13480055020632736,0.9587345254470426,0.04126547455295736,911,46,425,440,907,4,0.050493962678375415,0.4665203073545554,0.4829857299670692,0.995609220636663,0.0043907793633369925
10688,699,614,85,678,21,0.8783977110157367,0.12160228898426323,0.9699570815450643,0.030042918454935622,926,52,416,458,914,12,0.056155507559395246,0.44924406047516197,0.4946004319654428,0.9870410367170627,0.012958963282937365
10689,345,290,55,298,47,0.8405797101449275,0.15942028985507245,0.863768115942029,0.13623188405797101,181,5,24,152,171,10,0.027624309392265192,0.13259668508287292,0.8397790055248618,0.9447513812154696,0.055248618784530384
10690,1674,1466,208,1608,66,0.8757467144563919,0.12425328554360812,0.9605734767025089,0.03942652329749104,978,44,459,475,974,4,0.044989775051124746,0.46932515337423314,0.48568507157464214,0.9959100204498977,0.00408997955010225
10691,883,688,195,836,47,0.7791619479048698,0.22083805209513024,0.9467723669309174,0.053227633069082674,1052,52,491,509,1046,6,0.049429657794676805,0.4667300380228137,0.4838403041825095,0.9942965779467681,0.005703422053231939
10692,901,802,99,888,13,0.8901220865704772,0.10987791342952276,0.9855715871254163,0.014428412874583796,975,47,465,463,972,3,0.048205128205128206,0.47692307692307695,0.4748717948717949,0.9969230769230769,0.003076923076923077
10693,865,682,183,838,27,0.7884393063583816,0.2115606936416185,0.96878612716763,0.03121387283236994,969,58,461,450,962,7,0.05985552115583075,0.4757481940144479,0.46439628482972134,0.9927760577915377,0.007223942208462332
10694,431,386,45,388,43,0.8955916473317865,0.10440835266821345,0.9002320185614849,0.09976798143851508,156,5,23,128,148,8,0.03205128205128205,0.14743589743589744,0.8205128205128205,0.9487179487179487,0.05128205128205128
10695,318,263,55,263,55,0.8270440251572327,0.17295597484276728,0.8270440251572327,0.17295597484276728,169,5,23,141,158,11,0.029585798816568046,0.13609467455621302,0.834319526627219,0.9349112426035503,0.0650887573964497
10696,380,320,60,324,56,0.8421052631578947,0.15789473684210525,0.8526315789473684,0.14736842105263157,175,5,23,147,168,7,0.02857142857142857,0.13142857142857142,0.84,0.96,0.04
10697,232,177,55,186,46,0.7629310344827587,0.23706896551724138,0.8017241379310345,0.19827586206896552,152,5,24,123,148,4,0.03289473684210526,0.15789473684210525,0.8092105263157895,0.9736842105263158,0.02631578947368421
10698,352,300,52,305,47,0.8522727272727273,0.14772727272727273,0.8664772727272727,0.13352272727272727,179,4,24,151,171,8,0.0223463687150838,0.1340782122905028,0.8435754189944135,0.9553072625698324,0.0446927374301676
10699,525,463,62,467,58,0.8819047619047619,0.1180952380952381,0.8895238095238095,0.11047619047619048,156,4,24,128,147,9,0.02564102564102564,0.15384615384615385,0.8205128205128205,0.9423076923076923,0.057692307692307696
10700,1316,1092,224,1259,57,0.8297872340425532,0.1702127659574468,0.9566869300911854,0.04331306990881459,1977,64,942,971,1969,8,0.03237228123419322,0.4764795144157815,0.49114820435002526,0.9959534648457259,0.004046535154274153
10701,1312,1051,261,1240,72,0.8010670731707317,0.1989329268292683,0.9451219512195121,0.054878048780487805,1037,44,475,518,1029,8,0.04243008678881389,0.45805207328833175,0.49951783992285437,0.9922854387656702,0.007714561234329798
10702,1335,1151,184,1277,58,0.8621722846441947,0.13782771535580524,0.9565543071161049,0.04344569288389513,2095,54,1003,1038,2089,6,0.025775656324582338,0.47875894988066825,0.4954653937947494,0.9971360381861575,0.002863961813842482
10703,1090,906,184,1030,60,0.8311926605504587,0.1688073394495413,0.944954128440367,0.05504587155963303,1237,50,602,585,1231,6,0.04042037186742118,0.486661277283751,0.47291835084882783,0.9951495553759094,0.004850444624090542
10704,318,263,55,263,55,0.8270440251572327,0.17295597484276728,0.8270440251572327,0.17295597484276728,140,5,23,112,136,4,0.03571428571428571,0.16428571428571428,0.8,0.9714285714285714,0.02857142857142857
10705,1417,1218,199,1348,69,0.8595624558927312,0.14043754410726889,0.9513055751587862,0.048694424841213835,1835,49,884,902,1832,3,0.02670299727520436,0.4817438692098093,0.49155313351498636,0.9983651226158038,0.0016348773841961854
10706,277,208,69,216,61,0.7509025270758123,0.2490974729241877,0.779783393501805,0.22021660649819494,188,4,25,159,177,11,0.02127659574468085,0.13297872340425532,0.8457446808510638,0.9414893617021277,0.05851063829787234
10707,281,82,199,149,132,0.2918149466192171,0.708185053380783,0.5302491103202847,0.4697508896797153,97,1,45,51,93,4,0.010309278350515464,0.4639175257731959,0.5257731958762887,0.9587628865979382,0.041237113402061855
10708,420,360,60,367,53,0.8571428571428571,0.14285714285714285,0.8738095238095238,0.1261904761904762,194,5,23,166,184,10,0.02577319587628866,0.11855670103092783,0.8556701030927835,0.9484536082474226,0.05154639175257732
10709,228,202,26,205,23,0.8859649122807017,0.11403508771929824,0.8991228070175439,0.10087719298245613,140,5,23,112,136,4,0.03571428571428571,0.16428571428571428,0.8,0.9714285714285714,0.02857142857142857
10710,351,297,54,298,53,0.8461538461538461,0.15384615384615385,0.8490028490028491,0.150997150997151,161,5,23,133,152,9,0.031055900621118012,0.14285714285714285,0.8260869565217391,0.9440993788819876,0.055900621118012424
10711,352,300,52,305,47,0.8522727272727273,0.14772727272727273,0.8664772727272727,0.13352272727272727,165,4,24,137,157,8,0.024242424242424242,0.14545454545454545,0.8303030303030303,0.9515151515151515,0.048484848484848485
10712,1228,984,244,1160,68,0.8013029315960912,0.1986970684039088,0.9446254071661238,0.05537459283387622,1264,71,587,606,1256,8,0.05617088607594937,0.46439873417721517,0.47943037974683544,0.9936708860759493,0.006329113924050633
10713,484,376,108,258,226,0.7768595041322314,0.2231404958677686,0.5330578512396694,0.4669421487603306,507,87,144,276,448,59,0.17159763313609466,0.28402366863905326,0.5443786982248521,0.883629191321499,0.11637080867850098
10714,317,273,44,272,45,0.861198738170347,0.138801261829653,0.8580441640378549,0.14195583596214512,157,4,24,129,148,9,0.025477707006369428,0.15286624203821655,0.821656050955414,0.9426751592356688,0.05732484076433121
10715,886,701,185,838,48,0.791196388261851,0.208803611738149,0.945823927765237,0.05417607223476298,634,80,268,286,633,1,0.12618296529968454,0.4227129337539432,0.45110410094637227,0.998422712933754,0.0015772870662460567
10716,248,206,42,205,43,0.8306451612903226,0.1693548387096774,0.8266129032258065,0.17338709677419356,120,5,23,92,114,6,0.041666666666666664,0.19166666666666668,0.7666666666666667,0.95,0.05
10717,1532,1286,246,1470,62,0.839425587467363,0.16057441253263707,0.9595300261096605,0.04046997389033943,1281,58,622,601,1276,5,0.04527712724434036,0.4855581576893052,0.46916471506635443,0.9960967993754879,0.0039032006245121
10718,212,171,41,177,35,0.8066037735849056,0.19339622641509435,0.8349056603773585,0.1650943396226415,170,5,24,141,162,8,0.029411764705882353,0.1411764705882353,0.8294117647058824,0.9529411764705882,0.047058823529411764
10719,305,255,50,257,48,0.8360655737704918,0.16393442622950818,0.8426229508196721,0.15737704918032788,119,5,23,91,114,5,0.04201680672268908,0.19327731092436976,0.7647058823529411,0.957983193277311,0.04201680672268908
10720,284,76,208,160,124,0.2676056338028169,0.7323943661971831,0.5633802816901409,0.43661971830985913,108,1,45,62,106,2,0.009259259259259259,0.4166666666666667,0.5740740740740741,0.9814814814814815,0.018518518518518517
10721,249,206,43,206,43,0.8273092369477911,0.17269076305220885,0.8273092369477911,0.17269076305220885,165,5,23,137,159,6,0.030303030303030304,0.1393939393939394,0.8303030303030303,0.9636363636363636,0.03636363636363636
10722,264,80,184,143,121,0.30303030303030304,0.696969696969697,0.5416666666666666,0.4583333333333333,106,2,54,50,104,2,0.018867924528301886,0.5094339622641509,0.4716981132075472,0.9811320754716981,0.018867924528301886
10723,181,145,36,148,33,0.8011049723756906,0.19889502762430938,0.8176795580110497,0.18232044198895028,180,5,23,152,170,10,0.027777777777777776,0.12777777777777777,0.8444444444444444,0.9444444444444444,0.05555555555555555
10724,2056,1779,277,1998,58,0.8652723735408561,0.13472762645914396,0.9717898832684825,0.02821011673151751,1122,40,542,540,1117,5,0.035650623885918005,0.483065953654189,0.48128342245989303,0.9955436720142602,0.004456327985739751
10725,205,162,43,165,40,0.7902439024390244,0.2097560975609756,0.8048780487804879,0.1951219512195122,157,5,23,129,148,9,0.03184713375796178,0.1464968152866242,0.821656050955414,0.9426751592356688,0.05732484076433121
10726,851,693,158,817,34,0.8143360752056404,0.18566392479435959,0.9600470035252644,0.0399529964747356,1067,63,517,487,1061,6,0.059044048734770385,0.4845360824742268,0.4564198687910028,0.9943767572633552,0.005623242736644799
10727,1516,1318,198,1471,45,0.8693931398416886,0.13060686015831136,0.9703166226912929,0.029683377308707123,2285,51,1110,1124,2278,7,0.022319474835886213,0.48577680525164113,0.49190371991247267,0.9969365426695842,0.003063457330415755
10728,1176,1006,170,1145,31,0.8554421768707483,0.1445578231292517,0.9736394557823129,0.026360544217687076,1583,52,760,771,1580,3,0.032849020846494,0.4801010739102969,0.48704990524320907,0.998104864181933,0.0018951358180669614
10729,267,76,191,141,126,0.2846441947565543,0.7153558052434457,0.5280898876404494,0.47191011235955055,108,0,44,64,105,3,0.0,0.4074074074074074,0.5925925925925926,0.9722222222222222,0.027777777777777776
10730,341,289,52,297,44,0.8475073313782991,0.15249266862170088,0.8709677419354839,0.12903225806451613,155,4,25,126,148,7,0.025806451612903226,0.16129032258064516,0.8129032258064516,0.9548387096774194,0.04516129032258064
10731,1771,1555,216,1723,48,0.8780350084697911,0.12196499153020893,0.9728966685488425,0.02710333145115754,1047,64,494,489,1040,7,0.061127029608404965,0.47182425978987586,0.4670487106017192,0.9933142311365807,0.0066857688634192934
10732,1338,1176,162,1284,54,0.8789237668161435,0.1210762331838565,0.9596412556053812,0.04035874439461883,2096,59,1001,1036,2090,6,0.02814885496183206,0.4775763358778626,0.49427480916030536,0.9971374045801527,0.0028625954198473282
10733,233,191,42,196,37,0.8197424892703863,0.18025751072961374,0.8412017167381974,0.15879828326180256,174,5,23,146,165,9,0.028735632183908046,0.13218390804597702,0.8390804597701149,0.9482758620689655,0.05172413793103448
10734,315,248,67,255,60,0.7873015873015873,0.2126984126984127,0.8095238095238095,0.19047619047619047,190,5,24,161,182,8,0.02631578947368421,0.12631578947368421,0.8473684210526315,0.9578947368421052,0.042105263157894736
10735,341,289,52,297,44,0.8475073313782991,0.15249266862170088,0.8709677419354839,0.12903225806451613,146,4,25,117,139,7,0.0273972602739726,0.17123287671232876,0.8013698630136986,0.952054794520548,0.04794520547945205
10736,2170,1953,217,2102,68,0.9,0.1,0.9686635944700461,0.03133640552995392,1288,45,621,622,1283,5,0.03493788819875776,0.48214285714285715,0.4829192546583851,0.9961180124223602,0.0038819875776397515
10737,467,428,39,428,39,0.9164882226980728,0.0835117773019272,0.9164882226980728,0.0835117773019272,154,4,24,126,148,6,0.025974025974025976,0.15584415584415584,0.8181818181818182,0.961038961038961,0.03896103896103896
10738,482,443,39,449,33,0.9190871369294605,0.08091286307053942,0.9315352697095436,0.06846473029045644,163,5,23,135,154,9,0.03067484662576687,0.1411042944785276,0.8282208588957055,0.9447852760736196,0.05521472392638037
10739,1960,1679,281,1880,80,0.8566326530612245,0.1433673469387755,0.9591836734693877,0.04081632653061224,1001,60,489,452,997,4,0.059940059940059943,0.4885114885114885,0.4515484515484515,0.996003996003996,0.003996003996003996
10740,1335,1151,184,1277,58,0.8621722846441947,0.13782771535580524,0.9565543071161049,0.04344569288389513,2095,54,1003,1038,2089,6,0.025775656324582338,0.47875894988066825,0.4954653937947494,0.9971360381861575,0.002863961813842482
10741,1893,1720,173,1840,53,0.9086106708927628,0.09138932910723718,0.9720021130480718,0.027997886951928157,924,48,441,435,920,4,0.05194805194805195,0.4772727272727273,0.4707792207792208,0.9956709956709957,0.004329004329004329
10742,597,540,57,543,54,0.9045226130653267,0.09547738693467336,0.9095477386934674,0.09045226130653267,155,5,23,127,149,6,0.03225806451612903,0.14838709677419354,0.8193548387096774,0.9612903225806452,0.03870967741935484
10743,1651,1468,183,1578,73,0.8891580860084797,0.1108419139915203,0.9557843731072078,0.044215626892792244,1525,53,734,738,1522,3,0.03475409836065574,0.48131147540983604,0.4839344262295082,0.9980327868852459,0.0019672131147540984
10744,306,270,36,276,30,0.8823529411764706,0.11764705882352941,0.9019607843137255,0.09803921568627451,156,5,23,128,148,8,0.03205128205128205,0.14743589743589744,0.8205128205128205,0.9487179487179487,0.05128205128205128
10745,784,635,149,725,59,0.8099489795918368,0.19005102040816327,0.9247448979591837,0.07525510204081633,459,51,202,206,448,11,0.1111111111111111,0.4400871459694989,0.44880174291938996,0.9760348583877996,0.023965141612200435
10746,393,346,47,350,43,0.8804071246819338,0.11959287531806616,0.8905852417302799,0.10941475826972011,119,5,23,91,114,5,0.04201680672268908,0.19327731092436976,0.7647058823529411,0.957983193277311,0.04201680672268908
10747,1339,1156,183,1277,62,0.8633308439133682,0.13666915608663183,0.9536967886482449,0.04630321135175504,1022,42,476,504,1015,7,0.0410958904109589,0.4657534246575342,0.4931506849315068,0.9931506849315068,0.00684931506849315
10748,327,266,61,265,62,0.8134556574923547,0.18654434250764526,0.8103975535168195,0.18960244648318042,141,5,23,113,136,5,0.03546099290780142,0.16312056737588654,0.8014184397163121,0.9645390070921985,0.03546099290780142
10749,205,162,43,165,40,0.7902439024390244,0.2097560975609756,0.8048780487804879,0.1951219512195122,157,5,23,129,148,9,0.03184713375796178,0.1464968152866242,0.821656050955414,0.9426751592356688,0.05732484076433121
10750,4867,4158,709,3974,893,0.8543250462297103,0.14567495377028972,0.8165194164783234,0.1834805835216766,1010,125,268,617,703,307,0.12376237623762376,0.26534653465346536,0.6108910891089109,0.696039603960396,0.30396039603960395
10751,1215,1087,128,1177,38,0.8946502057613168,0.10534979423868313,0.968724279835391,0.031275720164609055,1189,80,554,555,1184,5,0.0672834314550042,0.4659377628259041,0.4667788057190917,0.9957947855340622,0.004205214465937763
10752,1062,913,149,1029,33,0.85969868173258,0.14030131826741996,0.9689265536723164,0.031073446327683617,1162,58,541,563,1156,6,0.04991394148020654,0.4655765920826162,0.4845094664371773,0.9948364888123924,0.0051635111876075735
10753,1095,876,219,1055,40,0.8,0.2,0.9634703196347032,0.0365296803652968,595,87,268,240,594,1,0.146218487394958,0.4504201680672269,0.40336134453781514,0.9983193277310924,0.0016806722689075631
10754,417,380,37,378,39,0.9112709832134293,0.08872901678657075,0.9064748201438849,0.09352517985611511,179,5,23,151,169,10,0.027932960893854747,0.12849162011173185,0.8435754189944135,0.9441340782122905,0.055865921787709494
10755,1122,881,241,1060,62,0.785204991087344,0.21479500891265596,0.9447415329768271,0.05525846702317291,1067,55,518,494,1061,6,0.05154639175257732,0.4854732895970009,0.4629803186504217,0.9943767572633552,0.005623242736644799
10756,2056,1779,277,1998,58,0.8652723735408561,0.13472762645914396,0.9717898832684825,0.02821011673151751,1122,40,542,540,1117,5,0.035650623885918005,0.483065953654189,0.48128342245989303,0.9955436720142602,0.004456327985739751
10757,356,292,64,300,56,0.8202247191011236,0.1797752808988764,0.8426966292134831,0.15730337078651685,172,4,25,143,164,8,0.023255813953488372,0.14534883720930233,0.8313953488372093,0.9534883720930233,0.046511627906976744
10758,773,641,132,733,40,0.8292367399741267,0.17076326002587322,0.9482535575679172,0.0517464424320828,760,56,343,361,755,5,0.07368421052631578,0.4513157894736842,0.475,0.993421052631579,0.006578947368421052
10759,1357,1142,215,1289,68,0.8415622697126013,0.1584377302873987,0.9498894620486367,0.050110537951363304,1299,54,627,618,1293,6,0.04157043879907621,0.48267898383371827,0.47575057736720555,0.9953810623556582,0.004618937644341801
10760,827,659,168,797,30,0.7968561064087062,0.20314389359129384,0.9637243047158404,0.036275695284159616,1231,59,577,595,1223,8,0.0479285134037368,0.4687246141348497,0.4833468724614135,0.9935012185215272,0.006498781478472786
10761,939,742,197,889,50,0.7902023429179978,0.20979765708200213,0.946751863684771,0.05324813631522897,579,108,239,232,578,1,0.18652849740932642,0.41278065630397237,0.4006908462867012,0.998272884283247,0.0017271157167530224
10762,1445,1220,225,1396,49,0.8442906574394463,0.15570934256055363,0.9660899653979239,0.033910034602076124,1279,67,595,617,1270,9,0.05238467552775606,0.4652071931196247,0.48240813135261923,0.9929632525410477,0.007036747458952306
10763,1175,971,204,1124,51,0.8263829787234043,0.17361702127659576,0.9565957446808511,0.04340425531914894,695,92,287,316,694,1,0.13237410071942446,0.41294964028776976,0.4546762589928058,0.9985611510791367,0.0014388489208633094
10764,856,691,165,809,47,0.8072429906542056,0.1927570093457944,0.9450934579439252,0.054906542056074766,1143,43,530,570,1135,8,0.03762029746281715,0.4636920384951881,0.49868766404199477,0.9930008748906387,0.00699912510936133
10765,1559,1303,256,1482,77,0.8357921744708147,0.16420782552918536,0.9506093649775497,0.04939063502245029,2107,45,1002,1060,2101,6,0.021357380161366873,0.4755576649264357,0.5030849549121974,0.9971523493118177,0.0028476506881822496
10766,431,396,35,396,35,0.9187935034802784,0.08120649651972157,0.9187935034802784,0.08120649651972157,122,5,23,94,114,8,0.040983606557377046,0.1885245901639344,0.7704918032786885,0.9344262295081968,0.06557377049180328
10767,1176,1006,170,1145,31,0.8554421768707483,0.1445578231292517,0.9736394557823129,0.026360544217687076,1583,52,760,771,1580,3,0.032849020846494,0.4801010739102969,0.48704990524320907,0.998104864181933,0.0018951358180669614
10768,403,341,62,349,54,0.8461538461538461,0.15384615384615385,0.8660049627791563,0.13399503722084366,147,5,23,119,141,6,0.034013605442176874,0.1564625850340136,0.8095238095238095,0.9591836734693877,0.04081632653061224
10769,1476,1304,172,1431,45,0.8834688346883469,0.11653116531165311,0.9695121951219512,0.03048780487804878,1040,47,499,494,1036,4,0.04519230769230769,0.4798076923076923,0.475,0.9961538461538462,0.0038461538461538464
10770,2104,1838,266,2026,78,0.873574144486692,0.12642585551330798,0.9629277566539924,0.0370722433460076,1590,53,763,774,1587,3,0.03333333333333333,0.479874213836478,0.4867924528301887,0.9981132075471698,0.0018867924528301887
10771,301,104,197,160,141,0.34551495016611294,0.654485049833887,0.53156146179402,0.4684385382059801,100,0,37,63,98,2,0.0,0.37,0.63,0.98,0.02
10772,1872,1682,190,1814,58,0.8985042735042735,0.1014957264957265,0.969017094017094,0.030982905982905984,1644,67,792,785,1641,3,0.04075425790754258,0.48175182481751827,0.4774939172749392,0.9981751824817519,0.0018248175182481751
10773,1695,1493,202,1649,46,0.8808259587020649,0.1191740412979351,0.9728613569321534,0.027138643067846607,1598,65,773,760,1595,3,0.040675844806007506,0.483729662077597,0.4755944931163955,0.9981226533166458,0.0018773466833541927
10774,305,244,61,250,55,0.8,0.2,0.819672131147541,0.18032786885245902,183,5,23,155,174,9,0.0273224043715847,0.12568306010928962,0.8469945355191257,0.9508196721311475,0.04918032786885246
10775,1148,979,169,1093,55,0.8527874564459931,0.14721254355400698,0.9520905923344948,0.04790940766550523,948,65,557,326,946,2,0.06856540084388185,0.5875527426160337,0.3438818565400844,0.9978902953586498,0.002109704641350211
10776,1391,1160,231,1334,57,0.8339324227174695,0.16606757728253055,0.9590222861250899,0.040977713874910136,1256,75,605,576,1247,9,0.059713375796178345,0.48168789808917195,0.4585987261146497,0.9928343949044586,0.007165605095541401
10777,495,427,68,433,62,0.8626262626262626,0.13737373737373737,0.8747474747474747,0.12525252525252525,157,5,24,128,149,8,0.03184713375796178,0.15286624203821655,0.8152866242038217,0.9490445859872612,0.050955414012738856
10778,393,341,52,344,49,0.8676844783715013,0.13231552162849872,0.8753180661577609,0.12468193384223919,182,5,23,154,173,9,0.027472527472527472,0.12637362637362637,0.8461538461538461,0.9505494505494505,0.04945054945054945
10779,321,270,51,273,48,0.8411214953271028,0.1588785046728972,0.8504672897196262,0.14953271028037382,192,5,23,164,184,8,0.026041666666666668,0.11979166666666667,0.8541666666666666,0.9583333333333334,0.041666666666666664
10780,922,735,187,882,40,0.797180043383948,0.20281995661605207,0.9566160520607375,0.04338394793926247,569,80,227,262,568,1,0.140597539543058,0.3989455184534271,0.46045694200351495,0.9982425307557118,0.0017574692442882249
10781,1963,1754,209,1909,54,0.8935303107488538,0.10646968925114621,0.9724910850738665,0.02750891492613347,1145,59,534,552,1140,5,0.05152838427947598,0.4663755458515284,0.4820960698689956,0.9956331877729258,0.004366812227074236
10782,298,85,213,166,132,0.28523489932885904,0.714765100671141,0.5570469798657718,0.4429530201342282,101,0,45,56,99,2,0.0,0.44554455445544555,0.5544554455445545,0.9801980198019802,0.019801980198019802
10783,205,181,24,186,19,0.8829268292682927,0.11707317073170732,0.9073170731707317,0.09268292682926829,150,4,24,122,140,10,0.02666666666666667,0.16,0.8133333333333334,0.9333333333333333,0.06666666666666667
10784,306,270,36,276,30,0.8823529411764706,0.11764705882352941,0.9019607843137255,0.09803921568627451,172,5,23,144,164,8,0.029069767441860465,0.13372093023255813,0.8372093023255814,0.9534883720930233,0.046511627906976744
10785,259,217,42,225,34,0.8378378378378378,0.16216216216216217,0.8687258687258688,0.13127413127413126,175,5,24,146,166,9,0.02857142857142857,0.13714285714285715,0.8342857142857143,0.9485714285714286,0.05142857142857143
10786,1058,861,197,1003,55,0.8137996219281664,0.18620037807183365,0.9480151228733459,0.05198487712665406,679,103,265,311,678,1,0.15169366715758467,0.390279823269514,0.4580265095729013,0.9985272459499264,0.0014727540500736377
10787,1397,1153,244,1335,62,0.8253400143163923,0.17465998568360774,0.9556191839656406,0.04438081603435934,1168,66,546,556,1161,7,0.05650684931506849,0.4674657534246575,0.476027397260274,0.9940068493150684,0.0059931506849315065
10788,1042,879,163,1007,35,0.8435700575815739,0.15642994241842612,0.9664107485604606,0.03358925143953935,347,45,163,139,346,1,0.12968299711815562,0.4697406340057637,0.40057636887608067,0.9971181556195965,0.002881844380403458
10789,211,170,41,177,34,0.8056872037914692,0.1943127962085308,0.8388625592417062,0.16113744075829384,170,5,24,141,162,8,0.029411764705882353,0.1411764705882353,0.8294117647058824,0.9529411764705882,0.047058823529411764
10790,1476,1304,172,1431,45,0.8834688346883469,0.11653116531165311,0.9695121951219512,0.03048780487804878,1039,47,499,493,1035,4,0.04523580365736285,0.480269489894129,0.47449470644850816,0.9961501443695862,0.0038498556304138597
10791,406,359,47,361,45,0.8842364532019704,0.11576354679802955,0.8891625615763546,0.11083743842364532,151,4,24,123,143,8,0.026490066225165563,0.15894039735099338,0.8145695364238411,0.9470198675496688,0.052980132450331126
10792,356,292,64,300,56,0.8202247191011236,0.1797752808988764,0.8426966292134831,0.15730337078651685,173,4,25,144,164,9,0.023121387283236993,0.14450867052023122,0.8323699421965318,0.9479768786127167,0.05202312138728324
10793,602,499,103,566,36,0.8289036544850499,0.17109634551495018,0.9401993355481728,0.059800664451827246,1153,45,553,555,1143,10,0.03902862098872507,0.47961838681699914,0.4813529921942758,0.9913269731136166,0.008673026886383347
10794,1005,817,188,954,51,0.8129353233830846,0.18706467661691542,0.9492537313432836,0.050746268656716415,1055,68,480,507,1048,7,0.06445497630331753,0.4549763033175355,0.48056872037914694,0.9933649289099526,0.006635071090047393
10795,1335,1151,184,1277,58,0.8621722846441947,0.13782771535580524,0.9565543071161049,0.04344569288389513,2095,54,1003,1038,2089,6,0.025775656324582338,0.47875894988066825,0.4954653937947494,0.9971360381861575,0.002863961813842482
10796,1497,1265,232,1425,72,0.8450233800935204,0.15497661990647962,0.9519038076152304,0.04809619238476954,2296,74,1112,1110,2291,5,0.032229965156794424,0.4843205574912892,0.4834494773519164,0.997822299651568,0.0021777003484320556
10797,271,229,42,235,36,0.8450184501845018,0.15498154981549817,0.8671586715867159,0.13284132841328414,190,5,24,161,182,8,0.02631578947368421,0.12631578947368421,0.8473684210526315,0.9578947368421052,0.042105263157894736
10798,316,257,59,260,56,0.8132911392405063,0.18670886075949367,0.8227848101265823,0.17721518987341772,179,5,23,151,170,9,0.027932960893854747,0.12849162011173185,0.8435754189944135,0.9497206703910615,0.05027932960893855
10799,292,99,193,148,144,0.339041095890411,0.660958904109589,0.5068493150684932,0.4931506849315068,107,1,50,56,106,1,0.009345794392523364,0.4672897196261682,0.5233644859813084,0.9906542056074766,0.009345794392523364
10800,983,799,184,926,57,0.8128179043743642,0.1871820956256358,0.9420142421159715,0.05798575788402848,981,44,470,467,975,6,0.04485219164118247,0.47910295616717635,0.47604485219164117,0.9938837920489296,0.0061162079510703364
10801,1099,877,222,1038,61,0.7979981801637852,0.20200181983621474,0.9444949954504095,0.055505004549590536,629,89,284,256,626,3,0.14149443561208266,0.45151033386327505,0.4069952305246423,0.9952305246422893,0.0047694753577106515
10802,248,206,42,205,43,0.8306451612903226,0.1693548387096774,0.8266129032258065,0.17338709677419356,167,5,23,139,158,9,0.029940119760479042,0.1377245508982036,0.8323353293413174,0.9461077844311377,0.05389221556886228
10803,1242,1146,96,1217,25,0.9227053140096618,0.07729468599033816,0.9798711755233495,0.020128824476650563,914,48,435,431,911,3,0.0525164113785558,0.4759299781181619,0.47155361050328226,0.9967177242888403,0.0032822757111597373
10804,1458,1250,208,1415,43,0.8573388203017832,0.14266117969821673,0.9705075445816187,0.029492455418381344,1245,65,596,584,1238,7,0.05220883534136546,0.478714859437751,0.46907630522088356,0.9943775100401606,0.005622489959839358
10805,4889,4183,706,3820,1069,0.8555941910411127,0.1444058089588873,0.7813458785027613,0.2186541214972387,997,123,268,606,645,352,0.12337011033099297,0.2688064192577733,0.6078234704112337,0.6469408224674023,0.3530591775325978
10806,352,300,52,305,47,0.8522727272727273,0.14772727272727273,0.8664772727272727,0.13352272727272727,179,4,24,151,171,8,0.0223463687150838,0.1340782122905028,0.8435754189944135,0.9553072625698324,0.0446927374301676
10807,320,269,51,280,40,0.840625,0.159375,0.875,0.125,179,5,23,151,169,10,0.027932960893854747,0.12849162011173185,0.8435754189944135,0.9441340782122905,0.055865921787709494
10808,487,430,57,436,51,0.8829568788501027,0.11704312114989733,0.8952772073921971,0.10472279260780287,131,5,23,103,125,6,0.03816793893129771,0.17557251908396945,0.7862595419847328,0.9541984732824428,0.04580152671755725
10809,1007,795,212,945,62,0.7894736842105263,0.21052631578947367,0.9384309831181727,0.06156901688182721,652,73,256,323,651,1,0.11196319018404909,0.39263803680981596,0.495398773006135,0.9984662576687117,0.0015337423312883436
10810,1053,896,157,1003,50,0.8509021842355176,0.14909781576448244,0.9525166191832859,0.04748338081671415,946,57,428,461,939,7,0.06025369978858351,0.452431289640592,0.48731501057082455,0.992600422832981,0.007399577167019027
10811,487,430,57,436,51,0.8829568788501027,0.11704312114989733,0.8952772073921971,0.10472279260780287,154,5,23,126,146,8,0.032467532467532464,0.14935064935064934,0.8181818181818182,0.948051948051948,0.05194805194805195
10812,1549,1310,239,1496,53,0.8457069076823758,0.15429309231762428,0.9657843770174306,0.0342156229825694,1010,44,478,488,1004,6,0.04356435643564356,0.47326732673267324,0.48316831683168315,0.994059405940594,0.005940594059405941
10813,319,263,56,269,50,0.8244514106583072,0.1755485893416928,0.8432601880877743,0.15673981191222572,149,5,23,121,140,9,0.03355704697986577,0.15436241610738255,0.8120805369127517,0.9395973154362416,0.06040268456375839
10814,460,407,53,412,48,0.8847826086956522,0.11521739130434783,0.8956521739130435,0.10434782608695652,198,5,23,170,188,10,0.025252525252525252,0.11616161616161616,0.8585858585858586,0.9494949494949495,0.050505050505050504
10815,217,172,45,178,39,0.7926267281105991,0.2073732718894009,0.8202764976958525,0.17972350230414746,157,5,23,129,150,7,0.03184713375796178,0.1464968152866242,0.821656050955414,0.9554140127388535,0.044585987261146494
10816,431,386,45,388,43,0.8955916473317865,0.10440835266821345,0.9002320185614849,0.09976798143851508,174,5,23,146,165,9,0.028735632183908046,0.13218390804597702,0.8390804597701149,0.9482758620689655,0.05172413793103448
10817,244,201,43,206,38,0.8237704918032787,0.1762295081967213,0.8442622950819673,0.1557377049180328,153,5,23,125,147,6,0.032679738562091505,0.1503267973856209,0.8169934640522876,0.9607843137254902,0.0392156862745098
10818,380,320,60,324,56,0.8421052631578947,0.15789473684210525,0.8526315789473684,0.14736842105263157,148,5,23,120,141,7,0.033783783783783786,0.1554054054054054,0.8108108108108109,0.9527027027027027,0.0472972972972973
10819,426,364,62,370,56,0.8544600938967136,0.14553990610328638,0.8685446009389671,0.13145539906103287,150,5,23,122,140,10,0.03333333333333333,0.15333333333333332,0.8133333333333334,0.9333333333333333,0.06666666666666667
10820,1705,1508,197,1644,61,0.884457478005865,0.1155425219941349,0.9642228739002933,0.03577712609970674,1279,46,643,590,1273,6,0.03596559812353401,0.5027365129007036,0.4612978889757623,0.9953088350273651,0.004691164972634871
10821,394,344,50,349,45,0.8730964467005076,0.12690355329949238,0.8857868020304569,0.11421319796954314,155,5,23,127,147,8,0.03225806451612903,0.14838709677419354,0.8193548387096774,0.9483870967741935,0.05161290322580645
10822,1215,1087,128,1177,38,0.8946502057613168,0.10534979423868313,0.968724279835391,0.031275720164609055,1189,80,554,555,1184,5,0.0672834314550042,0.4659377628259041,0.4667788057190917,0.9957947855340622,0.004205214465937763
10823,312,94,218,155,157,0.30128205128205127,0.6987179487179487,0.4967948717948718,0.5032051282051282,118,1,48,69,113,5,0.00847457627118644,0.4067796610169492,0.5847457627118644,0.9576271186440678,0.0423728813559322
10824,839,653,186,774,65,0.7783075089392133,0.22169249106078665,0.9225268176400476,0.07747318235995232,995,42,478,475,990,5,0.04221105527638191,0.48040201005025124,0.47738693467336685,0.9949748743718593,0.005025125628140704
10825,217,172,45,178,39,0.7926267281105991,0.2073732718894009,0.8202764976958525,0.17972350230414746,154,5,23,126,146,8,0.032467532467532464,0.14935064935064934,0.8181818181818182,0.948051948051948,0.05194805194805195
10826,312,284,28,287,25,0.9102564102564102,0.08974358974358974,0.9198717948717948,0.08012820512820513,156,5,23,128,148,8,0.03205128205128205,0.14743589743589744,0.8205128205128205,0.9487179487179487,0.05128205128205128
10827,1034,841,193,977,57,0.8133462282398453,0.18665377176015474,0.9448742746615088,0.0551257253384913,994,70,467,457,987,7,0.07042253521126761,0.46981891348088534,0.4597585513078471,0.9929577464788732,0.007042253521126761
10828,177,143,34,150,27,0.807909604519774,0.192090395480226,0.847457627118644,0.15254237288135594,154,5,24,125,145,9,0.032467532467532464,0.15584415584415584,0.8116883116883117,0.9415584415584416,0.05844155844155844
10829,1103,932,171,1047,56,0.8449682683590208,0.15503173164097914,0.9492293744333635,0.050770625566636446,1256,46,607,603,1250,6,0.03662420382165605,0.48328025477707004,0.48009554140127386,0.9952229299363057,0.004777070063694267
10830,230,173,57,177,53,0.7521739130434782,0.24782608695652175,0.7695652173913043,0.23043478260869565,151,5,23,123,143,8,0.033112582781456956,0.152317880794702,0.8145695364238411,0.9470198675496688,0.052980132450331126
10831,1697,1481,216,1641,56,0.8727165586328816,0.12728344136711844,0.9670005892751915,0.032999410724808484,1097,65,527,505,1092,5,0.059252506836827715,0.4804010938924339,0.4603463992707384,0.9954421148587056,0.004557885141294439
10832,247,192,55,200,47,0.7773279352226721,0.22267206477732793,0.8097165991902834,0.1902834008097166,187,5,23,159,178,9,0.026737967914438502,0.12299465240641712,0.8502673796791443,0.9518716577540107,0.0481283422459893
10833,1237,988,249,964,273,0.7987065481002426,0.20129345189975748,0.7793047696038804,0.22069523039611966,481,11,95,375,311,170,0.02286902286902287,0.19750519750519752,0.7796257796257796,0.6465696465696466,0.35343035343035345
10834,243,200,43,206,37,0.823045267489712,0.17695473251028807,0.8477366255144033,0.1522633744855967,164,5,23,136,156,8,0.03048780487804878,0.1402439024390244,0.8292682926829268,0.9512195121951219,0.04878048780487805
10835,1426,1242,184,1367,59,0.8709677419354839,0.12903225806451613,0.958625525946704,0.04137447405329593,1032,71,477,484,1027,5,0.0687984496124031,0.4622093023255814,0.4689922480620155,0.9951550387596899,0.0048449612403100775
10836,1531,1264,267,1461,70,0.8256041802743305,0.1743958197256695,0.9542782495101241,0.045721750489875895,1581,56,749,776,1572,9,0.03542061986084757,0.4737507906388362,0.49082858950031627,0.9943074003795066,0.0056925996204933585
10837,380,320,60,324,56,0.8421052631578947,0.15789473684210525,0.8526315789473684,0.14736842105263157,175,5,23,147,168,7,0.02857142857142857,0.13142857142857142,0.84,0.96,0.04
10838,415,367,48,370,45,0.8843373493975903,0.11566265060240964,0.891566265060241,0.10843373493975904,185,4,24,157,176,9,0.021621621621621623,0.12972972972972974,0.8486486486486486,0.9513513513513514,0.04864864864864865
10839,1286,1045,241,1224,62,0.812597200622084,0.187402799377916,0.9517884914463453,0.04821150855365474,727,90,324,313,723,4,0.12379642365887207,0.44566712517193946,0.4305364511691884,0.9944979367262724,0.005502063273727648
10840,292,92,200,141,151,0.3150684931506849,0.684931506849315,0.4828767123287671,0.5171232876712328,80,1,31,48,80,0,0.0125,0.3875,0.6,1.0,0.0
10841,357,294,63,303,54,0.8235294117647058,0.17647058823529413,0.8487394957983193,0.15126050420168066,177,5,24,148,170,7,0.02824858757062147,0.13559322033898305,0.8361581920903954,0.96045197740113,0.03954802259887006
10842,1417,1218,199,1348,69,0.8595624558927312,0.14043754410726889,0.9513055751587862,0.048694424841213835,1835,49,884,902,1832,3,0.02670299727520436,0.4817438692098093,0.49155313351498636,0.9983651226158038,0.0016348773841961854
10843,275,245,30,253,22,0.8909090909090909,0.10909090909090909,0.92,0.08,177,5,23,149,168,9,0.02824858757062147,0.12994350282485875,0.8418079096045198,0.9491525423728814,0.05084745762711865
10844,1007,787,220,957,50,0.7815292949354519,0.21847070506454816,0.9503475670307845,0.04965243296921549,1005,48,461,496,998,7,0.04776119402985075,0.45870646766169154,0.4935323383084577,0.9930348258706467,0.006965174129353234
10845,432,397,35,397,35,0.9189814814814815,0.08101851851851852,0.9189814814814815,0.08101851851851852,123,5,23,95,115,8,0.04065040650406504,0.18699186991869918,0.7723577235772358,0.9349593495934959,0.06504065040650407
10846,222,184,38,191,31,0.8288288288288288,0.17117117117117117,0.8603603603603603,0.13963963963963963,186,5,23,158,178,8,0.026881720430107527,0.12365591397849462,0.8494623655913979,0.956989247311828,0.043010752688172046
10847,286,246,40,252,34,0.8601398601398601,0.13986013986013987,0.8811188811188811,0.11888111888111888,176,5,24,147,169,7,0.028409090909090908,0.13636363636363635,0.8352272727272727,0.9602272727272727,0.03977272727272727
10848,568,505,63,497,71,0.8890845070422535,0.11091549295774648,0.875,0.125,173,5,23,145,165,8,0.028901734104046242,0.1329479768786127,0.838150289017341,0.953757225433526,0.046242774566473986
10849,1375,1140,235,1297,78,0.8290909090909091,0.1709090909090909,0.9432727272727273,0.05672727272727273,1001,49,478,474,996,5,0.04895104895104895,0.4775224775224775,0.47352647352647353,0.995004995004995,0.004995004995004995
10850,403,333,70,339,64,0.826302729528536,0.17369727047146402,0.8411910669975186,0.1588089330024814,166,5,23,138,159,7,0.030120481927710843,0.13855421686746988,0.8313253012048193,0.9578313253012049,0.04216867469879518
10851,525,463,62,467,58,0.8819047619047619,0.1180952380952381,0.8895238095238095,0.11047619047619048,200,4,24,172,192,8,0.02,0.12,0.86,0.96,0.04
10852,139,103,36,108,31,0.7410071942446043,0.2589928057553957,0.7769784172661871,0.22302158273381295,174,5,23,146,165,9,0.028735632183908046,0.13218390804597702,0.8390804597701149,0.9482758620689655,0.05172413793103448
10853,1252,1042,210,1193,59,0.8322683706070287,0.16773162939297126,0.9528753993610224,0.04712460063897764,1194,58,550,586,1188,6,0.048576214405360134,0.46063651591289784,0.490787269681742,0.9949748743718593,0.005025125628140704
10854,2056,1779,277,1998,58,0.8652723735408561,0.13472762645914396,0.9717898832684825,0.02821011673151751,1122,40,542,540,1117,5,0.035650623885918005,0.483065953654189,0.48128342245989303,0.9955436720142602,0.004456327985739751
10855,408,340,68,345,63,0.8333333333333334,0.16666666666666666,0.8455882352941176,0.15441176470588236,199,4,24,171,192,7,0.020100502512562814,0.12060301507537688,0.8592964824120602,0.964824120603015,0.035175879396984924
10856,1599,1382,217,1536,63,0.8642901813633521,0.1357098186366479,0.9606003752345216,0.039399624765478425,1294,68,615,611,1287,7,0.05255023183925812,0.4752704791344668,0.4721792890262751,0.9945904173106646,0.005409582689335394
10857,181,145,36,148,33,0.8011049723756906,0.19889502762430938,0.8176795580110497,0.18232044198895028,179,5,23,151,169,10,0.027932960893854747,0.12849162011173185,0.8435754189944135,0.9441340782122905,0.055865921787709494
10858,1532,1286,246,1470,62,0.839425587467363,0.16057441253263707,0.9595300261096605,0.04046997389033943,1281,58,622,601,1276,5,0.04527712724434036,0.4855581576893052,0.46916471506635443,0.9960967993754879,0.0039032006245121
10859,1377,1187,190,1318,59,0.8620188816267248,0.13798111837327523,0.9571532316630356,0.042846768336964415,1112,60,511,541,1108,4,0.0539568345323741,0.4595323741007194,0.48651079136690645,0.9964028776978417,0.0035971223021582736
10860,1026,801,225,969,57,0.7807017543859649,0.21929824561403508,0.9444444444444444,0.05555555555555555,729,94,330,305,728,1,0.1289437585733882,0.45267489711934156,0.41838134430727025,0.9986282578875172,0.0013717421124828531
10861,273,232,41,235,38,0.8498168498168498,0.15018315018315018,0.8608058608058609,0.1391941391941392,153,4,24,125,145,8,0.026143790849673203,0.1568627450980392,0.8169934640522876,0.9477124183006536,0.05228758169934641
10862,205,162,43,165,40,0.7902439024390244,0.2097560975609756,0.8048780487804879,0.1951219512195122,152,5,23,124,143,9,0.03289473684210526,0.1513157894736842,0.8157894736842105,0.9407894736842105,0.05921052631578947
10863,338,293,45,297,41,0.8668639053254438,0.13313609467455623,0.878698224852071,0.12130177514792899,173,5,23,145,164,9,0.028901734104046242,0.1329479768786127,0.838150289017341,0.9479768786127167,0.05202312138728324
10864,313,275,38,283,30,0.8785942492012779,0.12140575079872204,0.9041533546325878,0.09584664536741214,143,5,23,115,136,7,0.03496503496503497,0.16083916083916083,0.8041958041958042,0.951048951048951,0.04895104895104895
10865,4856,4149,707,3966,890,0.8544069192751236,0.14559308072487645,0.8167215815485996,0.18327841845140033,1011,125,267,619,704,307,0.12363996043521266,0.26409495548961426,0.6122650840751731,0.6963402571711177,0.3036597428288823
10866,1868,1542,326,1758,110,0.8254817987152034,0.1745182012847966,0.9411134903640257,0.058886509635974305,624,61,292,271,616,8,0.09775641025641026,0.46794871794871795,0.4342948717948718,0.9871794871794872,0.01282051282051282
